z	NotreDame_De_Paris.txt 2, Miserables.txt 1
zaatcha	Miserables.txt 1
zag	Miserables.txt 4
zarach	NotreDame_De_Paris.txt 2
zeal	NotreDame_De_Paris.txt 1, Miserables.txt 12
zealous	Miserables.txt 3
zeila	Miserables.txt 2
zelma	Miserables.txt 4
zenith	NotreDame_De_Paris.txt 1, Miserables.txt 8
zephine	Miserables.txt 16
zephirod	NotreDame_De_Paris.txt 1
zephyr	Miserables.txt 1
zero	Miserables.txt 4
zetulbe	Miserables.txt 2
zi	Miserables.txt 3
zieten	Miserables.txt 2
zig	Miserables.txt 4
zigzag	NotreDame_De_Paris.txt 2
zigzags	NotreDame_De_Paris.txt 3, Miserables.txt 3
zinc	Miserables.txt 7
zingara	NotreDame_De_Paris.txt 1
zingari	NotreDame_De_Paris.txt 1
zip	NotreDame_De_Paris.txt 1, Miserables.txt 1
ziruph	NotreDame_De_Paris.txt 1
zodiac	Miserables.txt 2
zoilus	Miserables.txt 2
zone	NotreDame_De_Paris.txt 7, Miserables.txt 3
zones	NotreDame_De_Paris.txt 3
zoroaster	NotreDame_De_Paris.txt 2
zouave	Miserables.txt 1
zounds	NotreDame_De_Paris.txt 1
zs	Miserables.txt 1
zuyderzee	Miserables.txt 1
