m	NotreDame_De_Paris.txt 29, Miserables.txt 971
ma	NotreDame_De_Paris.txt 6, Miserables.txt 27
mabeuf	Miserables.txt 95
mabile	Miserables.txt 1
mabillon	Miserables.txt 1
mabonne	NotreDame_De_Paris.txt 1
mac	Miserables.txt 4
macaroons	Miserables.txt 1
macbeth	Miserables.txt 1
maccabees	Miserables.txt 1
macchi	Miserables.txt 1
macchiavelli	Miserables.txt 1
mace	NotreDame_De_Paris.txt 3
macebearers	NotreDame_De_Paris.txt 1
macerations	Miserables.txt 1
maces	NotreDame_De_Paris.txt 1
machiavelli	Miserables.txt 3
machicolations	NotreDame_De_Paris.txt 4
machicots	NotreDame_De_Paris.txt 1
machinations	Miserables.txt 1
machine	NotreDame_De_Paris.txt 3, Miserables.txt 15
machineel	Miserables.txt 1
machines	NotreDame_De_Paris.txt 1, Miserables.txt 5
mack	Miserables.txt 2
mad	NotreDame_De_Paris.txt 23, Miserables.txt 44
madam	NotreDame_De_Paris.txt 6, Miserables.txt 12
madame	NotreDame_De_Paris.txt 33, Miserables.txt 257
madamoiselle	NotreDame_De_Paris.txt 1
maddened	NotreDame_De_Paris.txt 1
made	NotreDame_De_Paris.txt 302, Miserables.txt 788
madeira	Miserables.txt 1
madeleine	Miserables.txt 284
madelonettes	Miserables.txt 6
mademoiselle	NotreDame_De_Paris.txt 20, Miserables.txt 112
madly	NotreDame_De_Paris.txt 4, Miserables.txt 3
madman	NotreDame_De_Paris.txt 7, Miserables.txt 4
madness	NotreDame_De_Paris.txt 7, Miserables.txt 14
madras	Miserables.txt 1
madrepore	Miserables.txt 2
madrid	Miserables.txt 3
madwoman	NotreDame_De_Paris.txt 2
maelstrom	Miserables.txt 1
maenads	Miserables.txt 1
maevius	Miserables.txt 1
magaera	Miserables.txt 1
magazine	Miserables.txt 1
magi	Miserables.txt 1
magian	NotreDame_De_Paris.txt 1
magic	NotreDame_De_Paris.txt 27, Miserables.txt 7
magical	NotreDame_De_Paris.txt 1, Miserables.txt 2
magically	NotreDame_De_Paris.txt 1
magician	NotreDame_De_Paris.txt 6, Miserables.txt 1
magicians	Miserables.txt 1
magimel	Miserables.txt 1
magisterial	NotreDame_De_Paris.txt 2, Miserables.txt 2
magistracy	NotreDame_De_Paris.txt 4, Miserables.txt 5
magistrate	NotreDame_De_Paris.txt 8, Miserables.txt 15
magistrates	NotreDame_De_Paris.txt 2, Miserables.txt 3
magistri	NotreDame_De_Paris.txt 2
magloire	NotreDame_De_Paris.txt 1, Miserables.txt 77
magna	NotreDame_De_Paris.txt 1
magnanimities	Miserables.txt 1
magnanimity	Miserables.txt 2
magnanimous	Miserables.txt 4
magnates	NotreDame_De_Paris.txt 1, Miserables.txt 1
magnet	NotreDame_De_Paris.txt 1, Miserables.txt 1
magnetic	NotreDame_De_Paris.txt 1, Miserables.txt 5
magnetism	NotreDame_De_Paris.txt 1, Miserables.txt 1
magnificence	NotreDame_De_Paris.txt 2, Miserables.txt 7
magnificences	NotreDame_De_Paris.txt 1, Miserables.txt 1
magnificent	NotreDame_De_Paris.txt 28, Miserables.txt 53
magnificently	NotreDame_De_Paris.txt 1, Miserables.txt 1
magnified	NotreDame_De_Paris.txt 1, Miserables.txt 1
magnify	Miserables.txt 1
magnifying	NotreDame_De_Paris.txt 2, Miserables.txt 1
magnitude	NotreDame_De_Paris.txt 1
magno	NotreDame_De_Paris.txt 1
magnon	Miserables.txt 30
magnons	Miserables.txt 1
magnus	Miserables.txt 1
magny	Miserables.txt 1
magot	NotreDame_De_Paris.txt 1
mah	NotreDame_De_Paris.txt 2
mahab	NotreDame_De_Paris.txt 1
mahiet	NotreDame_De_Paris.txt 4
mahiette	NotreDame_De_Paris.txt 46
mahogany	Miserables.txt 5
mahom	NotreDame_De_Paris.txt 6
mahomet	NotreDame_De_Paris.txt 1, Miserables.txt 2
mahometan	NotreDame_De_Paris.txt 1
mahometanism	Miserables.txt 1
mahometans	NotreDame_De_Paris.txt 2
mahoney	Miserables.txt 1
mai	Miserables.txt 2
maid	NotreDame_De_Paris.txt 11, Miserables.txt 20
maiden	NotreDame_De_Paris.txt 2, Miserables.txt 5
maidenliness	Miserables.txt 1
maidens	NotreDame_De_Paris.txt 7, Miserables.txt 2
maids	NotreDame_De_Paris.txt 3, Miserables.txt 6
mail	NotreDame_De_Paris.txt 4, Miserables.txt 13
maillard	Miserables.txt 2
mailles	NotreDame_De_Paris.txt 1
maillevin	NotreDame_De_Paris.txt 1
maillotins	Miserables.txt 1
mailly	NotreDame_De_Paris.txt 1
main	NotreDame_De_Paris.txt 3, Miserables.txt 12
maine	Miserables.txt 12
maintain	NotreDame_De_Paris.txt 2, Miserables.txt 5
maintained	NotreDame_De_Paris.txt 6, Miserables.txt 7
maintaining	NotreDame_De_Paris.txt 2, Miserables.txt 2
maintains	Miserables.txt 2
maintenance	Miserables.txt 1
maior	Miserables.txt 1
maire	NotreDame_De_Paris.txt 1, Miserables.txt 59
mairesse	NotreDame_De_Paris.txt 2
mais	NotreDame_De_Paris.txt 1, Miserables.txt 4
maison	NotreDame_De_Paris.txt 1, Miserables.txt 1
maistre	Miserables.txt 3
maitland	Miserables.txt 3
maitre	Miserables.txt 5
maize	NotreDame_De_Paris.txt 3
majestic	NotreDame_De_Paris.txt 5, Miserables.txt 10
majestically	NotreDame_De_Paris.txt 6, Miserables.txt 6
majesty	NotreDame_De_Paris.txt 35, Miserables.txt 38
majo	Miserables.txt 1
major	Miserables.txt 4
majore	Miserables.txt 1
majorities	Miserables.txt 1
majority	NotreDame_De_Paris.txt 3, Miserables.txt 14
make	NotreDame_De_Paris.txt 123, Miserables.txt 370
maker	NotreDame_De_Paris.txt 3, Miserables.txt 14
makers	NotreDame_De_Paris.txt 5, Miserables.txt 5
makes	NotreDame_De_Paris.txt 30, Miserables.txt 109
maketh	NotreDame_De_Paris.txt 1
making	NotreDame_De_Paris.txt 44, Miserables.txt 145
mal	Miserables.txt 1
mala	NotreDame_De_Paris.txt 1
malade	Miserables.txt 2
maladerie	NotreDame_De_Paris.txt 2
maladies	NotreDame_De_Paris.txt 3, Miserables.txt 9
malady	NotreDame_De_Paris.txt 3, Miserables.txt 19
malaquais	Miserables.txt 2
malarme	Miserables.txt 1
malbrouck	Miserables.txt 1
male	NotreDame_De_Paris.txt 7, Miserables.txt 8
malebranche	Miserables.txt 2
malediction	NotreDame_De_Paris.txt 4, Miserables.txt 4
maledictions	NotreDame_De_Paris.txt 3
malefactor	NotreDame_De_Paris.txt 1, Miserables.txt 5
malefactors	Miserables.txt 7
malek	Miserables.txt 1
males	Miserables.txt 1
malevolence	NotreDame_De_Paris.txt 6
malevolent	NotreDame_De_Paris.txt 2, Miserables.txt 1
malfilatre	Miserables.txt 1
malher	Miserables.txt 1
malheur	Miserables.txt 1
malheurs	Miserables.txt 1
malice	NotreDame_De_Paris.txt 7, Miserables.txt 7
malicious	NotreDame_De_Paris.txt 14, Miserables.txt 21
maliciously	NotreDame_De_Paris.txt 3
malign	NotreDame_De_Paris.txt 1
malignant	NotreDame_De_Paris.txt 4, Miserables.txt 1
mall	NotreDame_De_Paris.txt 1
mallet	Miserables.txt 1
malls	NotreDame_De_Paris.txt 1
malplaquet	Miserables.txt 2
malta	Miserables.txt 3
malteses	Miserables.txt 1
maltreated	NotreDame_De_Paris.txt 1
malure	Miserables.txt 1
malus	NotreDame_De_Paris.txt 1
malvoisie	Miserables.txt 1
mam	Miserables.txt 1
maman	Miserables.txt 1
mame	Miserables.txt 9
mamemoiselle	Miserables.txt 1
mamma	Miserables.txt 6
mammas	Miserables.txt 1
mammiferous	Miserables.txt 1
mammoths	Miserables.txt 1
mamselle	Miserables.txt 11
man	NotreDame_De_Paris.txt 354, Miserables.txt 2003
manage	NotreDame_De_Paris.txt 3, Miserables.txt 19
managed	NotreDame_De_Paris.txt 1, Miserables.txt 15
manager	Miserables.txt 2
manages	Miserables.txt 1
manchon	Miserables.txt 1
mancia	NotreDame_De_Paris.txt 3
mandar	Miserables.txt 1
mandate	Miserables.txt 2
mande	Miserables.txt 1
mandrin	Miserables.txt 1
manducet	NotreDame_De_Paris.txt 2
mane	NotreDame_De_Paris.txt 2, Miserables.txt 2
manezingues	Miserables.txt 1
mange	Miserables.txt 1
mangedentelle	Miserables.txt 1
manger	Miserables.txt 2
mangeront	NotreDame_De_Paris.txt 1
mangled	NotreDame_De_Paris.txt 2
mangue	NotreDame_De_Paris.txt 1
manhood	Miserables.txt 3
mania	NotreDame_De_Paris.txt 2, Miserables.txt 2
maniacal	Miserables.txt 1
manibus	Miserables.txt 1
manifest	NotreDame_De_Paris.txt 3, Miserables.txt 2
manifestations	NotreDame_De_Paris.txt 1, Miserables.txt 1
manifested	NotreDame_De_Paris.txt 1, Miserables.txt 1
manifesting	Miserables.txt 1
manifests	Miserables.txt 1
manifold	Miserables.txt 1
manikin	NotreDame_De_Paris.txt 13, Miserables.txt 2
manin	Miserables.txt 1
manipulated	NotreDame_De_Paris.txt 1, Miserables.txt 1
manipulating	Miserables.txt 1
manipulation	Miserables.txt 3
mankind	NotreDame_De_Paris.txt 1, Miserables.txt 4
manliness	Miserables.txt 1
manly	Miserables.txt 6
manner	NotreDame_De_Paris.txt 48, Miserables.txt 163
manners	NotreDame_De_Paris.txt 3, Miserables.txt 20
mannikin	Miserables.txt 1
manoeuvre	Miserables.txt 5
manoeuvres	NotreDame_De_Paris.txt 1, Miserables.txt 7
manoeuvring	Miserables.txt 1
manon	NotreDame_De_Paris.txt 1, Miserables.txt 1
manor	NotreDame_De_Paris.txt 3, Miserables.txt 3
manosque	Miserables.txt 1
manou	NotreDame_De_Paris.txt 1, Miserables.txt 1
mans	NotreDame_De_Paris.txt 1, Miserables.txt 1
mansard	Miserables.txt 4
mansion	NotreDame_De_Paris.txt 17, Miserables.txt 1
mansions	NotreDame_De_Paris.txt 3
manslaughterers	Miserables.txt 1
manteaux	Miserables.txt 5
mantel	NotreDame_De_Paris.txt 1
mantelet	Miserables.txt 1
mantes	NotreDame_De_Paris.txt 1, Miserables.txt 1
mantillas	Miserables.txt 1
mantilles	Miserables.txt 1
mantle	NotreDame_De_Paris.txt 12, Miserables.txt 12
mantlepiece	NotreDame_De_Paris.txt 1
mantles	NotreDame_De_Paris.txt 1, Miserables.txt 1
mantua	Miserables.txt 4
manuals	Miserables.txt 1
manuel	Miserables.txt 4
manufactories	Miserables.txt 1
manufactory	Miserables.txt 1
manufacture	Miserables.txt 8
manufactured	Miserables.txt 1
manufacturer	Miserables.txt 6
manufacturers	Miserables.txt 1
manufactures	NotreDame_De_Paris.txt 1
manufacturing	Miserables.txt 1
manure	Miserables.txt 10
manuscript	NotreDame_De_Paris.txt 6, Miserables.txt 10
manuscripts	NotreDame_De_Paris.txt 5, Miserables.txt 3
manutianis	Miserables.txt 1
manvault	NotreDame_De_Paris.txt 1
many	NotreDame_De_Paris.txt 140, Miserables.txt 236
map	Miserables.txt 6
maps	NotreDame_De_Paris.txt 1
mar	NotreDame_De_Paris.txt 2, Miserables.txt 2
marabouts	Miserables.txt 1
marafin	NotreDame_De_Paris.txt 2
marais	Miserables.txt 16
marat	Miserables.txt 12
maraude	Miserables.txt 2
marauder	Miserables.txt 3
marauders	Miserables.txt 3
marauding	Miserables.txt 4
marble	NotreDame_De_Paris.txt 29, Miserables.txt 33
marbled	NotreDame_De_Paris.txt 1
marbles	Miserables.txt 2
marc	NotreDame_De_Paris.txt 6
marceau	NotreDame_De_Paris.txt 1, Miserables.txt 10
marcel	NotreDame_De_Paris.txt 1, Miserables.txt 3
march	NotreDame_De_Paris.txt 26, Miserables.txt 74
marchand	NotreDame_De_Paris.txt 2, Miserables.txt 1
marchandise	NotreDame_De_Paris.txt 1
marchands	Miserables.txt 1
marchangy	Miserables.txt 2
marche	NotreDame_De_Paris.txt 1, Miserables.txt 7
marched	NotreDame_De_Paris.txt 6, Miserables.txt 14
marches	NotreDame_De_Paris.txt 1, Miserables.txt 3
marchiennes	Miserables.txt 1
marching	NotreDame_De_Paris.txt 7, Miserables.txt 12
marchpane	NotreDame_De_Paris.txt 2
marchpanes	NotreDame_De_Paris.txt 1
marcian	Miserables.txt 1
marcognet	Miserables.txt 2
marcos	Miserables.txt 1
marcus	Miserables.txt 2
mardi	NotreDame_De_Paris.txt 1, Miserables.txt 1
mardigras	Miserables.txt 1
mardis	Miserables.txt 1
mardisoir	Miserables.txt 1
mare	Miserables.txt 2
marechal	Miserables.txt 1
marechale	Miserables.txt 1
marengo	Miserables.txt 13
margaret	Miserables.txt 1
margaric	Miserables.txt 1
margaritam	NotreDame_De_Paris.txt 1
margaritas	NotreDame_De_Paris.txt 1
margin	Miserables.txt 7
marginal	NotreDame_De_Paris.txt 1
margoton	Miserables.txt 1
marguerite	NotreDame_De_Paris.txt 12, Miserables.txt 16
marguerites	NotreDame_De_Paris.txt 1, Miserables.txt 1
maria	NotreDame_De_Paris.txt 4, Miserables.txt 3
mariage	Miserables.txt 1
marie	NotreDame_De_Paris.txt 11, Miserables.txt 12
maries	Miserables.txt 1
mariette	Miserables.txt 1
marignan	Miserables.txt 1
marigni	NotreDame_De_Paris.txt 1
marigny	Miserables.txt 2
marine	Miserables.txt 5
mariner	Miserables.txt 1
mariners	Miserables.txt 1
marines	Miserables.txt 1
maringo	Miserables.txt 1
marion	Miserables.txt 3
maris	NotreDame_De_Paris.txt 1
marital	Miserables.txt 1
maritime	Miserables.txt 1
marius	Miserables.txt 1373
marivault	NotreDame_De_Paris.txt 1
mark	NotreDame_De_Paris.txt 5, Miserables.txt 17
marked	NotreDame_De_Paris.txt 5, Miserables.txt 25
market	NotreDame_De_Paris.txt 8, Miserables.txt 30
marketing	Miserables.txt 1
markets	NotreDame_De_Paris.txt 6, Miserables.txt 4
marking	NotreDame_De_Paris.txt 1, Miserables.txt 1
marks	NotreDame_De_Paris.txt 6, Miserables.txt 7
marksman	Miserables.txt 2
marksmanship	Miserables.txt 3
marl	Miserables.txt 1
marlborough	Miserables.txt 1
marly	Miserables.txt 2
marmosetis	NotreDame_De_Paris.txt 1
marmot	Miserables.txt 3
marmousets	Miserables.txt 1
marne	Miserables.txt 5
marnix	Miserables.txt 2
marques	Miserables.txt 1
marquesa	Miserables.txt 1
marquis	NotreDame_De_Paris.txt 2, Miserables.txt 25
marquisates	Miserables.txt 1
marquise	Miserables.txt 11
marquises	Miserables.txt 3
marriage	NotreDame_De_Paris.txt 20, Miserables.txt 36
marriages	Miserables.txt 2
married	NotreDame_De_Paris.txt 7, Miserables.txt 23
marries	Miserables.txt 1
marronne	Miserables.txt 1
marrons	Miserables.txt 1
marrow	NotreDame_De_Paris.txt 3, Miserables.txt 2
marry	NotreDame_De_Paris.txt 5, Miserables.txt 26
marrying	NotreDame_De_Paris.txt 2, Miserables.txt 3
mars	Miserables.txt 18
marsan	Miserables.txt 1
marseillaise	Miserables.txt 7
marseillaises	Miserables.txt 1
marseilles	NotreDame_De_Paris.txt 1, Miserables.txt 5
marsh	NotreDame_De_Paris.txt 2, Miserables.txt 2
marshal	NotreDame_De_Paris.txt 7, Miserables.txt 14
marshals	NotreDame_De_Paris.txt 3, Miserables.txt 3
marshes	NotreDame_De_Paris.txt 1, Miserables.txt 5
mart	NotreDame_De_Paris.txt 1, Miserables.txt 1
martainville	Miserables.txt 2
martha	Miserables.txt 1
marthe	NotreDame_De_Paris.txt 3, Miserables.txt 2
martial	NotreDame_De_Paris.txt 1
martin	NotreDame_De_Paris.txt 19, Miserables.txt 33
martingale	Miserables.txt 3
martini	NotreDame_De_Paris.txt 3
marto	Miserables.txt 1
martyr	Miserables.txt 5
martyrdom	Miserables.txt 4
martyred	Miserables.txt 1
martyrized	NotreDame_De_Paris.txt 1
martyrs	Miserables.txt 7
marvel	NotreDame_De_Paris.txt 1, Miserables.txt 7
marvelled	NotreDame_De_Paris.txt 1
marvelling	NotreDame_De_Paris.txt 1
marvellous	NotreDame_De_Paris.txt 21, Miserables.txt 16
marvellously	NotreDame_De_Paris.txt 1, Miserables.txt 1
marvels	NotreDame_De_Paris.txt 3, Miserables.txt 8
mary	NotreDame_De_Paris.txt 4, Miserables.txt 3
masaccio	NotreDame_De_Paris.txt 1
masaniello	Miserables.txt 1
mascarades	Miserables.txt 1
masculine	Miserables.txt 3
masea	NotreDame_De_Paris.txt 1
mask	NotreDame_De_Paris.txt 5, Miserables.txt 27
masked	NotreDame_De_Paris.txt 2, Miserables.txt 21
masker	NotreDame_De_Paris.txt 1, Miserables.txt 1
maskers	Miserables.txt 14
masks	NotreDame_De_Paris.txt 1, Miserables.txt 11
mason	NotreDame_De_Paris.txt 5, Miserables.txt 4
masonic	Miserables.txt 1
masonries	NotreDame_De_Paris.txt 1
masonry	NotreDame_De_Paris.txt 13, Miserables.txt 10
masons	NotreDame_De_Paris.txt 3, Miserables.txt 1
masquais	Miserables.txt 1
masquerade	Miserables.txt 1
masquerades	Miserables.txt 1
mass	NotreDame_De_Paris.txt 37, Miserables.txt 72
massacre	NotreDame_De_Paris.txt 1, Miserables.txt 7
massacred	Miserables.txt 1
massacres	Miserables.txt 2
massed	Miserables.txt 7
masses	NotreDame_De_Paris.txt 10, Miserables.txt 28
massieu	Miserables.txt 1
massing	Miserables.txt 3
massive	NotreDame_De_Paris.txt 6, Miserables.txt 13
mast	Miserables.txt 4
master	NotreDame_De_Paris.txt 231, Miserables.txt 76
mastered	Miserables.txt 2
masterful	Miserables.txt 2
masterfully	Miserables.txt 1
masterly	Miserables.txt 3
masterpiece	NotreDame_De_Paris.txt 4, Miserables.txt 9
masterpieces	Miserables.txt 7
masters	NotreDame_De_Paris.txt 9, Miserables.txt 18
mastership	NotreDame_De_Paris.txt 1
mastery	Miserables.txt 1
mastic	Miserables.txt 1
mastication	NotreDame_De_Paris.txt 1
mastodon	Miserables.txt 2
mastodons	Miserables.txt 2
mastroquets	Miserables.txt 1
mat	NotreDame_De_Paris.txt 2, Miserables.txt 10
matantur	Miserables.txt 1
match	NotreDame_De_Paris.txt 3, Miserables.txt 6
matched	NotreDame_De_Paris.txt 1, Miserables.txt 1
matches	Miserables.txt 3
mate	NotreDame_De_Paris.txt 2
matefelon	NotreDame_De_Paris.txt 1
matelote	Miserables.txt 14
matelotes	Miserables.txt 1
mater	Miserables.txt 1
material	NotreDame_De_Paris.txt 3, Miserables.txt 26
materialism	Miserables.txt 4
materially	Miserables.txt 2
materials	NotreDame_De_Paris.txt 2, Miserables.txt 2
materiaux	Miserables.txt 1
maternal	NotreDame_De_Paris.txt 1, Miserables.txt 7
maternally	NotreDame_De_Paris.txt 1
maternity	NotreDame_De_Paris.txt 1, Miserables.txt 8
mates	Miserables.txt 1
mathan	Miserables.txt 1
mathematical	Miserables.txt 2
mathematically	NotreDame_De_Paris.txt 1, Miserables.txt 3
mathematician	Miserables.txt 1
mathematics	NotreDame_De_Paris.txt 2, Miserables.txt 3
mathias	NotreDame_De_Paris.txt 7
mathieu	NotreDame_De_Paris.txt 2, Miserables.txt 9
mathurin	Miserables.txt 2
mathurine	NotreDame_De_Paris.txt 1
mathurins	NotreDame_De_Paris.txt 1, Miserables.txt 3
matin	Miserables.txt 4
matins	Miserables.txt 2
mats	NotreDame_De_Paris.txt 1, Miserables.txt 2
matt	Miserables.txt 4
matter	NotreDame_De_Paris.txt 39, Miserables.txt 195
mattered	NotreDame_De_Paris.txt 2, Miserables.txt 5
matters	NotreDame_De_Paris.txt 14, Miserables.txt 37
matthew	Miserables.txt 1
matting	NotreDame_De_Paris.txt 2, Miserables.txt 1
mattock	Miserables.txt 7
mattress	NotreDame_De_Paris.txt 5, Miserables.txt 28
mattresses	NotreDame_De_Paris.txt 1, Miserables.txt 5
mature	Miserables.txt 1
maturity	Miserables.txt 1
matutinal	NotreDame_De_Paris.txt 1, Miserables.txt 2
maubert	NotreDame_De_Paris.txt 1, Miserables.txt 5
maubuee	Miserables.txt 4
mauconseil	NotreDame_De_Paris.txt 2
maugerepuis	NotreDame_De_Paris.txt 1
maugout	Miserables.txt 1
mauling	NotreDame_De_Paris.txt 1
maupetit	Miserables.txt 1
maur	NotreDame_De_Paris.txt 1, Miserables.txt 1
maurolics	Miserables.txt 1
mauvais	NotreDame_De_Paris.txt 3
mauvaises	NotreDame_De_Paris.txt 1
mauve	Miserables.txt 1
mauves	Miserables.txt 2
mavot	Miserables.txt 3
maw	NotreDame_De_Paris.txt 2, Miserables.txt 7
max	NotreDame_De_Paris.txt 2
maxim	NotreDame_De_Paris.txt 1, Miserables.txt 2
maximilian	NotreDame_De_Paris.txt 2
maxims	NotreDame_De_Paris.txt 2, Miserables.txt 1
maximum	NotreDame_De_Paris.txt 2, Miserables.txt 3
may	NotreDame_De_Paris.txt 83, Miserables.txt 357
mayagan	Miserables.txt 1
mayence	NotreDame_De_Paris.txt 1, Miserables.txt 2
mayeux	Miserables.txt 1
mayor	Miserables.txt 120
mayoralities	Miserables.txt 1
mayoralty	Miserables.txt 3
mayors	Miserables.txt 1
maypole	NotreDame_De_Paris.txt 4
maypoles	NotreDame_De_Paris.txt 1
mazarin	NotreDame_De_Paris.txt 1, Miserables.txt 1
mazarine	Miserables.txt 1
mazas	Miserables.txt 1
mazes	Miserables.txt 1
mazet	Miserables.txt 1
me	NotreDame_De_Paris.txt 510, Miserables.txt 1156
meadow	NotreDame_De_Paris.txt 3, Miserables.txt 13
meadows	NotreDame_De_Paris.txt 1, Miserables.txt 9
meagre	NotreDame_De_Paris.txt 3, Miserables.txt 8
meal	Miserables.txt 2
meals	Miserables.txt 7
mealyback	Miserables.txt 1
meam	NotreDame_De_Paris.txt 3
mean	NotreDame_De_Paris.txt 20, Miserables.txt 60
meander	NotreDame_De_Paris.txt 1
meandered	NotreDame_De_Paris.txt 1, Miserables.txt 1
meanderings	NotreDame_De_Paris.txt 1
meanest	NotreDame_De_Paris.txt 1
meaning	NotreDame_De_Paris.txt 10, Miserables.txt 27
meanings	Miserables.txt 1
means	NotreDame_De_Paris.txt 23, Miserables.txt 115
meant	NotreDame_De_Paris.txt 5, Miserables.txt 31
meantime	NotreDame_De_Paris.txt 18, Miserables.txt 53
meanwhile	NotreDame_De_Paris.txt 62, Miserables.txt 40
measure	NotreDame_De_Paris.txt 8, Miserables.txt 22
measured	NotreDame_De_Paris.txt 3, Miserables.txt 12
measureless	Miserables.txt 1
measurement	Miserables.txt 1
measurers	NotreDame_De_Paris.txt 1
measures	Miserables.txt 9
measuring	NotreDame_De_Paris.txt 2, Miserables.txt 2
meat	NotreDame_De_Paris.txt 2, Miserables.txt 22
meaux	Miserables.txt 16
mechanical	NotreDame_De_Paris.txt 4, Miserables.txt 15
mechanically	NotreDame_De_Paris.txt 10, Miserables.txt 23
mechanism	Miserables.txt 6
mechanisms	Miserables.txt 1
mechlin	Miserables.txt 3
mechtilde	Miserables.txt 3
mecistaeus	Miserables.txt 1
meck	Miserables.txt 2
medal	Miserables.txt 3
medallion	Miserables.txt 2
medallions	Miserables.txt 1
medals	Miserables.txt 1
medard	Miserables.txt 7
meddle	NotreDame_De_Paris.txt 1, Miserables.txt 3
meddles	Miserables.txt 1
media	Miserables.txt 1
mediation	Miserables.txt 1
mediatorial	Miserables.txt 1
medical	Miserables.txt 5
medici	Miserables.txt 2
medicine	NotreDame_De_Paris.txt 12, Miserables.txt 6
medicines	NotreDame_De_Paris.txt 1, Miserables.txt 1
medicis	NotreDame_De_Paris.txt 2
medine	Miserables.txt 1
mediocre	NotreDame_De_Paris.txt 2, Miserables.txt 6
mediocres	Miserables.txt 1
mediocrity	Miserables.txt 2
medit	Miserables.txt 1
meditate	NotreDame_De_Paris.txt 4, Miserables.txt 8
meditated	NotreDame_De_Paris.txt 5, Miserables.txt 28
meditates	Miserables.txt 2
meditating	NotreDame_De_Paris.txt 5, Miserables.txt 11
meditation	NotreDame_De_Paris.txt 5, Miserables.txt 26
meditations	NotreDame_De_Paris.txt 2, Miserables.txt 5
mediterranean	Miserables.txt 3
medium	NotreDame_De_Paris.txt 10, Miserables.txt 13
mediums	Miserables.txt 1
medley	NotreDame_De_Paris.txt 2
medleys	Miserables.txt 1
medusa	Miserables.txt 2
meduse	Miserables.txt 2
meeren	Miserables.txt 1
meet	NotreDame_De_Paris.txt 4, Miserables.txt 45
meeting	NotreDame_De_Paris.txt 5, Miserables.txt 16
meetings	NotreDame_De_Paris.txt 1, Miserables.txt 2
meets	Miserables.txt 7
meg	Miserables.txt 2
megaeras	Miserables.txt 1
megalopolitan	NotreDame_De_Paris.txt 1
meganthios	Miserables.txt 1
megaryon	Miserables.txt 1
megisserie	Miserables.txt 1
meinec	Miserables.txt 1
mela	Miserables.txt 1
melan	NotreDame_De_Paris.txt 1, Miserables.txt 1
melancholy	NotreDame_De_Paris.txt 15, Miserables.txt 113
melas	Miserables.txt 3
mell	NotreDame_De_Paris.txt 7, Miserables.txt 18
melliflua	NotreDame_De_Paris.txt 1
meloclioe	NotreDame_De_Paris.txt 1
melodia	NotreDame_De_Paris.txt 1
melodies	NotreDame_De_Paris.txt 2, Miserables.txt 2
melodrama	Miserables.txt 3
melodramas	Miserables.txt 1
melody	Miserables.txt 1
melon	Miserables.txt 7
melons	Miserables.txt 2
melpomene	Miserables.txt 1
melt	NotreDame_De_Paris.txt 4, Miserables.txt 7
melted	NotreDame_De_Paris.txt 12, Miserables.txt 7
melting	NotreDame_De_Paris.txt 1, Miserables.txt 2
melts	NotreDame_De_Paris.txt 1, Miserables.txt 3
melun	Miserables.txt 1
member	NotreDame_De_Paris.txt 3, Miserables.txt 33
members	NotreDame_De_Paris.txt 2, Miserables.txt 13
membranes	Miserables.txt 1
membranous	Miserables.txt 1
meme	Miserables.txt 6
memoir	Miserables.txt 1
memoire	Miserables.txt 1
memoirs	Miserables.txt 6
memorable	NotreDame_De_Paris.txt 1, Miserables.txt 9
memorandum	Miserables.txt 3
memorial	NotreDame_De_Paris.txt 2, Miserables.txt 1
memorials	NotreDame_De_Paris.txt 1
memories	Miserables.txt 18
memory	NotreDame_De_Paris.txt 25, Miserables.txt 63
men	NotreDame_De_Paris.txt 130, Miserables.txt 615
menace	NotreDame_De_Paris.txt 2, Miserables.txt 6
menaced	NotreDame_De_Paris.txt 2, Miserables.txt 7
menaces	NotreDame_De_Paris.txt 1, Miserables.txt 2
menacing	NotreDame_De_Paris.txt 2, Miserables.txt 13
menaechmus	Miserables.txt 1
menage	Miserables.txt 1
menagerie	NotreDame_De_Paris.txt 1, Miserables.txt 2
menageries	NotreDame_De_Paris.txt 1, Miserables.txt 1
menais	Miserables.txt 1
menalchme	Miserables.txt 1
mend	Miserables.txt 1
mendacious	NotreDame_De_Paris.txt 1
mended	Miserables.txt 1
mender	Miserables.txt 12
mendiant	Miserables.txt 1
mendicancy	NotreDame_De_Paris.txt 1
mendicant	NotreDame_De_Paris.txt 10, Miserables.txt 12
mendici	Miserables.txt 1
mending	Miserables.txt 1
mendon	Miserables.txt 1
menear	NotreDame_De_Paris.txt 1
menelean	NotreDame_De_Paris.txt 1
menesse	Miserables.txt 1
menetriers	Miserables.txt 1
menilmontant	Miserables.txt 9
ment	NotreDame_De_Paris.txt 2
mental	Miserables.txt 6
mentally	NotreDame_De_Paris.txt 1, Miserables.txt 2
mention	NotreDame_De_Paris.txt 7, Miserables.txt 25
mentioned	NotreDame_De_Paris.txt 3, Miserables.txt 54
mentioning	NotreDame_De_Paris.txt 2, Miserables.txt 2
meo	NotreDame_De_Paris.txt 1
mephitic	NotreDame_De_Paris.txt 1
mepity	NotreDame_De_Paris.txt 1
mer	NotreDame_De_Paris.txt 3, Miserables.txt 2
mercantile	NotreDame_De_Paris.txt 1, Miserables.txt 1
merchandise	NotreDame_De_Paris.txt 7, Miserables.txt 3
merchant	NotreDame_De_Paris.txt 7, Miserables.txt 17
merchantibility	NotreDame_De_Paris.txt 1, Miserables.txt 1
merchants	NotreDame_De_Paris.txt 7, Miserables.txt 5
merci	Miserables.txt 1
mercier	NotreDame_De_Paris.txt 1, Miserables.txt 1
merciere	Miserables.txt 1
merciful	NotreDame_De_Paris.txt 1, Miserables.txt 1
merciless	Miserables.txt 1
mercurius	NotreDame_De_Paris.txt 2
mercury	Miserables.txt 1
mercy	NotreDame_De_Paris.txt 35, Miserables.txt 18
merde	Miserables.txt 1
mere	NotreDame_De_Paris.txt 13, Miserables.txt 21
merelles	NotreDame_De_Paris.txt 1
merely	NotreDame_De_Paris.txt 13, Miserables.txt 55
meres	Miserables.txt 1
merest	Miserables.txt 2
meretricis	NotreDame_De_Paris.txt 1
mericourt	Miserables.txt 1
merino	Miserables.txt 3
merinos	Miserables.txt 1
meriones	Miserables.txt 1
merit	NotreDame_De_Paris.txt 1, Miserables.txt 7
merited	Miserables.txt 1
meritis	Miserables.txt 1
meritorious	Miserables.txt 1
merits	NotreDame_De_Paris.txt 1, Miserables.txt 6
merlan	Miserables.txt 1
merle	Miserables.txt 1
merlin	Miserables.txt 1
merlonus	Miserables.txt 2
merloussiere	Miserables.txt 1
mero	NotreDame_De_Paris.txt 1
merovingian	Miserables.txt 1
merrily	Miserables.txt 10
merriment	NotreDame_De_Paris.txt 1, Miserables.txt 1
merry	NotreDame_De_Paris.txt 11, Miserables.txt 60
merrymaking	Miserables.txt 1
mesdames	Miserables.txt 3
mesdemoiselles	NotreDame_De_Paris.txt 1
mesgrigny	Miserables.txt 1
mesh	Miserables.txt 3
meshes	NotreDame_De_Paris.txt 1, Miserables.txt 4
mesieres	Miserables.txt 2
mesmer	Miserables.txt 2
mesopotamia	NotreDame_De_Paris.txt 2
mess	Miserables.txt 2
message	NotreDame_De_Paris.txt 1, Miserables.txt 3
messager	Miserables.txt 1
messages	Miserables.txt 2
messalina	Miserables.txt 2
messeigneurs	NotreDame_De_Paris.txt 8
messenger	NotreDame_De_Paris.txt 1, Miserables.txt 5
messer	NotreDame_De_Paris.txt 3
messidor	NotreDame_De_Paris.txt 1
messier	Miserables.txt 1
messieurs	NotreDame_De_Paris.txt 16, Miserables.txt 3
messire	NotreDame_De_Paris.txt 31
messires	NotreDame_De_Paris.txt 1
mestienne	Miserables.txt 20
met	NotreDame_De_Paris.txt 13, Miserables.txt 56
metal	NotreDame_De_Paris.txt 11, Miserables.txt 2
metallic	NotreDame_De_Paris.txt 3, Miserables.txt 3
metalloids	Miserables.txt 1
metals	NotreDame_De_Paris.txt 2, Miserables.txt 1
metamorphosable	Miserables.txt 1
metamorphosed	Miserables.txt 2
metamorphoses	NotreDame_De_Paris.txt 1, Miserables.txt 1
metamorphosis	NotreDame_De_Paris.txt 1, Miserables.txt 1
metaphor	NotreDame_De_Paris.txt 1, Miserables.txt 13
metaphorical	Miserables.txt 3
metaphors	NotreDame_De_Paris.txt 1, Miserables.txt 5
metaphysical	Miserables.txt 1
metaphysics	NotreDame_De_Paris.txt 3, Miserables.txt 1
meteor	Miserables.txt 3
meteorological	Miserables.txt 1
meteors	NotreDame_De_Paris.txt 1
method	NotreDame_De_Paris.txt 1, Miserables.txt 10
methodical	Miserables.txt 3
methods	NotreDame_De_Paris.txt 1, Miserables.txt 4
methusalem	Miserables.txt 1
methuselah	Miserables.txt 1
metonymies	Miserables.txt 1
metre	Miserables.txt 2
metres	Miserables.txt 16
metropolis	NotreDame_De_Paris.txt 1, Miserables.txt 3
mets	Miserables.txt 1
metternich	Miserables.txt 3
mettre	Miserables.txt 1
metz	Miserables.txt 1
meudon	Miserables.txt 1
meulan	NotreDame_De_Paris.txt 1, Miserables.txt 1
meum	NotreDame_De_Paris.txt 1
meuniers	NotreDame_De_Paris.txt 4
meurice	Miserables.txt 1
meuse	Miserables.txt 1
mewed	Miserables.txt 1
mewing	Miserables.txt 1
meya	NotreDame_De_Paris.txt 1
mezzocane	Miserables.txt 1
mi	NotreDame_De_Paris.txt 1, Miserables.txt 2
miasma	Miserables.txt 5
miasmas	Miserables.txt 5
miasms	Miserables.txt 2
mibray	Miserables.txt 2
mice	NotreDame_De_Paris.txt 1, Miserables.txt 6
michael	NotreDame_De_Paris.txt 8, Miserables.txt 8
michel	NotreDame_De_Paris.txt 22, Miserables.txt 10
michelle	NotreDame_De_Paris.txt 1, Miserables.txt 2
microcosm	NotreDame_De_Paris.txt 1
microm	NotreDame_De_Paris.txt 1
microscope	NotreDame_De_Paris.txt 1, Miserables.txt 4
microscopic	Miserables.txt 3
mid	NotreDame_De_Paris.txt 1, Miserables.txt 14
midday	NotreDame_De_Paris.txt 11, Miserables.txt 17
middle	NotreDame_De_Paris.txt 66, Miserables.txt 78
midi	Miserables.txt 1
midnight	NotreDame_De_Paris.txt 7, Miserables.txt 29
midst	NotreDame_De_Paris.txt 40, Miserables.txt 93
midstream	NotreDame_De_Paris.txt 1
midsummer	NotreDame_De_Paris.txt 1
midway	NotreDame_De_Paris.txt 1, Miserables.txt 5
midwives	NotreDame_De_Paris.txt 2
mien	NotreDame_De_Paris.txt 13, Miserables.txt 18
miens	Miserables.txt 1
mieux	Miserables.txt 3
might	NotreDame_De_Paris.txt 58, Miserables.txt 339
mightier	Miserables.txt 1
mighty	NotreDame_De_Paris.txt 2, Miserables.txt 8
mignards	NotreDame_De_Paris.txt 1
mignon	NotreDame_De_Paris.txt 1
miguel	Miserables.txt 1
mihiel	Miserables.txt 1
mila	Miserables.txt 2
milan	NotreDame_De_Paris.txt 1, Miserables.txt 3
milch	Miserables.txt 1
mild	Miserables.txt 3
mildly	Miserables.txt 3
mildness	NotreDame_De_Paris.txt 1, Miserables.txt 2
mile	Miserables.txt 2
miles	NotreDame_De_Paris.txt 1, Miserables.txt 1
milhaud	Miserables.txt 3
miliary	Miserables.txt 2
militaire	Miserables.txt 1
militant	Miserables.txt 2
militarism	Miserables.txt 2
military	NotreDame_De_Paris.txt 8, Miserables.txt 37
militia	Miserables.txt 1
milk	NotreDame_De_Paris.txt 3, Miserables.txt 15
milky	NotreDame_De_Paris.txt 1
mill	NotreDame_De_Paris.txt 10, Miserables.txt 7
milled	Miserables.txt 1
millepeds	Miserables.txt 3
miller	NotreDame_De_Paris.txt 3, Miserables.txt 1
millet	NotreDame_De_Paris.txt 1, Miserables.txt 4
millevoye	Miserables.txt 1
millia	NotreDame_De_Paris.txt 1
milliard	Miserables.txt 2
milliards	Miserables.txt 7
million	NotreDame_De_Paris.txt 3, Miserables.txt 11
millionaire	Miserables.txt 6
millionaires	Miserables.txt 1
millionairess	Miserables.txt 1
millionnaire	Miserables.txt 9
millions	NotreDame_De_Paris.txt 2, Miserables.txt 25
mills	NotreDame_De_Paris.txt 7, Miserables.txt 3
millstone	Miserables.txt 2
millstones	Miserables.txt 1
miltiere	Miserables.txt 1
milton	Miserables.txt 3
mimae	Miserables.txt 1
mimi	Miserables.txt 1
mimic	NotreDame_De_Paris.txt 1
mind	NotreDame_De_Paris.txt 45, Miserables.txt 228
minded	NotreDame_De_Paris.txt 4, Miserables.txt 4
mindedness	Miserables.txt 1
minds	NotreDame_De_Paris.txt 4, Miserables.txt 36
mine	NotreDame_De_Paris.txt 17, Miserables.txt 39
mined	Miserables.txt 1
miner	NotreDame_De_Paris.txt 1, Miserables.txt 1
mineral	Miserables.txt 2
miners	Miserables.txt 7
minerva	Miserables.txt 3
minerve	Miserables.txt 2
mines	NotreDame_De_Paris.txt 1, Miserables.txt 7
minette	Miserables.txt 14
minever	NotreDame_De_Paris.txt 1
mingle	NotreDame_De_Paris.txt 8, Miserables.txt 11
mingled	NotreDame_De_Paris.txt 35, Miserables.txt 99
mingles	NotreDame_De_Paris.txt 1, Miserables.txt 8
mingling	NotreDame_De_Paris.txt 4, Miserables.txt 3
miniature	Miserables.txt 1
minims	Miserables.txt 1
mining	NotreDame_De_Paris.txt 1, Miserables.txt 1
minion	Miserables.txt 1
minister	NotreDame_De_Paris.txt 1, Miserables.txt 26
ministers	NotreDame_De_Paris.txt 1, Miserables.txt 3
ministry	Miserables.txt 5
minor	NotreDame_De_Paris.txt 2
minority	NotreDame_De_Paris.txt 1
minos	NotreDame_De_Paris.txt 1
minstrel	NotreDame_De_Paris.txt 3, Miserables.txt 1
mint	NotreDame_De_Paris.txt 3
minus	Miserables.txt 8
minute	NotreDame_De_Paris.txt 7, Miserables.txt 53
minuteness	Miserables.txt 2
minutes	NotreDame_De_Paris.txt 25, Miserables.txt 85
miquelets	Miserables.txt 1
mira	NotreDame_De_Paris.txt 1
mirabeau	NotreDame_De_Paris.txt 2, Miserables.txt 5
mirabelle	Miserables.txt 2
miracle	NotreDame_De_Paris.txt 9, Miserables.txt 7
miracles	NotreDame_De_Paris.txt 17, Miserables.txt 16
miracolo	Miserables.txt 1
miraculous	NotreDame_De_Paris.txt 5
miraculously	NotreDame_De_Paris.txt 1, Miserables.txt 2
mirage	Miserables.txt 3
mirages	Miserables.txt 3
miralabi	Miserables.txt 1
mirant	Miserables.txt 1
mire	NotreDame_De_Paris.txt 4, Miserables.txt 32
mirepoix	Miserables.txt 1
miring	Miserables.txt 1
mirlababo	Miserables.txt 1
mirliton	Miserables.txt 2
miroir	Miserables.txt 2
miromesnil	Miserables.txt 1
mirror	NotreDame_De_Paris.txt 2, Miserables.txt 42
mirrored	NotreDame_De_Paris.txt 1
mirrors	Miserables.txt 6
mirth	NotreDame_De_Paris.txt 8, Miserables.txt 10
mirthful	Miserables.txt 3
mis	Miserables.txt 1
misadventure	NotreDame_De_Paris.txt 2, Miserables.txt 1
misalliance	Miserables.txt 1
misalliances	Miserables.txt 1
misanthropy	NotreDame_De_Paris.txt 1
miscarriage	Miserables.txt 2
miscarried	Miserables.txt 4
miscarry	NotreDame_De_Paris.txt 1, Miserables.txt 2
mischief	NotreDame_De_Paris.txt 2, Miserables.txt 6
mischievous	NotreDame_De_Paris.txt 2, Miserables.txt 2
misconstruction	Miserables.txt 1
miscreant	Miserables.txt 1
misdeed	NotreDame_De_Paris.txt 1, Miserables.txt 1
misdeeds	NotreDame_De_Paris.txt 1, Miserables.txt 2
misdemeanor	Miserables.txt 3
misenicors	NotreDame_De_Paris.txt 1
miser	Miserables.txt 2
miserable	NotreDame_De_Paris.txt 35, Miserables.txt 37
miserables	Miserables.txt 14
miserably	NotreDame_De_Paris.txt 3
misere	Miserables.txt 1
miserere	Miserables.txt 1
misericorde	Miserables.txt 1
miseries	Miserables.txt 10
misery	NotreDame_De_Paris.txt 5, Miserables.txt 83
misfortune	NotreDame_De_Paris.txt 11, Miserables.txt 30
misfortunes	NotreDame_De_Paris.txt 2, Miserables.txt 8
misgiving	Miserables.txt 1
mishap	NotreDame_De_Paris.txt 1
misinformed	Miserables.txt 1
misinterpretation	Miserables.txt 1
misit	NotreDame_De_Paris.txt 1
misknown	NotreDame_De_Paris.txt 1
mislaid	NotreDame_De_Paris.txt 1
mislay	Miserables.txt 1
mislead	Miserables.txt 1
misled	Miserables.txt 2
miss	NotreDame_De_Paris.txt 2, Miserables.txt 13
missal	NotreDame_De_Paris.txt 3, Miserables.txt 1
missed	NotreDame_De_Paris.txt 1, Miserables.txt 11
misserable	Miserables.txt 1
missery	Miserables.txt 1
misses	Miserables.txt 3
misshapen	NotreDame_De_Paris.txt 4, Miserables.txt 15
missing	NotreDame_De_Paris.txt 2, Miserables.txt 18
mission	NotreDame_De_Paris.txt 4, Miserables.txt 9
missionaries	Miserables.txt 1
missions	Miserables.txt 1
mississippi	NotreDame_De_Paris.txt 1, Miserables.txt 1
missive	NotreDame_De_Paris.txt 1
missives	Miserables.txt 3
missolonghi	Miserables.txt 1
missouri	Miserables.txt 1
mist	NotreDame_De_Paris.txt 6, Miserables.txt 25
mistake	NotreDame_De_Paris.txt 8, Miserables.txt 41
mistaken	NotreDame_De_Paris.txt 4, Miserables.txt 30
mistakes	Miserables.txt 5
mistaking	Miserables.txt 1
mister	NotreDame_De_Paris.txt 1, Miserables.txt 6
misteriously	Miserables.txt 1
mistigri	NotreDame_De_Paris.txt 1
mistletoe	Miserables.txt 1
mistook	NotreDame_De_Paris.txt 1, Miserables.txt 1
mistress	NotreDame_De_Paris.txt 16, Miserables.txt 34
mistresses	Miserables.txt 9
mistricolle	NotreDame_De_Paris.txt 4
mistrust	Miserables.txt 1
mists	NotreDame_De_Paris.txt 5, Miserables.txt 10
misty	NotreDame_De_Paris.txt 3, Miserables.txt 2
misunderstanding	Miserables.txt 2
misunderstood	Miserables.txt 1
misused	Miserables.txt 1
mitchell	Miserables.txt 2
mite	Miserables.txt 2
mitigated	Miserables.txt 1
mitigation	NotreDame_De_Paris.txt 1
mitou	NotreDame_De_Paris.txt 1
mitraille	Miserables.txt 1
mitre	NotreDame_De_Paris.txt 2, Miserables.txt 2
mitred	NotreDame_De_Paris.txt 1, Miserables.txt 1
mitres	NotreDame_De_Paris.txt 4, Miserables.txt 3
mitron	Miserables.txt 1
mittimus	NotreDame_De_Paris.txt 1
mix	Miserables.txt 2
mixed	NotreDame_De_Paris.txt 7, Miserables.txt 14
mixing	Miserables.txt 1
mixture	NotreDame_De_Paris.txt 5, Miserables.txt 13
mixtures	NotreDame_De_Paris.txt 1
mm	Miserables.txt 2
mme	Miserables.txt 1
mo	Miserables.txt 1
moan	NotreDame_De_Paris.txt 1
moans	Miserables.txt 1
moat	NotreDame_De_Paris.txt 3, Miserables.txt 3
moats	Miserables.txt 1
mob	NotreDame_De_Paris.txt 1, Miserables.txt 10
mobile	Miserables.txt 1
mobility	NotreDame_De_Paris.txt 1
mobs	Miserables.txt 1
mock	NotreDame_De_Paris.txt 2, Miserables.txt 1
mocked	NotreDame_De_Paris.txt 1
mocker	NotreDame_De_Paris.txt 1
mockery	NotreDame_De_Paris.txt 1, Miserables.txt 4
mocking	NotreDame_De_Paris.txt 6, Miserables.txt 1
mode	NotreDame_De_Paris.txt 7, Miserables.txt 15
model	Miserables.txt 6
modelled	Miserables.txt 1
modena	Miserables.txt 1
moderata	NotreDame_De_Paris.txt 1
moderate	NotreDame_De_Paris.txt 2, Miserables.txt 9
moderated	Miserables.txt 1
moderately	Miserables.txt 4
moderates	Miserables.txt 1
moderation	Miserables.txt 1
modern	NotreDame_De_Paris.txt 10, Miserables.txt 9
moderns	Miserables.txt 1
modes	Miserables.txt 1
modest	NotreDame_De_Paris.txt 1, Miserables.txt 11
modestly	NotreDame_De_Paris.txt 2, Miserables.txt 1
modesty	NotreDame_De_Paris.txt 8, Miserables.txt 21
modicum	Miserables.txt 2
modification	NotreDame_De_Paris.txt 1, Miserables.txt 2
modifications	Miserables.txt 1
modified	NotreDame_De_Paris.txt 4, Miserables.txt 6
modify	Miserables.txt 1
modiste	Miserables.txt 1
modulations	NotreDame_De_Paris.txt 1
modus	Miserables.txt 1
moere	NotreDame_De_Paris.txt 1
mohammed	Miserables.txt 1
mohammedan	Miserables.txt 1
mohammedanism	Miserables.txt 1
moi	NotreDame_De_Paris.txt 1, Miserables.txt 2
moine	NotreDame_De_Paris.txt 1
moineaux	NotreDame_De_Paris.txt 1, Miserables.txt 1
moire	Miserables.txt 6
moires	Miserables.txt 1
mois	Miserables.txt 2
moise	NotreDame_De_Paris.txt 1
moisson	Miserables.txt 1
moist	NotreDame_De_Paris.txt 2, Miserables.txt 2
moistened	Miserables.txt 2
moisture	NotreDame_De_Paris.txt 1, Miserables.txt 3
mokanna	Miserables.txt 1
mole	NotreDame_De_Paris.txt 2, Miserables.txt 6
molecule	NotreDame_De_Paris.txt 3, Miserables.txt 1
molecules	Miserables.txt 1
molendin	NotreDame_De_Paris.txt 1
molendino	NotreDame_De_Paris.txt 5
molesme	Miserables.txt 1
moliere	NotreDame_De_Paris.txt 1, Miserables.txt 10
mollet	NotreDame_De_Paris.txt 2
momacque	Miserables.txt 1
moment	NotreDame_De_Paris.txt 261, Miserables.txt 564
momentarily	Miserables.txt 3
momentary	NotreDame_De_Paris.txt 3, Miserables.txt 13
moments	NotreDame_De_Paris.txt 38, Miserables.txt 91
momes	Miserables.txt 1
momignard	Miserables.txt 1
momignards	Miserables.txt 1
mommol	Miserables.txt 1
mon	NotreDame_De_Paris.txt 5, Miserables.txt 31
monarch	NotreDame_De_Paris.txt 2, Miserables.txt 3
monarchical	Miserables.txt 6
monarchie	Miserables.txt 1
monarchies	Miserables.txt 2
monarchs	Miserables.txt 1
monarchy	Miserables.txt 29
monasteries	Miserables.txt 5
monastery	NotreDame_De_Paris.txt 4, Miserables.txt 10
monastic	Miserables.txt 3
monasticism	Miserables.txt 6
monceaux	Miserables.txt 1
monday	NotreDame_De_Paris.txt 1, Miserables.txt 2
monde	Miserables.txt 2
mondetour	Miserables.txt 31
money	NotreDame_De_Paris.txt 39, Miserables.txt 132
moneyed	Miserables.txt 1
monger	Miserables.txt 1
moniteur	NotreDame_De_Paris.txt 1, Miserables.txt 11
monitor	NotreDame_De_Paris.txt 2
monk	NotreDame_De_Paris.txt 21, Miserables.txt 11
monkey	NotreDame_De_Paris.txt 8, Miserables.txt 4
monkeys	NotreDame_De_Paris.txt 2, Miserables.txt 3
monkish	Miserables.txt 1
monks	NotreDame_De_Paris.txt 2, Miserables.txt 8
monnot	Miserables.txt 1
monolithic	NotreDame_De_Paris.txt 1
monologue	NotreDame_De_Paris.txt 2, Miserables.txt 6
monologues	NotreDame_De_Paris.txt 1, Miserables.txt 3
monopoly	NotreDame_De_Paris.txt 1, Miserables.txt 1
monorhymed	Miserables.txt 1
monosyllable	Miserables.txt 1
monosyllables	Miserables.txt 2
monotonies	Miserables.txt 1
monotonous	NotreDame_De_Paris.txt 5, Miserables.txt 4
monroyal	NotreDame_De_Paris.txt 1
monseigheur	NotreDame_De_Paris.txt 1
monseigneur	NotreDame_De_Paris.txt 39, Miserables.txt 89
monsiegneur	NotreDame_De_Paris.txt 1
monsieur	NotreDame_De_Paris.txt 138, Miserables.txt 369
monsignor	Miserables.txt 4
monsiuer	Miserables.txt 1
monster	NotreDame_De_Paris.txt 18, Miserables.txt 41
monsters	NotreDame_De_Paris.txt 11, Miserables.txt 9
monstrosities	Miserables.txt 1
monstrous	NotreDame_De_Paris.txt 23, Miserables.txt 46
monstrously	Miserables.txt 1
monstrurn	NotreDame_De_Paris.txt 1
mont	Miserables.txt 51
montagu	NotreDame_De_Paris.txt 1
montaigu	NotreDame_De_Paris.txt 2
montals	Miserables.txt 1
montargis	NotreDame_De_Paris.txt 1
montarlot	Miserables.txt 1
montauban	Miserables.txt 2
montbazon	Miserables.txt 1
montbrison	Miserables.txt 1
montcalm	Miserables.txt 1
montchenu	Miserables.txt 1
montdidier	Miserables.txt 1
monte	Miserables.txt 1
montebello	Miserables.txt 2
montenotte	Miserables.txt 2
montes	Miserables.txt 1
montesquieu	Miserables.txt 1
monteynard	Miserables.txt 1
montfau	NotreDame_De_Paris.txt 11
montfaucon	Miserables.txt 2
montfermeil	Miserables.txt 76
montgomery	Miserables.txt 1
month	NotreDame_De_Paris.txt 24, Miserables.txt 64
monthly	Miserables.txt 1
months	NotreDame_De_Paris.txt 16, Miserables.txt 95
montilz	NotreDame_De_Paris.txt 1
montlh	NotreDame_De_Paris.txt 3
montmartre	NotreDame_De_Paris.txt 3, Miserables.txt 8
montmatre	Miserables.txt 1
montmichel	NotreDame_De_Paris.txt 4
montmirail	Miserables.txt 2
montmorency	NotreDame_De_Paris.txt 1, Miserables.txt 2
montorgueil	NotreDame_De_Paris.txt 1, Miserables.txt 3
montparnasse	Miserables.txt 90
montpellier	Miserables.txt 1
montpercy	Miserables.txt 1
montre	Miserables.txt 2
montreuil	Miserables.txt 4
montrevel	Miserables.txt 1
montrouge	NotreDame_De_Paris.txt 1, Miserables.txt 1
montvernet	Miserables.txt 1
monument	NotreDame_De_Paris.txt 15, Miserables.txt 10
monumental	NotreDame_De_Paris.txt 4, Miserables.txt 7
monuments	NotreDame_De_Paris.txt 18, Miserables.txt 2
mood	NotreDame_De_Paris.txt 4, Miserables.txt 7
moods	NotreDame_De_Paris.txt 1
moon	NotreDame_De_Paris.txt 16, Miserables.txt 42
moonless	NotreDame_De_Paris.txt 1
moonlight	NotreDame_De_Paris.txt 8, Miserables.txt 10
moor	Miserables.txt 2
moored	NotreDame_De_Paris.txt 1, Miserables.txt 3
moorings	NotreDame_De_Paris.txt 1
moorish	NotreDame_De_Paris.txt 1
moors	NotreDame_De_Paris.txt 1, Miserables.txt 1
mopped	Miserables.txt 1
moral	NotreDame_De_Paris.txt 5, Miserables.txt 32
morale	NotreDame_De_Paris.txt 1
morality	NotreDame_De_Paris.txt 13, Miserables.txt 10
moralizing	Miserables.txt 2
morally	Miserables.txt 3
morals	Miserables.txt 2
morand	Miserables.txt 1
morasses	Miserables.txt 1
morbigou	Miserables.txt 1
morbleu	Miserables.txt 1
morbus	Miserables.txt 1
more	NotreDame_De_Paris.txt 487, Miserables.txt 1130
moreau	Miserables.txt 1
moreover	NotreDame_De_Paris.txt 51, Miserables.txt 132
moret	Miserables.txt 1
morey	Miserables.txt 1
morgue	Miserables.txt 1
morillo	Miserables.txt 2
morillos	Miserables.txt 1
morin	Miserables.txt 1
morion	NotreDame_De_Paris.txt 2, Miserables.txt 1
moriturum	Miserables.txt 2
morland	Miserables.txt 3
morn	NotreDame_De_Paris.txt 1, Miserables.txt 3
morning	NotreDame_De_Paris.txt 60, Miserables.txt 235
mornings	NotreDame_De_Paris.txt 2
morocco	Miserables.txt 2
morose	NotreDame_De_Paris.txt 5, Miserables.txt 1
morrow	NotreDame_De_Paris.txt 25, Miserables.txt 110
morsant	NotreDame_De_Paris.txt 1
morsel	NotreDame_De_Paris.txt 1, Miserables.txt 7
morsels	NotreDame_De_Paris.txt 1, Miserables.txt 2
mortal	NotreDame_De_Paris.txt 2, Miserables.txt 4
mortality	Miserables.txt 2
mortally	Miserables.txt 1
mortals	Miserables.txt 5
mortar	NotreDame_De_Paris.txt 1, Miserables.txt 5
morte	NotreDame_De_Paris.txt 1
mortellerie	Miserables.txt 1
mortgages	Miserables.txt 1
mortgagor	Miserables.txt 1
mortier	Miserables.txt 1
mortification	NotreDame_De_Paris.txt 1
mortifications	NotreDame_De_Paris.txt 1, Miserables.txt 1
mortified	Miserables.txt 1
mortises	NotreDame_De_Paris.txt 1
mortuary	Miserables.txt 1
mortuology	NotreDame_De_Paris.txt 1
mortuus	Miserables.txt 2
morvan	Miserables.txt 1
morvilliers	NotreDame_De_Paris.txt 1
mos	Miserables.txt 1
mosaic	NotreDame_De_Paris.txt 1
mosaics	NotreDame_De_Paris.txt 1
moscow	Miserables.txt 2
moses	NotreDame_De_Paris.txt 1, Miserables.txt 4
moskowa	Miserables.txt 2
mosque	NotreDame_De_Paris.txt 2, Miserables.txt 2
moss	NotreDame_De_Paris.txt 1, Miserables.txt 7
mosses	Miserables.txt 3
most	NotreDame_De_Paris.txt 88, Miserables.txt 332
mostly	Miserables.txt 1
mot	Miserables.txt 1
motets	NotreDame_De_Paris.txt 1
moth	Miserables.txt 2
mothe	Miserables.txt 1
mother	NotreDame_De_Paris.txt 123, Miserables.txt 362
mothers	NotreDame_De_Paris.txt 6, Miserables.txt 45
motion	NotreDame_De_Paris.txt 17, Miserables.txt 16
motioned	NotreDame_De_Paris.txt 2, Miserables.txt 1
motionless	NotreDame_De_Paris.txt 32, Miserables.txt 75
motive	NotreDame_De_Paris.txt 4, Miserables.txt 6
motives	Miserables.txt 7
motley	NotreDame_De_Paris.txt 8, Miserables.txt 1
motor	Miserables.txt 1
motors	Miserables.txt 2
motto	Miserables.txt 2
mouachis	NotreDame_De_Paris.txt 1
moubon	NotreDame_De_Paris.txt 3
mouche	Miserables.txt 1
mouffetard	Miserables.txt 10
mould	NotreDame_De_Paris.txt 1, Miserables.txt 10
moulded	Miserables.txt 4
moulding	Miserables.txt 2
mouldy	NotreDame_De_Paris.txt 5, Miserables.txt 6
moulin	NotreDame_De_Paris.txt 12
moulins	Miserables.txt 2
moulting	Miserables.txt 1
mound	NotreDame_De_Paris.txt 1, Miserables.txt 2
mount	NotreDame_De_Paris.txt 17, Miserables.txt 12
mountain	NotreDame_De_Paris.txt 2, Miserables.txt 18
mountaineers	Miserables.txt 3
mountainous	NotreDame_De_Paris.txt 1, Miserables.txt 2
mountains	NotreDame_De_Paris.txt 8, Miserables.txt 20
mountebank	Miserables.txt 8
mountebanks	Miserables.txt 2
mounted	NotreDame_De_Paris.txt 24, Miserables.txt 45
mounting	NotreDame_De_Paris.txt 7, Miserables.txt 17
mounts	NotreDame_De_Paris.txt 2, Miserables.txt 14
mourn	NotreDame_De_Paris.txt 1, Miserables.txt 3
mourned	Miserables.txt 1
mournful	NotreDame_De_Paris.txt 1, Miserables.txt 30
mournfully	NotreDame_De_Paris.txt 1, Miserables.txt 5
mourning	NotreDame_De_Paris.txt 5, Miserables.txt 22
mourut	Miserables.txt 1
mouse	NotreDame_De_Paris.txt 2, Miserables.txt 14
mousetrap	Miserables.txt 1
mousquetaire	Miserables.txt 1
mousquetaires	Miserables.txt 1
mousqueton	Miserables.txt 1
mousson	Miserables.txt 1
moussu	Miserables.txt 1
moustache	NotreDame_De_Paris.txt 4, Miserables.txt 1
moustaches	Miserables.txt 2
moutardes	Miserables.txt 1
mouth	NotreDame_De_Paris.txt 37, Miserables.txt 101
mouthed	Miserables.txt 2
mouthful	NotreDame_De_Paris.txt 1, Miserables.txt 4
mouthfuls	Miserables.txt 2
mouthing	Miserables.txt 1
mouths	NotreDame_De_Paris.txt 13, Miserables.txt 27
mouton	NotreDame_De_Paris.txt 2
moutu	Miserables.txt 1
movable	NotreDame_De_Paris.txt 2, Miserables.txt 2
move	NotreDame_De_Paris.txt 11, Miserables.txt 18
moved	NotreDame_De_Paris.txt 23, Miserables.txt 52
movement	NotreDame_De_Paris.txt 27, Miserables.txt 103
movements	NotreDame_De_Paris.txt 3, Miserables.txt 26
moves	NotreDame_De_Paris.txt 2, Miserables.txt 2
moving	NotreDame_De_Paris.txt 17, Miserables.txt 29
mow	Miserables.txt 1
mowed	NotreDame_De_Paris.txt 1, Miserables.txt 1
mower	Miserables.txt 1
mown	Miserables.txt 3
mr	Miserables.txt 53
muce	NotreDame_De_Paris.txt 1
much	NotreDame_De_Paris.txt 126, Miserables.txt 328
muche	Miserables.txt 2
mud	NotreDame_De_Paris.txt 12, Miserables.txt 47
mudas	NotreDame_De_Paris.txt 1
muddy	NotreDame_De_Paris.txt 1, Miserables.txt 10
muff	Miserables.txt 2
muffle	Miserables.txt 1
muffled	NotreDame_De_Paris.txt 2, Miserables.txt 2
mufflers	Miserables.txt 1
muffling	Miserables.txt 2
mugs	Miserables.txt 1
muison	NotreDame_De_Paris.txt 1
mule	NotreDame_De_Paris.txt 8, Miserables.txt 1
mules	NotreDame_De_Paris.txt 2, Miserables.txt 1
muleteer	NotreDame_De_Paris.txt 1, Miserables.txt 1
mulieres	NotreDame_De_Paris.txt 1, Miserables.txt 1
mulleins	Miserables.txt 1
mullions	NotreDame_De_Paris.txt 1
multa	NotreDame_De_Paris.txt 1
multiform	NotreDame_De_Paris.txt 2
multiple	NotreDame_De_Paris.txt 1, Miserables.txt 1
multiplication	NotreDame_De_Paris.txt 1, Miserables.txt 2
multiplied	NotreDame_De_Paris.txt 6, Miserables.txt 8
multiplies	Miserables.txt 1
multiply	NotreDame_De_Paris.txt 2, Miserables.txt 6
multiplying	Miserables.txt 2
multis	NotreDame_De_Paris.txt 1
multitude	NotreDame_De_Paris.txt 12, Miserables.txt 25
multitudes	NotreDame_De_Paris.txt 1, Miserables.txt 6
multum	Miserables.txt 1
mumble	NotreDame_De_Paris.txt 2
mumbled	NotreDame_De_Paris.txt 1, Miserables.txt 3
mumbling	Miserables.txt 2
mummer	NotreDame_De_Paris.txt 1
mummeries	NotreDame_De_Paris.txt 2
mummery	NotreDame_De_Paris.txt 1
mummified	Miserables.txt 1
mummol	NotreDame_De_Paris.txt 1
mummy	NotreDame_De_Paris.txt 1, Miserables.txt 1
munatius	Miserables.txt 1
mundus	NotreDame_De_Paris.txt 1
municipal	NotreDame_De_Paris.txt 1, Miserables.txt 23
municipalities	Miserables.txt 1
municipality	Miserables.txt 2
munitions	NotreDame_De_Paris.txt 1, Miserables.txt 3
munophis	Miserables.txt 1
munster	Miserables.txt 1
mur	NotreDame_De_Paris.txt 1, Miserables.txt 20
mural	Miserables.txt 1
murant	NotreDame_De_Paris.txt 1
murat	Miserables.txt 2
murder	NotreDame_De_Paris.txt 5, Miserables.txt 9
murdered	NotreDame_De_Paris.txt 2, Miserables.txt 4
murderer	NotreDame_De_Paris.txt 1, Miserables.txt 6
murderers	Miserables.txt 4
murdering	Miserables.txt 2
murders	Miserables.txt 1
mureaux	NotreDame_De_Paris.txt 1
murky	Miserables.txt 1
murmur	NotreDame_De_Paris.txt 12, Miserables.txt 22
murmurant	NotreDame_De_Paris.txt 1
murmured	NotreDame_De_Paris.txt 18, Miserables.txt 42
murmuring	NotreDame_De_Paris.txt 2, Miserables.txt 8
murmurs	NotreDame_De_Paris.txt 1, Miserables.txt 6
musagetes	NotreDame_De_Paris.txt 1
musain	Miserables.txt 13
musc	Miserables.txt 1
muscle	Miserables.txt 2
muscles	NotreDame_De_Paris.txt 4, Miserables.txt 7
muscovites	NotreDame_De_Paris.txt 1
muscular	Miserables.txt 1
muse	Miserables.txt 1
musebois	Miserables.txt 1
muses	NotreDame_De_Paris.txt 1, Miserables.txt 1
museum	NotreDame_De_Paris.txt 1, Miserables.txt 5
mushrooms	Miserables.txt 1
music	NotreDame_De_Paris.txt 16, Miserables.txt 17
musical	NotreDame_De_Paris.txt 4, Miserables.txt 2
musichetta	Miserables.txt 2
musician	NotreDame_De_Paris.txt 1, Miserables.txt 3
musicians	NotreDame_De_Paris.txt 3, Miserables.txt 1
musing	Miserables.txt 1
musings	Miserables.txt 1
musket	NotreDame_De_Paris.txt 1, Miserables.txt 7
musketeer	NotreDame_De_Paris.txt 1
musketeers	Miserables.txt 1
musketry	NotreDame_De_Paris.txt 2, Miserables.txt 9
muskets	Miserables.txt 5
muskowa	Miserables.txt 1
muslin	Miserables.txt 4
muslins	Miserables.txt 1
musnier	NotreDame_De_Paris.txt 10
musses	Miserables.txt 1
must	NotreDame_De_Paris.txt 133, Miserables.txt 523
mustache	Miserables.txt 4
mustaches	Miserables.txt 6
mustards	Miserables.txt 1
musters	NotreDame_De_Paris.txt 1
mustn	Miserables.txt 2
mutations	Miserables.txt 1
mute	NotreDame_De_Paris.txt 9, Miserables.txt 27
mutes	Miserables.txt 1
mutilated	NotreDame_De_Paris.txt 4, Miserables.txt 2
mutilating	Miserables.txt 1
mutilation	Miserables.txt 1
mutilations	NotreDame_De_Paris.txt 3
mutinies	NotreDame_De_Paris.txt 1
mutiny	NotreDame_De_Paris.txt 2
mutor	Miserables.txt 1
mutter	Miserables.txt 4
muttered	NotreDame_De_Paris.txt 21, Miserables.txt 25
muttering	NotreDame_De_Paris.txt 2, Miserables.txt 4
mutterings	Miserables.txt 1
mutton	Miserables.txt 4
mutual	Miserables.txt 5
mutualists	Miserables.txt 1
mutually	Miserables.txt 3
muzhik	Miserables.txt 1
muzzle	NotreDame_De_Paris.txt 3, Miserables.txt 9
muzzled	Miserables.txt 1
muzzles	Miserables.txt 2
my	NotreDame_De_Paris.txt 599, Miserables.txt 1168
myriad	NotreDame_De_Paris.txt 1
myriads	NotreDame_De_Paris.txt 2
myriel	Miserables.txt 33
myrmidons	Miserables.txt 1
myrrhinus	Miserables.txt 1
myrtle	Miserables.txt 1
myself	NotreDame_De_Paris.txt 43, Miserables.txt 144
mysteries	NotreDame_De_Paris.txt 1, Miserables.txt 14
mysterious	NotreDame_De_Paris.txt 27, Miserables.txt 120
mysteriously	NotreDame_De_Paris.txt 1, Miserables.txt 1
mystery	NotreDame_De_Paris.txt 36, Miserables.txt 40
mystic	NotreDame_De_Paris.txt 1, Miserables.txt 1
mystical	NotreDame_De_Paris.txt 1, Miserables.txt 1
mysticism	Miserables.txt 1
mystification	Miserables.txt 2
myth	NotreDame_De_Paris.txt 4
mythological	Miserables.txt 1
mythology	Miserables.txt 2
myths	Miserables.txt 1
