d	Miserables.txt 183, NotreDame_De_Paris.txt 52
dab	Miserables.txt 2
dabbled	Miserables.txt 1
dabs	Miserables.txt 1
dabuge	Miserables.txt 1
dactyl	NotreDame_De_Paris.txt 1
daddy	Miserables.txt 3
dado	Miserables.txt 1
dados	NotreDame_De_Paris.txt 1
daedalus	NotreDame_De_Paris.txt 4, Miserables.txt 1
daelli	Miserables.txt 1
daemonum	NotreDame_De_Paris.txt 1
dagger	NotreDame_De_Paris.txt 11, Miserables.txt 8
daggers	NotreDame_De_Paris.txt 5
dagobert	NotreDame_De_Paris.txt 1
dague	Miserables.txt 1
dahlia	Miserables.txt 19
dahlias	Miserables.txt 2
dahuille	NotreDame_De_Paris.txt 1
daigning	Miserables.txt 1
dail	Miserables.txt 1
daily	Miserables.txt 7, NotreDame_De_Paris.txt 1
daim	NotreDame_De_Paris.txt 6
dainties	NotreDame_De_Paris.txt 1, Miserables.txt 1
daintily	Miserables.txt 1
daintiness	NotreDame_De_Paris.txt 2
dainty	NotreDame_De_Paris.txt 3, Miserables.txt 3
dairies	Miserables.txt 4
dais	NotreDame_De_Paris.txt 4, Miserables.txt 3
daisies	Miserables.txt 3, NotreDame_De_Paris.txt 1
daisy	NotreDame_De_Paris.txt 3, Miserables.txt 2
daiz	NotreDame_De_Paris.txt 1
dallemagne	Miserables.txt 1
dalmatics	NotreDame_De_Paris.txt 1
dalmatie	Miserables.txt 1
dam	Miserables.txt 1
damage	Miserables.txt 5, NotreDame_De_Paris.txt 3
damaged	Miserables.txt 4, NotreDame_De_Paris.txt 1
damages	NotreDame_De_Paris.txt 5, Miserables.txt 5
damas	Miserables.txt 1
damascened	NotreDame_De_Paris.txt 1
damascus	Miserables.txt 2
damasippus	Miserables.txt 1
damask	Miserables.txt 8, NotreDame_De_Paris.txt 5
damasks	Miserables.txt 1
damb	Miserables.txt 1
dambray	Miserables.txt 2
dame	NotreDame_De_Paris.txt 177, Miserables.txt 17
dames	NotreDame_De_Paris.txt 5, Miserables.txt 1
dammed	NotreDame_De_Paris.txt 1
damn	NotreDame_De_Paris.txt 1
damnable	NotreDame_De_Paris.txt 1
damnation	NotreDame_De_Paris.txt 5, Miserables.txt 4
damned	NotreDame_De_Paris.txt 8, Miserables.txt 7
damnerais	Miserables.txt 1
damoiselle	NotreDame_De_Paris.txt 6
damoiselles	NotreDame_De_Paris.txt 2
damp	Miserables.txt 11, NotreDame_De_Paris.txt 2
dampen	Miserables.txt 1
damper	Miserables.txt 2
dampmartin	NotreDame_De_Paris.txt 1
dampness	Miserables.txt 4, NotreDame_De_Paris.txt 2
damsel	NotreDame_De_Paris.txt 6
damsels	NotreDame_De_Paris.txt 9
dance	NotreDame_De_Paris.txt 15, Miserables.txt 10
danced	NotreDame_De_Paris.txt 5, Miserables.txt 5
dancer	NotreDame_De_Paris.txt 29, Miserables.txt 5
dancers	Miserables.txt 3
dances	Miserables.txt 5, NotreDame_De_Paris.txt 4
dancing	NotreDame_De_Paris.txt 14, Miserables.txt 4
dand	NotreDame_De_Paris.txt 1
dandelions	Miserables.txt 2
dandies	Miserables.txt 3
dandified	Miserables.txt 2
dandle	Miserables.txt 1
dandling	Miserables.txt 1
dandy	Miserables.txt 10
danger	Miserables.txt 38, NotreDame_De_Paris.txt 5
dangerous	Miserables.txt 31
dangerously	Miserables.txt 2
dangers	Miserables.txt 6, NotreDame_De_Paris.txt 2
dangle	Miserables.txt 1
dangling	NotreDame_De_Paris.txt 2, Miserables.txt 1
dans	Miserables.txt 20, NotreDame_De_Paris.txt 1
dante	Miserables.txt 13, NotreDame_De_Paris.txt 5
dantes	Miserables.txt 1
danton	Miserables.txt 14
danube	Miserables.txt 1
daphnis	Miserables.txt 1
dapifero	NotreDame_De_Paris.txt 1
dappes	Miserables.txt 1
dappled	NotreDame_De_Paris.txt 1
dardant	Miserables.txt 1
dare	Miserables.txt 23, NotreDame_De_Paris.txt 7
dared	Miserables.txt 36, NotreDame_De_Paris.txt 18
dares	Miserables.txt 2, NotreDame_De_Paris.txt 1
daring	Miserables.txt 28, NotreDame_De_Paris.txt 5
dark	Miserables.txt 119, NotreDame_De_Paris.txt 44
darkened	NotreDame_De_Paris.txt 1
darker	Miserables.txt 1
darkest	NotreDame_De_Paris.txt 2, Miserables.txt 2
darkly	NotreDame_De_Paris.txt 1
darkmans	Miserables.txt 1
darkness	Miserables.txt 141, NotreDame_De_Paris.txt 23
darknesses	Miserables.txt 1
darling	Miserables.txt 5
darned	Miserables.txt 1
daron	Miserables.txt 1
dart	Miserables.txt 5, NotreDame_De_Paris.txt 3
darted	Miserables.txt 17, NotreDame_De_Paris.txt 8
darting	Miserables.txt 5, NotreDame_De_Paris.txt 1
darts	Miserables.txt 3
das	Miserables.txt 1
dash	Miserables.txt 7, NotreDame_De_Paris.txt 5
dashed	NotreDame_De_Paris.txt 8, Miserables.txt 7
dashes	NotreDame_De_Paris.txt 3, Miserables.txt 2
dashing	Miserables.txt 4, NotreDame_De_Paris.txt 1
data	Miserables.txt 2, NotreDame_De_Paris.txt 1
date	Miserables.txt 34, NotreDame_De_Paris.txt 10
dated	Miserables.txt 3, NotreDame_De_Paris.txt 2
dates	Miserables.txt 6, NotreDame_De_Paris.txt 1
dating	NotreDame_De_Paris.txt 2, Miserables.txt 1
datum	NotreDame_De_Paris.txt 1
daub	Miserables.txt 4, NotreDame_De_Paris.txt 1
daubed	Miserables.txt 3, NotreDame_De_Paris.txt 1
dauber	Miserables.txt 1
daubing	Miserables.txt 5
daubs	Miserables.txt 1
dauby	NotreDame_De_Paris.txt 1
daughter	Miserables.txt 124, NotreDame_De_Paris.txt 83
daughters	Miserables.txt 38, NotreDame_De_Paris.txt 2
daumesnil	NotreDame_De_Paris.txt 1
daumont	Miserables.txt 1
dauphin	NotreDame_De_Paris.txt 13, Miserables.txt 4
dauphine	Miserables.txt 4, NotreDame_De_Paris.txt 2
dauphines	Miserables.txt 1
dauphiness	NotreDame_De_Paris.txt 2
dauphins	Miserables.txt 5
dauphiny	NotreDame_De_Paris.txt 1
dautin	Miserables.txt 1
dautun	Miserables.txt 1
dauvet	NotreDame_De_Paris.txt 1
david	Miserables.txt 7
dawn	Miserables.txt 64, NotreDame_De_Paris.txt 3
dawned	Miserables.txt 2
dawning	Miserables.txt 9, NotreDame_De_Paris.txt 1
dawns	Miserables.txt 2
day	Miserables.txt 805, NotreDame_De_Paris.txt 249
daybreak	Miserables.txt 29, NotreDame_De_Paris.txt 4
daylight	Miserables.txt 54, NotreDame_De_Paris.txt 10
days	Miserables.txt 192, NotreDame_De_Paris.txt 45
daytime	Miserables.txt 5
dazed	NotreDame_De_Paris.txt 4
dazzle	Miserables.txt 3
dazzled	Miserables.txt 33, NotreDame_De_Paris.txt 6
dazzlement	NotreDame_De_Paris.txt 1
dazzles	NotreDame_De_Paris.txt 1, Miserables.txt 1
dazzling	Miserables.txt 28, NotreDame_De_Paris.txt 15
dazzlingly	Miserables.txt 2
de	Miserables.txt 639, NotreDame_De_Paris.txt 409
dea	NotreDame_De_Paris.txt 1
deacon	NotreDame_De_Paris.txt 2, Miserables.txt 1
deacons	NotreDame_De_Paris.txt 1
dead	Miserables.txt 249, NotreDame_De_Paris.txt 61
deaden	Miserables.txt 4
deadened	Miserables.txt 3
deadly	Miserables.txt 3
deaf	NotreDame_De_Paris.txt 76, Miserables.txt 17
deafen	NotreDame_De_Paris.txt 2
deafened	Miserables.txt 2, NotreDame_De_Paris.txt 1
deafening	NotreDame_De_Paris.txt 5, Miserables.txt 3
deafness	NotreDame_De_Paris.txt 6, Miserables.txt 2
deal	Miserables.txt 76, NotreDame_De_Paris.txt 21
dealer	Miserables.txt 16, NotreDame_De_Paris.txt 1
dealers	Miserables.txt 4
dealing	Miserables.txt 3, NotreDame_De_Paris.txt 1
dealings	NotreDame_De_Paris.txt 2
deals	Miserables.txt 3
dealt	NotreDame_De_Paris.txt 7, Miserables.txt 3
dean	Miserables.txt 1
deaneries	NotreDame_De_Paris.txt 1
deans	NotreDame_De_Paris.txt 1
dear	Miserables.txt 44, NotreDame_De_Paris.txt 41
dearer	Miserables.txt 1
dearest	Miserables.txt 5
dearly	Miserables.txt 7, NotreDame_De_Paris.txt 3
dearness	Miserables.txt 1
death	Miserables.txt 243, NotreDame_De_Paris.txt 65
deathblow	NotreDame_De_Paris.txt 1
deathly	Miserables.txt 1
deaths	Miserables.txt 4
debacchantis	NotreDame_De_Paris.txt 1
debacchatio	NotreDame_De_Paris.txt 1
debacker	Miserables.txt 1
debarcation	NotreDame_De_Paris.txt 1
debarring	NotreDame_De_Paris.txt 1
debased	Miserables.txt 3
debasements	NotreDame_De_Paris.txt 1
debasing	Miserables.txt 1
debate	Miserables.txt 4
debated	NotreDame_De_Paris.txt 1
debates	NotreDame_De_Paris.txt 1
debauch	NotreDame_De_Paris.txt 1
debauched	Miserables.txt 2
debauchees	NotreDame_De_Paris.txt 2
debaucheries	Miserables.txt 1
debauchery	NotreDame_De_Paris.txt 4, Miserables.txt 2
debauching	Miserables.txt 1
debet	NotreDame_De_Paris.txt 1
debilitated	Miserables.txt 1
debou	NotreDame_De_Paris.txt 2
debouch	Miserables.txt 2, NotreDame_De_Paris.txt 1
debouched	Miserables.txt 4, NotreDame_De_Paris.txt 3
debouches	Miserables.txt 1
debrye	Miserables.txt 1
debt	Miserables.txt 15, NotreDame_De_Paris.txt 1
debtor	NotreDame_De_Paris.txt 1, Miserables.txt 1
debtors	Miserables.txt 1
debts	Miserables.txt 9, NotreDame_De_Paris.txt 1
dec	Miserables.txt 1
decadence	NotreDame_De_Paris.txt 4
decamp	Miserables.txt 4
decamped	Miserables.txt 1
decamping	Miserables.txt 1
decantantur	NotreDame_De_Paris.txt 1
decanter	Miserables.txt 1
decapitate	NotreDame_De_Paris.txt 1
decapitated	Miserables.txt 3
decarade	Miserables.txt 1
decay	Miserables.txt 6, NotreDame_De_Paris.txt 1
decayed	NotreDame_De_Paris.txt 1
decaying	NotreDame_De_Paris.txt 1
decazes	Miserables.txt 3
decease	Miserables.txt 1
deceased	Miserables.txt 2, NotreDame_De_Paris.txt 1
deceit	Miserables.txt 1
deceive	Miserables.txt 3, NotreDame_De_Paris.txt 2
deceived	Miserables.txt 10, NotreDame_De_Paris.txt 3
deceives	Miserables.txt 3
deceiving	Miserables.txt 7
december	Miserables.txt 8, NotreDame_De_Paris.txt 1
decency	Miserables.txt 3
decent	Miserables.txt 4, NotreDame_De_Paris.txt 2
deceptions	Miserables.txt 1
deceptive	Miserables.txt 2
dechiraverunt	NotreDame_De_Paris.txt 1
decide	Miserables.txt 10, NotreDame_De_Paris.txt 3
decided	Miserables.txt 26, NotreDame_De_Paris.txt 6
decidedly	Miserables.txt 25, NotreDame_De_Paris.txt 5
decimate	Miserables.txt 1
decimated	Miserables.txt 6
decipher	NotreDame_De_Paris.txt 2, Miserables.txt 1
deciphered	Miserables.txt 3
deciphering	NotreDame_De_Paris.txt 1, Miserables.txt 1
decision	Miserables.txt 18, NotreDame_De_Paris.txt 1
decisions	NotreDame_De_Paris.txt 1
decisive	Miserables.txt 17, NotreDame_De_Paris.txt 2
deck	Miserables.txt 3
decked	Miserables.txt 6, NotreDame_De_Paris.txt 5
deckest	Miserables.txt 1
decks	Miserables.txt 4
declaimer	Miserables.txt 4
declaimers	Miserables.txt 2
declaiming	NotreDame_De_Paris.txt 1, Miserables.txt 1
declamations	Miserables.txt 3
declaration	Miserables.txt 6, NotreDame_De_Paris.txt 3
declarations	Miserables.txt 1
declare	Miserables.txt 11, NotreDame_De_Paris.txt 1
declared	Miserables.txt 26, NotreDame_De_Paris.txt 2
declaremus	NotreDame_De_Paris.txt 1
declares	Miserables.txt 2, NotreDame_De_Paris.txt 1
declaring	Miserables.txt 3, NotreDame_De_Paris.txt 1
decline	Miserables.txt 7, NotreDame_De_Paris.txt 1
declined	Miserables.txt 2
declines	Miserables.txt 1
declining	Miserables.txt 5, NotreDame_De_Paris.txt 2
declivities	Miserables.txt 1
declivity	Miserables.txt 4
decoiffee	Miserables.txt 1
decolla	Miserables.txt 1
decomposition	Miserables.txt 2
decompositions	Miserables.txt 1
decorated	Miserables.txt 10
decoration	Miserables.txt 6
decorations	NotreDame_De_Paris.txt 1
decorously	NotreDame_De_Paris.txt 1
decreased	Miserables.txt 4
decreases	Miserables.txt 1
decreasing	Miserables.txt 1
decree	NotreDame_De_Paris.txt 8, Miserables.txt 5
decreed	Miserables.txt 4
decrees	Miserables.txt 4
decrepit	Miserables.txt 11, NotreDame_De_Paris.txt 5
decrepitude	Miserables.txt 3
decres	Miserables.txt 1
decretal	NotreDame_De_Paris.txt 1
decretalists	NotreDame_De_Paris.txt 1
decretals	NotreDame_De_Paris.txt 6
decretists	NotreDame_De_Paris.txt 1
decurions	Miserables.txt 1
dedicated	Miserables.txt 1
dedication	Miserables.txt 2
deduced	NotreDame_De_Paris.txt 1
deduct	Miserables.txt 1
deductible	NotreDame_De_Paris.txt 1, Miserables.txt 1
deduction	Miserables.txt 2
deed	Miserables.txt 17, NotreDame_De_Paris.txt 5
deeds	Miserables.txt 28, NotreDame_De_Paris.txt 8
deem	NotreDame_De_Paris.txt 1, Miserables.txt 1
deemed	NotreDame_De_Paris.txt 1
deep	Miserables.txt 59, NotreDame_De_Paris.txt 28
deepen	NotreDame_De_Paris.txt 1
deepened	Miserables.txt 1
deepening	Miserables.txt 1
deeper	NotreDame_De_Paris.txt 9, Miserables.txt 9
deepest	NotreDame_De_Paris.txt 2, Miserables.txt 2
deeply	Miserables.txt 32, NotreDame_De_Paris.txt 15
deer	NotreDame_De_Paris.txt 3
defaced	Miserables.txt 2
defacing	NotreDame_De_Paris.txt 1
default	Miserables.txt 7, NotreDame_De_Paris.txt 1
defeat	Miserables.txt 8
defeated	Miserables.txt 1
defect	Miserables.txt 11, NotreDame_De_Paris.txt 6
defective	NotreDame_De_Paris.txt 4, Miserables.txt 3
defects	Miserables.txt 4, NotreDame_De_Paris.txt 2
defence	Miserables.txt 14, NotreDame_De_Paris.txt 3
defenceless	Miserables.txt 1
defend	Miserables.txt 17, NotreDame_De_Paris.txt 3
defendant	NotreDame_De_Paris.txt 1, Miserables.txt 1
defended	Miserables.txt 13, NotreDame_De_Paris.txt 3
defender	Miserables.txt 1
defenders	Miserables.txt 1
defending	NotreDame_De_Paris.txt 6, Miserables.txt 4
defends	Miserables.txt 6
defendu	Miserables.txt 1
defensive	NotreDame_De_Paris.txt 2, Miserables.txt 1
defer	NotreDame_De_Paris.txt 1
deference	Miserables.txt 4
deferential	Miserables.txt 2
defiance	Miserables.txt 5, NotreDame_De_Paris.txt 3
defiantly	Miserables.txt 1
defier	Miserables.txt 1
defile	Miserables.txt 1
defiled	NotreDame_De_Paris.txt 1
defilement	Miserables.txt 1
defiles	Miserables.txt 1
defiling	NotreDame_De_Paris.txt 1, Miserables.txt 1
define	Miserables.txt 2
defined	Miserables.txt 5, NotreDame_De_Paris.txt 2
definite	NotreDame_De_Paris.txt 2, Miserables.txt 2
definitely	Miserables.txt 5
definiteness	NotreDame_De_Paris.txt 1, Miserables.txt 1
definition	Miserables.txt 2
definitive	Miserables.txt 13, NotreDame_De_Paris.txt 3
deflected	Miserables.txt 1
deformed	NotreDame_De_Paris.txt 8, Miserables.txt 8
deformities	Miserables.txt 3
deformity	NotreDame_De_Paris.txt 10, Miserables.txt 8
defuit	NotreDame_De_Paris.txt 1
defunct	Miserables.txt 2, NotreDame_De_Paris.txt 1
defy	Miserables.txt 2
degenerate	Miserables.txt 2
degenerated	Miserables.txt 2
degenerates	Miserables.txt 1
degradation	Miserables.txt 5
degradations	NotreDame_De_Paris.txt 1, Miserables.txt 1
degraded	Miserables.txt 4
degrading	Miserables.txt 2
degree	Miserables.txt 40, NotreDame_De_Paris.txt 15
degrees	Miserables.txt 14, NotreDame_De_Paris.txt 6
dehaze	Miserables.txt 1
dei	Miserables.txt 2
deification	Miserables.txt 1
deified	Miserables.txt 1
deign	Miserables.txt 5, NotreDame_De_Paris.txt 1
deigned	Miserables.txt 4, NotreDame_De_Paris.txt 2
deigning	NotreDame_De_Paris.txt 1, Miserables.txt 1
deity	Miserables.txt 1
deja	Miserables.txt 1
dejected	Miserables.txt 10
dejection	Miserables.txt 9, NotreDame_De_Paris.txt 1
del	NotreDame_De_Paris.txt 1
delalot	Miserables.txt 1
delancey	Miserables.txt 1
delancre	Miserables.txt 1
delaporte	Miserables.txt 1
delaveau	Miserables.txt 1
delaverderie	Miserables.txt 1
delay	Miserables.txt 10
delayed	Miserables.txt 4
delegate	Miserables.txt 1
deletions	NotreDame_De_Paris.txt 1, Miserables.txt 1
deleuze	Miserables.txt 1
deliberate	Miserables.txt 12
deliberated	Miserables.txt 1
deliberately	Miserables.txt 1
deliberating	Miserables.txt 3
deliberation	Miserables.txt 9
delicacies	NotreDame_De_Paris.txt 1, Miserables.txt 1
delicacy	Miserables.txt 6, NotreDame_De_Paris.txt 3
delicate	Miserables.txt 26, NotreDame_De_Paris.txt 24
delicately	NotreDame_De_Paris.txt 2
delicious	Miserables.txt 9, NotreDame_De_Paris.txt 1
deliciously	Miserables.txt 1
delicti	Miserables.txt 1
delight	Miserables.txt 29, NotreDame_De_Paris.txt 5
delighted	Miserables.txt 20, NotreDame_De_Paris.txt 7
delightful	Miserables.txt 9
delightfully	NotreDame_De_Paris.txt 1
delights	Miserables.txt 6
delille	Miserables.txt 2
delinquencies	NotreDame_De_Paris.txt 1
delinquent	Miserables.txt 1
delinquents	Miserables.txt 2
delirious	Miserables.txt 2, NotreDame_De_Paris.txt 1
delirium	Miserables.txt 7, NotreDame_De_Paris.txt 3
deliriums	NotreDame_De_Paris.txt 1, Miserables.txt 1
deliver	Miserables.txt 25, NotreDame_De_Paris.txt 5
deliverance	Miserables.txt 8
delivered	Miserables.txt 23, NotreDame_De_Paris.txt 8
deliverer	NotreDame_De_Paris.txt 1, Miserables.txt 1
delivering	Miserables.txt 4, NotreDame_De_Paris.txt 1
delivers	Miserables.txt 4
delivery	Miserables.txt 2
della	Miserables.txt 1
delorme	Miserables.txt 3, NotreDame_De_Paris.txt 1
delort	Miserables.txt 5
delphos	Miserables.txt 2
delude	Miserables.txt 1
deluded	Miserables.txt 1
deluding	NotreDame_De_Paris.txt 1
deluge	Miserables.txt 4, NotreDame_De_Paris.txt 2
delusion	Miserables.txt 1
delve	Miserables.txt 1
delvincourt	Miserables.txt 2
demagogical	Miserables.txt 1
demagogue	Miserables.txt 2
demagogues	Miserables.txt 1
demand	Miserables.txt 26, NotreDame_De_Paris.txt 3
demandait	Miserables.txt 2
demanded	Miserables.txt 60, NotreDame_De_Paris.txt 15
demanding	Miserables.txt 3, NotreDame_De_Paris.txt 1
demands	Miserables.txt 13, NotreDame_De_Paris.txt 2
demeanor	Miserables.txt 1
demens	Miserables.txt 1
demerits	NotreDame_De_Paris.txt 2
demi	Miserables.txt 9, NotreDame_De_Paris.txt 4
demigod	Miserables.txt 1
democracy	Miserables.txt 10, NotreDame_De_Paris.txt 1
democrat	Miserables.txt 3
democratic	Miserables.txt 9
democrats	Miserables.txt 2
demoiselle	NotreDame_De_Paris.txt 4
demoiselles	NotreDame_De_Paris.txt 1
demolish	Miserables.txt 3, NotreDame_De_Paris.txt 2
demolished	Miserables.txt 15, NotreDame_De_Paris.txt 4
demolishers	NotreDame_De_Paris.txt 1
demolishes	Miserables.txt 2, NotreDame_De_Paris.txt 1
demolishing	Miserables.txt 2, NotreDame_De_Paris.txt 1
demolition	Miserables.txt 5, NotreDame_De_Paris.txt 3
demolitions	Miserables.txt 2, NotreDame_De_Paris.txt 1
demon	NotreDame_De_Paris.txt 28, Miserables.txt 12
demonetized	Miserables.txt 1
demoniac	NotreDame_De_Paris.txt 1
demons	Miserables.txt 10, NotreDame_De_Paris.txt 4
demonstrata	NotreDame_De_Paris.txt 1
demonstrate	Miserables.txt 2
demonstrated	NotreDame_De_Paris.txt 2, Miserables.txt 2
demonstrates	NotreDame_De_Paris.txt 1, Miserables.txt 1
demonstrating	NotreDame_De_Paris.txt 1
demonstration	Miserables.txt 2
demonstrations	Miserables.txt 1
demonstrator	NotreDame_De_Paris.txt 1, Miserables.txt 1
demontrais	Miserables.txt 1
demoralized	Miserables.txt 1
demos	Miserables.txt 1
den	Miserables.txt 20, NotreDame_De_Paris.txt 7
denarios	NotreDame_De_Paris.txt 1
denial	Miserables.txt 8, NotreDame_De_Paris.txt 2
denials	Miserables.txt 3
denied	Miserables.txt 12, NotreDame_De_Paris.txt 2
deniers	NotreDame_De_Paris.txt 14
denies	Miserables.txt 7
denis	Miserables.txt 30, NotreDame_De_Paris.txt 17
denizens	Miserables.txt 1
denominated	Miserables.txt 2
denoted	Miserables.txt 1
denotes	Miserables.txt 1
denounce	Miserables.txt 14, NotreDame_De_Paris.txt 1
denounced	Miserables.txt 14, NotreDame_De_Paris.txt 3
denounces	Miserables.txt 1
denouncing	Miserables.txt 2, NotreDame_De_Paris.txt 1
dens	Miserables.txt 1
dense	Miserables.txt 16, NotreDame_De_Paris.txt 9
densely	Miserables.txt 1
denseness	Miserables.txt 1
denser	Miserables.txt 2
densest	Miserables.txt 2
densities	Miserables.txt 1
density	Miserables.txt 9
dental	Miserables.txt 2
dentated	NotreDame_De_Paris.txt 1
dented	Miserables.txt 1
denticulation	NotreDame_De_Paris.txt 1
denticulations	NotreDame_De_Paris.txt 1
dentist	Miserables.txt 3
dentro	NotreDame_De_Paris.txt 2
denudation	Miserables.txt 1
denuded	NotreDame_De_Paris.txt 1, Miserables.txt 1
denunciation	Miserables.txt 1
denunciator	NotreDame_De_Paris.txt 1, Miserables.txt 1
deny	Miserables.txt 12, NotreDame_De_Paris.txt 8
denying	NotreDame_De_Paris.txt 2
deo	Miserables.txt 1
depart	Miserables.txt 7, NotreDame_De_Paris.txt 3
departed	Miserables.txt 16, NotreDame_De_Paris.txt 7
departing	Miserables.txt 4, NotreDame_De_Paris.txt 2
department	Miserables.txt 12
departmental	Miserables.txt 1
departments	Miserables.txt 4
departs	Miserables.txt 3
departure	Miserables.txt 67, NotreDame_De_Paris.txt 6
departures	Miserables.txt 2
depeche	Miserables.txt 1
depend	Miserables.txt 4, NotreDame_De_Paris.txt 1
depended	Miserables.txt 4, NotreDame_De_Paris.txt 2
dependency	NotreDame_De_Paris.txt 1
dependent	NotreDame_De_Paris.txt 1
dependents	Miserables.txt 1
depending	Miserables.txt 3
depends	NotreDame_De_Paris.txt 3, Miserables.txt 2
depict	Miserables.txt 2
depicted	Miserables.txt 4, NotreDame_De_Paris.txt 3
depicting	NotreDame_De_Paris.txt 1, Miserables.txt 1
depleted	NotreDame_De_Paris.txt 1
deplorable	NotreDame_De_Paris.txt 2
deplore	Miserables.txt 1
deployed	Miserables.txt 4
depopulated	Miserables.txt 2
depopulates	Miserables.txt 1
deposit	Miserables.txt 13, NotreDame_De_Paris.txt 2
deposited	Miserables.txt 28, NotreDame_De_Paris.txt 9
depositing	Miserables.txt 3, NotreDame_De_Paris.txt 1
deposition	Miserables.txt 5, NotreDame_De_Paris.txt 2
depositions	Miserables.txt 2
deposits	NotreDame_De_Paris.txt 1
depraved	NotreDame_De_Paris.txt 2, Miserables.txt 2
deprecated	Miserables.txt 1
depressed	NotreDame_De_Paris.txt 1, Miserables.txt 1
depresses	Miserables.txt 1
depressing	Miserables.txt 2
depression	Miserables.txt 5, NotreDame_De_Paris.txt 2
deprivation	Miserables.txt 1
deprive	Miserables.txt 6
deprived	Miserables.txt 8, NotreDame_De_Paris.txt 5
deprives	Miserables.txt 2
depriving	Miserables.txt 1
depth	Miserables.txt 32, NotreDame_De_Paris.txt 1
depths	Miserables.txt 107, NotreDame_De_Paris.txt 17
depuratory	Miserables.txt 1
deputies	Miserables.txt 4
deputy	Miserables.txt 4
der	NotreDame_De_Paris.txt 1, Miserables.txt 1
derailed	Miserables.txt 2
derailment	Miserables.txt 1
deranged	Miserables.txt 1
derbac	Miserables.txt 1
derided	Miserables.txt 1
derides	Miserables.txt 1
derision	NotreDame_De_Paris.txt 5, Miserables.txt 1
derisive	NotreDame_De_Paris.txt 3, Miserables.txt 1
derivative	Miserables.txt 5, NotreDame_De_Paris.txt 3
derivatives	Miserables.txt 1
derive	Miserables.txt 2, NotreDame_De_Paris.txt 1
derived	Miserables.txt 9, NotreDame_De_Paris.txt 5
derniers	NotreDame_De_Paris.txt 1
dervishes	Miserables.txt 1
des	Miserables.txt 156, NotreDame_De_Paris.txt 60
desaix	Miserables.txt 1
desaugiers	Miserables.txt 3
descamisados	Miserables.txt 2
descartes	Miserables.txt 5
descend	Miserables.txt 28, NotreDame_De_Paris.txt 12
descendant	Miserables.txt 2
descended	Miserables.txt 59, NotreDame_De_Paris.txt 24
descending	Miserables.txt 22, NotreDame_De_Paris.txt 7
descends	Miserables.txt 9
descent	Miserables.txt 13, NotreDame_De_Paris.txt 2
descents	NotreDame_De_Paris.txt 1
describe	NotreDame_De_Paris.txt 4, Miserables.txt 2
described	Miserables.txt 16, NotreDame_De_Paris.txt 7
describes	Miserables.txt 3
describing	Miserables.txt 2, NotreDame_De_Paris.txt 1
descried	Miserables.txt 10, NotreDame_De_Paris.txt 3
description	Miserables.txt 14, NotreDame_De_Paris.txt 3
descry	Miserables.txt 3
deseaved	Miserables.txt 1
deserre	Miserables.txt 1
desert	Miserables.txt 10, NotreDame_De_Paris.txt 4
deserted	Miserables.txt 74, NotreDame_De_Paris.txt 26
deserters	Miserables.txt 2
deserting	Miserables.txt 2
desertion	NotreDame_De_Paris.txt 1
deserts	NotreDame_De_Paris.txt 1
deserve	Miserables.txt 4, NotreDame_De_Paris.txt 3
deserved	Miserables.txt 7, NotreDame_De_Paris.txt 1
deserves	NotreDame_De_Paris.txt 3, Miserables.txt 2
deservest	Miserables.txt 1
deserving	Miserables.txt 5, NotreDame_De_Paris.txt 1
desiccating	Miserables.txt 1
design	Miserables.txt 2, NotreDame_De_Paris.txt 1
designate	Miserables.txt 7, NotreDame_De_Paris.txt 1
designated	Miserables.txt 20, NotreDame_De_Paris.txt 2
designates	Miserables.txt 2
designating	Miserables.txt 2
designation	Miserables.txt 1
designations	NotreDame_De_Paris.txt 1
designed	Miserables.txt 2
designs	NotreDame_De_Paris.txt 2, Miserables.txt 1
desirable	Miserables.txt 4
desire	Miserables.txt 55, NotreDame_De_Paris.txt 13
desired	Miserables.txt 26, NotreDame_De_Paris.txt 6
desires	Miserables.txt 21, NotreDame_De_Paris.txt 4
desiring	Miserables.txt 2
desirous	Miserables.txt 17, NotreDame_De_Paris.txt 4
desk	Miserables.txt 8
desks	NotreDame_De_Paris.txt 1
desmarets	Miserables.txt 1
desmeared	NotreDame_De_Paris.txt 1
desmoulins	Miserables.txt 4
desnouettes	Miserables.txt 2
desnoyer	Miserables.txt 1
desolate	NotreDame_De_Paris.txt 1, Miserables.txt 1
desolations	Miserables.txt 3
despair	Miserables.txt 79, NotreDame_De_Paris.txt 34
despaired	Miserables.txt 2
despairing	Miserables.txt 18, NotreDame_De_Paris.txt 2
despairs	Miserables.txt 3
despatch	Miserables.txt 3, NotreDame_De_Paris.txt 1
despatched	Miserables.txt 9, NotreDame_De_Paris.txt 2
despatches	NotreDame_De_Paris.txt 2, Miserables.txt 1
despatching	Miserables.txt 2
desperate	Miserables.txt 30, NotreDame_De_Paris.txt 8
desperately	Miserables.txt 7, NotreDame_De_Paris.txt 1
desperation	Miserables.txt 2, NotreDame_De_Paris.txt 1
despicable	Miserables.txt 1
despise	Miserables.txt 9, NotreDame_De_Paris.txt 4
despised	Miserables.txt 6, NotreDame_De_Paris.txt 3
despises	Miserables.txt 1
despite	Miserables.txt 3, NotreDame_De_Paris.txt 2
despoil	Miserables.txt 1
despoiled	NotreDame_De_Paris.txt 2, Miserables.txt 2
despondency	Miserables.txt 3
despondent	Miserables.txt 1
despot	Miserables.txt 12
despotic	Miserables.txt 2
despotism	Miserables.txt 10
despots	Miserables.txt 3
despreaux	NotreDame_De_Paris.txt 1
desprez	Miserables.txt 1
desrues	Miserables.txt 1
dessert	Miserables.txt 4, NotreDame_De_Paris.txt 1
dessolles	Miserables.txt 1
dessous	Miserables.txt 2
dessus	NotreDame_De_Paris.txt 1
destin	Miserables.txt 1
destination	Miserables.txt 3, NotreDame_De_Paris.txt 1
destined	Miserables.txt 23, NotreDame_De_Paris.txt 6
destinies	Miserables.txt 9, NotreDame_De_Paris.txt 2
destining	Miserables.txt 1
destiny	Miserables.txt 77, NotreDame_De_Paris.txt 7
destitute	Miserables.txt 4, NotreDame_De_Paris.txt 1
destitution	Miserables.txt 9
destitutions	Miserables.txt 1
destroy	Miserables.txt 12, NotreDame_De_Paris.txt 6
destroyed	Miserables.txt 13, NotreDame_De_Paris.txt 9
destroying	Miserables.txt 3, NotreDame_De_Paris.txt 2
destruction	Miserables.txt 5, NotreDame_De_Paris.txt 2
destructive	Miserables.txt 1
detach	Miserables.txt 4, NotreDame_De_Paris.txt 3
detached	Miserables.txt 20, NotreDame_De_Paris.txt 8
detaching	NotreDame_De_Paris.txt 3
detachment	Miserables.txt 9
detail	Miserables.txt 33, NotreDame_De_Paris.txt 4
detailed	Miserables.txt 2
details	Miserables.txt 33, NotreDame_De_Paris.txt 8
detain	Miserables.txt 3
detained	Miserables.txt 7, NotreDame_De_Paris.txt 3
detaining	Miserables.txt 1
detected	Miserables.txt 2
detention	Miserables.txt 1
deteriorated	Miserables.txt 1
determinances	NotreDame_De_Paris.txt 1
determination	Miserables.txt 2
determine	Miserables.txt 3, NotreDame_De_Paris.txt 2
determined	Miserables.txt 9, NotreDame_De_Paris.txt 5
determines	Miserables.txt 1
determining	Miserables.txt 2
deterred	Miserables.txt 1
detest	Miserables.txt 5
detestable	Miserables.txt 4, NotreDame_De_Paris.txt 1
detested	Miserables.txt 5
detesting	NotreDame_De_Paris.txt 1
detests	Miserables.txt 2, NotreDame_De_Paris.txt 1
dethrone	NotreDame_De_Paris.txt 1
dethroned	NotreDame_De_Paris.txt 3, Miserables.txt 1
dethroning	NotreDame_De_Paris.txt 1
detonation	Miserables.txt 4, NotreDame_De_Paris.txt 2
detour	Miserables.txt 1
detours	Miserables.txt 1
detract	NotreDame_De_Paris.txt 1, Miserables.txt 1
detracted	Miserables.txt 4
detritus	Miserables.txt 2
deuce	Miserables.txt 30, NotreDame_De_Paris.txt 8
deum	NotreDame_De_Paris.txt 4, Miserables.txt 4
deus	NotreDame_De_Paris.txt 4
deutz	Miserables.txt 1
deux	Miserables.txt 14
deuxmilliards	Miserables.txt 1
devait	Miserables.txt 1
devant	NotreDame_De_Paris.txt 1, Miserables.txt 1
devastate	NotreDame_De_Paris.txt 1
devastated	Miserables.txt 2, NotreDame_De_Paris.txt 1
develop	Miserables.txt 6, NotreDame_De_Paris.txt 4
developed	Miserables.txt 11, NotreDame_De_Paris.txt 9
developing	NotreDame_De_Paris.txt 1
development	Miserables.txt 8, NotreDame_De_Paris.txt 2
developments	NotreDame_De_Paris.txt 1
develops	Miserables.txt 3, NotreDame_De_Paris.txt 2
deviation	Miserables.txt 1
deviations	NotreDame_De_Paris.txt 2
device	Miserables.txt 6, NotreDame_De_Paris.txt 4
devices	Miserables.txt 7
devil	NotreDame_De_Paris.txt 72, Miserables.txt 57
devilish	Miserables.txt 3, NotreDame_De_Paris.txt 2
devils	Miserables.txt 4, NotreDame_De_Paris.txt 2
devise	Miserables.txt 3, NotreDame_De_Paris.txt 1
devised	NotreDame_De_Paris.txt 2
devising	Miserables.txt 1
devisser	Miserables.txt 1
devoid	Miserables.txt 3, NotreDame_De_Paris.txt 2
devolny	Miserables.txt 1
devolving	Miserables.txt 2
devorant	Miserables.txt 1
devote	Miserables.txt 3
devoted	Miserables.txt 13, NotreDame_De_Paris.txt 2
devotee	Miserables.txt 2
devotees	NotreDame_De_Paris.txt 1
devotion	Miserables.txt 24, NotreDame_De_Paris.txt 7
devour	Miserables.txt 15, NotreDame_De_Paris.txt 5
devoured	NotreDame_De_Paris.txt 16, Miserables.txt 5
devourer	NotreDame_De_Paris.txt 1
devouring	Miserables.txt 6, NotreDame_De_Paris.txt 4
devours	NotreDame_De_Paris.txt 3, Miserables.txt 3
devout	NotreDame_De_Paris.txt 8, Miserables.txt 1
devoutly	NotreDame_De_Paris.txt 5, Miserables.txt 2
devoutness	NotreDame_De_Paris.txt 2
devrait	Miserables.txt 2
dew	Miserables.txt 10, NotreDame_De_Paris.txt 1
dexeubolos	NotreDame_De_Paris.txt 1
dexterity	NotreDame_De_Paris.txt 2
diabetes	Miserables.txt 1
diable	Miserables.txt 3, NotreDame_De_Paris.txt 1
diables	Miserables.txt 1
diabolical	NotreDame_De_Paris.txt 2, Miserables.txt 1
diabolically	NotreDame_De_Paris.txt 1
diabolus	Miserables.txt 1
diaconate	Miserables.txt 1
diacre	NotreDame_De_Paris.txt 1
diadem	NotreDame_De_Paris.txt 1
diagnosed	Miserables.txt 1
diagnoses	NotreDame_De_Paris.txt 1
diagnosis	Miserables.txt 2
diagonal	Miserables.txt 1
diagonally	Miserables.txt 1
dialect	Miserables.txt 12
dialects	NotreDame_De_Paris.txt 1, Miserables.txt 1
dialogue	Miserables.txt 23, NotreDame_De_Paris.txt 3
dialogues	Miserables.txt 4, NotreDame_De_Paris.txt 1
dialogus	NotreDame_De_Paris.txt 1
diameter	Miserables.txt 3, NotreDame_De_Paris.txt 1
diametrically	NotreDame_De_Paris.txt 1
diamond	Miserables.txt 5, NotreDame_De_Paris.txt 2
diamonds	Miserables.txt 10, NotreDame_De_Paris.txt 2
diana	NotreDame_De_Paris.txt 2, Miserables.txt 2
diane	NotreDame_De_Paris.txt 8, Miserables.txt 1
diaphaneity	Miserables.txt 2
diaphanous	NotreDame_De_Paris.txt 1
diaphragm	Miserables.txt 1
diaphragms	Miserables.txt 1
diatribe	Miserables.txt 2
diavolus	NotreDame_De_Paris.txt 1
dicas	Miserables.txt 1
dice	NotreDame_De_Paris.txt 6
dicere	Miserables.txt 1
dicite	NotreDame_De_Paris.txt 1
dictate	Miserables.txt 5, NotreDame_De_Paris.txt 1
dictated	Miserables.txt 5, NotreDame_De_Paris.txt 1
dictates	Miserables.txt 2, NotreDame_De_Paris.txt 1
dictation	NotreDame_De_Paris.txt 3, Miserables.txt 2
dictator	Miserables.txt 1
dictatorship	Miserables.txt 1
dictees	Miserables.txt 1
dictionaries	Miserables.txt 1
dictionary	Miserables.txt 2
dicto	NotreDame_De_Paris.txt 1
did	Miserables.txt 994, NotreDame_De_Paris.txt 225
didascalon	NotreDame_De_Paris.txt 1
diderot	Miserables.txt 8
didn	Miserables.txt 14
didorus	Miserables.txt 1
didst	Miserables.txt 9
didymus	NotreDame_De_Paris.txt 2
die	Miserables.txt 119, NotreDame_De_Paris.txt 35
died	Miserables.txt 59, NotreDame_De_Paris.txt 19
dien	NotreDame_De_Paris.txt 1
dieppe	NotreDame_De_Paris.txt 1
dier	Miserables.txt 1
dies	Miserables.txt 13, NotreDame_De_Paris.txt 2
diet	Miserables.txt 3
dieu	NotreDame_De_Paris.txt 52, Miserables.txt 34
differed	Miserables.txt 2
difference	Miserables.txt 34, NotreDame_De_Paris.txt 8
differences	NotreDame_De_Paris.txt 2, Miserables.txt 2
different	Miserables.txt 49, NotreDame_De_Paris.txt 15
differently	NotreDame_De_Paris.txt 2, Miserables.txt 1
differing	NotreDame_De_Paris.txt 1, Miserables.txt 1
differs	Miserables.txt 1
difficult	Miserables.txt 39, NotreDame_De_Paris.txt 15
difficulties	Miserables.txt 5
difficulty	Miserables.txt 53, NotreDame_De_Paris.txt 12
difforme	NotreDame_De_Paris.txt 1
diffuse	Miserables.txt 4, NotreDame_De_Paris.txt 1
diffused	Miserables.txt 4, NotreDame_De_Paris.txt 2
diffuses	Miserables.txt 1
dig	Miserables.txt 6
digest	Miserables.txt 2
digested	NotreDame_De_Paris.txt 2, Miserables.txt 1
digesting	Miserables.txt 1
digestion	Miserables.txt 4
digestive	Miserables.txt 1
digger	Miserables.txt 50
diggers	Miserables.txt 2
digging	Miserables.txt 4, NotreDame_De_Paris.txt 2
dignae	Miserables.txt 1
dignified	Miserables.txt 7, NotreDame_De_Paris.txt 2
dignify	Miserables.txt 1
dignifying	Miserables.txt 1
dignitaries	NotreDame_De_Paris.txt 3
dignitas	NotreDame_De_Paris.txt 1
dignite	Miserables.txt 1
dignities	Miserables.txt 5, NotreDame_De_Paris.txt 1
dignity	Miserables.txt 23, NotreDame_De_Paris.txt 5
digression	Miserables.txt 3
digs	Miserables.txt 4
digue	Miserables.txt 1
dike	Miserables.txt 3, NotreDame_De_Paris.txt 1
diked	Miserables.txt 1
dikes	NotreDame_De_Paris.txt 1, Miserables.txt 1
dilapidated	Miserables.txt 18, NotreDame_De_Paris.txt 2
dilapidation	NotreDame_De_Paris.txt 2, Miserables.txt 1
dilapitated	NotreDame_De_Paris.txt 1
dilated	NotreDame_De_Paris.txt 2, Miserables.txt 2
dilates	Miserables.txt 3
dilating	Miserables.txt 2, NotreDame_De_Paris.txt 1
dilemma	Miserables.txt 7, NotreDame_De_Paris.txt 2
dilemmas	NotreDame_De_Paris.txt 1, Miserables.txt 1
dilettante	Miserables.txt 1
diligence	Miserables.txt 21, NotreDame_De_Paris.txt 1
diligences	Miserables.txt 3
diligent	NotreDame_De_Paris.txt 1
diligently	Miserables.txt 1
dilute	Miserables.txt 1
dim	Miserables.txt 11, NotreDame_De_Paris.txt 2
dimensions	Miserables.txt 4
dimidiam	NotreDame_De_Paris.txt 1
dimidio	NotreDame_De_Paris.txt 1
diminish	Miserables.txt 4
diminished	Miserables.txt 10, NotreDame_De_Paris.txt 1
diminishes	Miserables.txt 4
diminishing	Miserables.txt 6
diminution	Miserables.txt 8
diminutive	Miserables.txt 2
diminutiveness	Miserables.txt 1
dimly	NotreDame_De_Paris.txt 5, Miserables.txt 5
dimmed	Miserables.txt 2
dimness	Miserables.txt 3
dimple	Miserables.txt 1
dimpled	Miserables.txt 2
din	NotreDame_De_Paris.txt 1, Miserables.txt 1
dinary	NotreDame_De_Paris.txt 1
dincourt	Miserables.txt 1
dine	Miserables.txt 15
dined	Miserables.txt 13
diner	Miserables.txt 1
ding	Miserables.txt 2
dingy	NotreDame_De_Paris.txt 2
dining	Miserables.txt 23
dinner	Miserables.txt 37, NotreDame_De_Paris.txt 1
dinners	Miserables.txt 5
dint	Miserables.txt 28, NotreDame_De_Paris.txt 2
diocesan	Miserables.txt 1
diocese	Miserables.txt 13
diogenes	Miserables.txt 10, NotreDame_De_Paris.txt 2
diomed	Miserables.txt 1
diomedes	Miserables.txt 1
dion	Miserables.txt 1
dip	NotreDame_De_Paris.txt 1, Miserables.txt 1
diplomacy	Miserables.txt 3
diplomat	NotreDame_De_Paris.txt 1, Miserables.txt 1
diplomatic	Miserables.txt 1
dipped	Miserables.txt 8, NotreDame_De_Paris.txt 1
dipper	NotreDame_De_Paris.txt 1
dipping	Miserables.txt 3
dips	NotreDame_De_Paris.txt 1, Miserables.txt 1
dirais	Miserables.txt 1
dire	Miserables.txt 2, NotreDame_De_Paris.txt 1
direct	Miserables.txt 20, NotreDame_De_Paris.txt 5
directed	Miserables.txt 55, NotreDame_De_Paris.txt 14
directing	Miserables.txt 9, NotreDame_De_Paris.txt 3
direction	Miserables.txt 121, NotreDame_De_Paris.txt 25
directions	Miserables.txt 13, NotreDame_De_Paris.txt 4
directly	Miserables.txt 27, NotreDame_De_Paris.txt 7
directness	Miserables.txt 1
director	Miserables.txt 8, NotreDame_De_Paris.txt 1
directory	Miserables.txt 6
directs	Miserables.txt 1
dirt	Miserables.txt 5
dirty	Miserables.txt 12, NotreDame_De_Paris.txt 7
dis	Miserables.txt 2
disabled	Miserables.txt 2
disabling	Miserables.txt 1
disaccord	Miserables.txt 1
disadvantage	Miserables.txt 2
disadvantages	Miserables.txt 1
disaggregate	Miserables.txt 1
disaggregation	Miserables.txt 1
disagreeable	Miserables.txt 13, NotreDame_De_Paris.txt 6
disagreement	Miserables.txt 1
disappear	Miserables.txt 21, NotreDame_De_Paris.txt 13
disappearance	Miserables.txt 14, NotreDame_De_Paris.txt 2
disappearances	Miserables.txt 3
disappeared	Miserables.txt 105, NotreDame_De_Paris.txt 41
disappearing	Miserables.txt 12, NotreDame_De_Paris.txt 1
disappears	Miserables.txt 10, NotreDame_De_Paris.txt 2
disappointed	NotreDame_De_Paris.txt 1
disappointment	Miserables.txt 5, NotreDame_De_Paris.txt 2
disappointments	Miserables.txt 1
disapprove	Miserables.txt 1
disarm	Miserables.txt 1
disarmed	Miserables.txt 6, NotreDame_De_Paris.txt 1
disarming	Miserables.txt 1
disarrange	Miserables.txt 3, NotreDame_De_Paris.txt 1
disarranged	NotreDame_De_Paris.txt 2, Miserables.txt 2
disarranges	Miserables.txt 2
disarranging	Miserables.txt 2
disarray	NotreDame_De_Paris.txt 2, Miserables.txt 1
disassociated	Miserables.txt 1
disaster	Miserables.txt 12, NotreDame_De_Paris.txt 1
disasters	Miserables.txt 2
disastrous	Miserables.txt 4
disastrously	Miserables.txt 1
disbanding	Miserables.txt 1
discarded	Miserables.txt 2
discarding	Miserables.txt 1
discern	Miserables.txt 1
discerned	Miserables.txt 4, NotreDame_De_Paris.txt 2
discernible	Miserables.txt 7
discernment	NotreDame_De_Paris.txt 1, Miserables.txt 1
discharge	Miserables.txt 23, NotreDame_De_Paris.txt 7
discharged	Miserables.txt 17, NotreDame_De_Paris.txt 3
discharges	Miserables.txt 6, NotreDame_De_Paris.txt 1
discharging	Miserables.txt 3, NotreDame_De_Paris.txt 1
disciple	NotreDame_De_Paris.txt 2, Miserables.txt 2
disciplina	NotreDame_De_Paris.txt 1
disciplinae	Miserables.txt 1
discipline	Miserables.txt 13, NotreDame_De_Paris.txt 7
disciplined	NotreDame_De_Paris.txt 2, Miserables.txt 1
discipulorum	NotreDame_De_Paris.txt 1
disclaim	NotreDame_De_Paris.txt 1, Miserables.txt 1
disclaimer	NotreDame_De_Paris.txt 3, Miserables.txt 3
disclaimers	NotreDame_De_Paris.txt 1, Miserables.txt 1
disclose	Miserables.txt 1
disclosed	Miserables.txt 2
disclosing	Miserables.txt 1
discobols	Miserables.txt 1
discomfited	NotreDame_De_Paris.txt 2
discomfiture	NotreDame_De_Paris.txt 1, Miserables.txt 1
discomfort	Miserables.txt 4, NotreDame_De_Paris.txt 1
discommoded	Miserables.txt 1
disconcert	Miserables.txt 3
disconcerted	Miserables.txt 9, NotreDame_De_Paris.txt 2
disconcerts	Miserables.txt 4
disconsolate	Miserables.txt 1
discontent	NotreDame_De_Paris.txt 3
discontented	Miserables.txt 3
discontinue	NotreDame_De_Paris.txt 2, Miserables.txt 1
discontinued	Miserables.txt 4
discord	NotreDame_De_Paris.txt 1, Miserables.txt 1
discordant	Miserables.txt 1
discount	Miserables.txt 2
discounts	Miserables.txt 1
discourage	Miserables.txt 1
discouraged	Miserables.txt 6, NotreDame_De_Paris.txt 4
discouragement	NotreDame_De_Paris.txt 2, Miserables.txt 2
discouragements	Miserables.txt 1
discourse	Miserables.txt 4
discoursed	Miserables.txt 1
discourses	Miserables.txt 1
discover	Miserables.txt 14, NotreDame_De_Paris.txt 5
discovered	Miserables.txt 37, NotreDame_De_Paris.txt 5
discoveries	Miserables.txt 2, NotreDame_De_Paris.txt 1
discovering	Miserables.txt 4, NotreDame_De_Paris.txt 1
discovers	NotreDame_De_Paris.txt 1, Miserables.txt 1
discovery	Miserables.txt 8, NotreDame_De_Paris.txt 1
discredit	Miserables.txt 2
discreet	Miserables.txt 10, NotreDame_De_Paris.txt 4
discreetly	Miserables.txt 6
discretion	Miserables.txt 6, NotreDame_De_Paris.txt 1
discretionary	Miserables.txt 1
disculpates	Miserables.txt 1
discuss	Miserables.txt 9
discussed	Miserables.txt 6
discussing	Miserables.txt 7, NotreDame_De_Paris.txt 1
discussion	Miserables.txt 11
discussions	Miserables.txt 1
disdain	NotreDame_De_Paris.txt 12, Miserables.txt 11
disdained	Miserables.txt 4, NotreDame_De_Paris.txt 1
disdainful	Miserables.txt 7, NotreDame_De_Paris.txt 3
disdainfully	Miserables.txt 3, NotreDame_De_Paris.txt 1
disdaining	Miserables.txt 1
disdains	Miserables.txt 2
disease	Miserables.txt 6, NotreDame_De_Paris.txt 1
diseased	Miserables.txt 1
diseases	Miserables.txt 1
disembark	NotreDame_De_Paris.txt 1
disembarkation	Miserables.txt 1
disembarking	Miserables.txt 3
disembowelled	Miserables.txt 3, NotreDame_De_Paris.txt 2
disenchant	NotreDame_De_Paris.txt 1
disenchanted	NotreDame_De_Paris.txt 1
disencumbered	Miserables.txt 2
disengage	Miserables.txt 2, NotreDame_De_Paris.txt 1
disengaged	Miserables.txt 5, NotreDame_De_Paris.txt 1
disengaging	Miserables.txt 1
disentangle	Miserables.txt 2
disentangled	NotreDame_De_Paris.txt 2, Miserables.txt 1
disentangling	Miserables.txt 1
disfavor	Miserables.txt 1
disfigure	NotreDame_De_Paris.txt 4, Miserables.txt 1
disfigured	Miserables.txt 7, NotreDame_De_Paris.txt 2
disfigurement	Miserables.txt 1
disfrocked	NotreDame_De_Paris.txt 1
disgorged	NotreDame_De_Paris.txt 1
disgrace	Miserables.txt 13, NotreDame_De_Paris.txt 2
disgraced	Miserables.txt 2
disgraceful	Miserables.txt 1
disgraces	Miserables.txt 2
disguise	Miserables.txt 12, NotreDame_De_Paris.txt 1
disguised	Miserables.txt 9
disguises	Miserables.txt 1
disguising	Miserables.txt 1
disgust	Miserables.txt 6, NotreDame_De_Paris.txt 4
disgusted	Miserables.txt 2, NotreDame_De_Paris.txt 1
disgusting	Miserables.txt 1
disgusts	Miserables.txt 2
dish	Miserables.txt 10, NotreDame_De_Paris.txt 3
dishclouts	Miserables.txt 1
disheartened	NotreDame_De_Paris.txt 1
dishes	Miserables.txt 6, NotreDame_De_Paris.txt 1
dishevelled	Miserables.txt 7, NotreDame_De_Paris.txt 6
dishevelment	Miserables.txt 1
dishevelments	Miserables.txt 1
dishonest	Miserables.txt 1
dishonor	Miserables.txt 2
dishonorable	NotreDame_De_Paris.txt 1
dishonored	NotreDame_De_Paris.txt 2, Miserables.txt 2
disinclined	NotreDame_De_Paris.txt 1, Miserables.txt 1
disinfected	Miserables.txt 2
disinfection	Miserables.txt 2
disingenuous	Miserables.txt 1
disinherit	Miserables.txt 2
disinherited	Miserables.txt 4
disintegrated	Miserables.txt 1
disintegration	Miserables.txt 1
disinterested	Miserables.txt 5
disinterestedness	Miserables.txt 6
disjointed	Miserables.txt 1
disk	NotreDame_De_Paris.txt 2, Miserables.txt 2
disks	NotreDame_De_Paris.txt 1
dislike	Miserables.txt 2
dislocate	Miserables.txt 1
dislocated	Miserables.txt 6, NotreDame_De_Paris.txt 2
dislocation	NotreDame_De_Paris.txt 1, Miserables.txt 1
dislodge	NotreDame_De_Paris.txt 1
dislodged	Miserables.txt 5
dislodging	NotreDame_De_Paris.txt 1
disloyalty	NotreDame_De_Paris.txt 1
dismal	Miserables.txt 7
dismally	Miserables.txt 1
dismantle	NotreDame_De_Paris.txt 1, Miserables.txt 1
dismantled	Miserables.txt 5, NotreDame_De_Paris.txt 1
dismas	Miserables.txt 6
dismay	Miserables.txt 3, NotreDame_De_Paris.txt 1
dismayed	Miserables.txt 2, NotreDame_De_Paris.txt 1
dismembered	NotreDame_De_Paris.txt 1
dismemberment	Miserables.txt 3, NotreDame_De_Paris.txt 1
dismiss	Miserables.txt 5
dismissal	Miserables.txt 3
dismissed	Miserables.txt 9, NotreDame_De_Paris.txt 1
dismisses	Miserables.txt 1
dismissing	Miserables.txt 2, NotreDame_De_Paris.txt 1
dismount	Miserables.txt 1
dismounted	Miserables.txt 2, NotreDame_De_Paris.txt 1
disobedient	Miserables.txt 1
disobey	Miserables.txt 1
disobeying	Miserables.txt 1
disobliging	Miserables.txt 1
disome	NotreDame_De_Paris.txt 1
disorder	Miserables.txt 21, NotreDame_De_Paris.txt 8
disordered	NotreDame_De_Paris.txt 3, Miserables.txt 3
disorderly	NotreDame_De_Paris.txt 3, Miserables.txt 2
disorganization	Miserables.txt 1
disorganized	Miserables.txt 2, NotreDame_De_Paris.txt 1
disorganizes	Miserables.txt 1
disorganizing	Miserables.txt 1
disown	Miserables.txt 2
disowned	Miserables.txt 2
dispel	Miserables.txt 1
dispelled	Miserables.txt 3, NotreDame_De_Paris.txt 1
dispensary	Miserables.txt 1
dispensation	NotreDame_De_Paris.txt 1, Miserables.txt 1
dispensations	Miserables.txt 1
dispense	Miserables.txt 4, NotreDame_De_Paris.txt 1
dispensed	NotreDame_De_Paris.txt 2
dispenser	Miserables.txt 1
disperse	Miserables.txt 2
dispersed	Miserables.txt 12, NotreDame_De_Paris.txt 2
disperses	Miserables.txt 3
dispersion	Miserables.txt 1
displace	Miserables.txt 3
displaced	Miserables.txt 6, NotreDame_De_Paris.txt 1
displacement	Miserables.txt 2
display	Miserables.txt 9, NotreDame_De_Paris.txt 3
displayed	Miserables.txt 22, NotreDame_De_Paris.txt 2
displaying	Miserables.txt 9, NotreDame_De_Paris.txt 7
displays	Miserables.txt 3
displease	Miserables.txt 2, NotreDame_De_Paris.txt 1
displeased	Miserables.txt 8, NotreDame_De_Paris.txt 4
displeases	NotreDame_De_Paris.txt 4
displeasing	Miserables.txt 6, NotreDame_De_Paris.txt 2
displeasure	NotreDame_De_Paris.txt 6, Miserables.txt 4
disporting	NotreDame_De_Paris.txt 1
disposal	Miserables.txt 5
dispose	Miserables.txt 4
disposed	Miserables.txt 5, NotreDame_De_Paris.txt 3
disposing	Miserables.txt 1
disposition	Miserables.txt 6, NotreDame_De_Paris.txt 3
disproportionate	NotreDame_De_Paris.txt 1, Miserables.txt 1
disproportionately	Miserables.txt 2
disproportioned	Miserables.txt 1
disputations	NotreDame_De_Paris.txt 1
dispute	Miserables.txt 8, NotreDame_De_Paris.txt 1
disputed	Miserables.txt 3, NotreDame_De_Paris.txt 1
disputes	Miserables.txt 3, NotreDame_De_Paris.txt 1
disputing	NotreDame_De_Paris.txt 3, Miserables.txt 2
disquiet	Miserables.txt 2, NotreDame_De_Paris.txt 1
disquieting	Miserables.txt 7
disquietude	Miserables.txt 1
disrepute	Miserables.txt 2
disrespect	NotreDame_De_Paris.txt 1
disrespectful	Miserables.txt 1
dissatisfied	Miserables.txt 2
dissecting	Miserables.txt 1
dissects	Miserables.txt 1
dissembling	NotreDame_De_Paris.txt 1
disseminated	Miserables.txt 2, NotreDame_De_Paris.txt 1
dissensions	Miserables.txt 1
dissertation	Miserables.txt 3
dissidiorum	NotreDame_De_Paris.txt 1
dissimilar	NotreDame_De_Paris.txt 1
dissimulate	NotreDame_De_Paris.txt 1, Miserables.txt 1
dissimulation	Miserables.txt 3
dissipate	NotreDame_De_Paris.txt 2, Miserables.txt 1
dissipated	Miserables.txt 9, NotreDame_De_Paris.txt 3
dissipates	Miserables.txt 1
dissipating	Miserables.txt 4, NotreDame_De_Paris.txt 1
dissolute	NotreDame_De_Paris.txt 1
dissolution	Miserables.txt 1
dissolve	Miserables.txt 2
dissolved	Miserables.txt 6
dissolvents	Miserables.txt 1
dissolves	Miserables.txt 2
dissolving	Miserables.txt 3
dissonances	Miserables.txt 1
dissuade	Miserables.txt 1
distaff	NotreDame_De_Paris.txt 2
distaffs	NotreDame_De_Paris.txt 2
distance	Miserables.txt 89, NotreDame_De_Paris.txt 14
distances	Miserables.txt 9
distant	Miserables.txt 57, NotreDame_De_Paris.txt 10
distends	Miserables.txt 1
distich	Miserables.txt 1
distiches	NotreDame_De_Paris.txt 1, Miserables.txt 1
distilleries	Miserables.txt 1
distillery	Miserables.txt 2
distills	Miserables.txt 1
distinct	Miserables.txt 21, NotreDame_De_Paris.txt 9
distinction	Miserables.txt 9, NotreDame_De_Paris.txt 2
distinctions	Miserables.txt 1
distinctive	NotreDame_De_Paris.txt 1, Miserables.txt 1
distinctly	Miserables.txt 37, NotreDame_De_Paris.txt 6
distinctness	NotreDame_De_Paris.txt 1, Miserables.txt 1
distinguish	Miserables.txt 23, NotreDame_De_Paris.txt 17
distinguishable	Miserables.txt 3
distinguished	Miserables.txt 32, NotreDame_De_Paris.txt 13
distinguishes	Miserables.txt 5, NotreDame_De_Paris.txt 1
distinguishing	NotreDame_De_Paris.txt 1
distort	NotreDame_De_Paris.txt 1
distorted	NotreDame_De_Paris.txt 2, Miserables.txt 1
distract	Miserables.txt 1
distracted	Miserables.txt 8, NotreDame_De_Paris.txt 5
distractedly	Miserables.txt 2, NotreDame_De_Paris.txt 1
distraction	Miserables.txt 2, NotreDame_De_Paris.txt 1
distractions	Miserables.txt 4
distress	Miserables.txt 30, NotreDame_De_Paris.txt 6
distressed	NotreDame_De_Paris.txt 1
distresses	Miserables.txt 4, NotreDame_De_Paris.txt 1
distressing	NotreDame_De_Paris.txt 1, Miserables.txt 1
distribute	Miserables.txt 7, NotreDame_De_Paris.txt 6
distributed	Miserables.txt 12, NotreDame_De_Paris.txt 5
distributes	Miserables.txt 1
distributing	Miserables.txt 8, NotreDame_De_Paris.txt 7
distribution	Miserables.txt 11, NotreDame_De_Paris.txt 8
distributor	NotreDame_De_Paris.txt 1, Miserables.txt 1
district	Miserables.txt 45
districts	Miserables.txt 2
distrust	Miserables.txt 14, NotreDame_De_Paris.txt 2
distrusted	Miserables.txt 2, NotreDame_De_Paris.txt 1
distrustful	NotreDame_De_Paris.txt 2, Miserables.txt 1
distrusts	NotreDame_De_Paris.txt 1
disturb	Miserables.txt 11, NotreDame_De_Paris.txt 3
disturbance	NotreDame_De_Paris.txt 2, Miserables.txt 1
disturbances	NotreDame_De_Paris.txt 1, Miserables.txt 1
disturbed	Miserables.txt 21, NotreDame_De_Paris.txt 12
disturbing	Miserables.txt 5, NotreDame_De_Paris.txt 2
disturbs	NotreDame_De_Paris.txt 2, Miserables.txt 2
disuse	Miserables.txt 2
disused	Miserables.txt 1
dit	Miserables.txt 1
ditch	Miserables.txt 14
ditches	Miserables.txt 4
dithryamb	Miserables.txt 1
dithyrambs	Miserables.txt 2
ditto	Miserables.txt 1
ditty	NotreDame_De_Paris.txt 5, Miserables.txt 4
dived	Miserables.txt 2
diver	Miserables.txt 2
divergent	NotreDame_De_Paris.txt 1
divers	Miserables.txt 13, NotreDame_De_Paris.txt 2
diversa	NotreDame_De_Paris.txt 1
diverse	Miserables.txt 3, NotreDame_De_Paris.txt 1
diversely	Miserables.txt 1
diversion	Miserables.txt 9, NotreDame_De_Paris.txt 5
diversity	NotreDame_De_Paris.txt 2
divert	Miserables.txt 4
diverted	Miserables.txt 5, NotreDame_De_Paris.txt 4
diverting	NotreDame_De_Paris.txt 3, Miserables.txt 1
diverts	Miserables.txt 1
dives	Miserables.txt 1
divide	NotreDame_De_Paris.txt 1, Miserables.txt 1
divided	Miserables.txt 14, NotreDame_De_Paris.txt 8
divides	Miserables.txt 5
dividing	Miserables.txt 2
divin	Miserables.txt 1
divina	Miserables.txt 1
divination	Miserables.txt 5
divine	Miserables.txt 69, NotreDame_De_Paris.txt 12
divined	Miserables.txt 29, NotreDame_De_Paris.txt 4
divinely	Miserables.txt 4, NotreDame_De_Paris.txt 1
divinities	NotreDame_De_Paris.txt 1, Miserables.txt 1
divinity	NotreDame_De_Paris.txt 2, Miserables.txt 2
divinum	Miserables.txt 3
division	Miserables.txt 18
divisions	Miserables.txt 9, NotreDame_De_Paris.txt 1
divorce	NotreDame_De_Paris.txt 1, Miserables.txt 1
divorced	Miserables.txt 1
divrs	Miserables.txt 1
dix	Miserables.txt 2
dizziness	Miserables.txt 2, NotreDame_De_Paris.txt 1
dizzy	Miserables.txt 12
djali	NotreDame_De_Paris.txt 36
dnop	Miserables.txt 1
do	Miserables.txt 932, NotreDame_De_Paris.txt 324
docile	NotreDame_De_Paris.txt 3
docility	NotreDame_De_Paris.txt 1
dock	Miserables.txt 3
docket	Miserables.txt 6
docks	Miserables.txt 1
docteur	NotreDame_De_Paris.txt 1, Miserables.txt 1
doctor	Miserables.txt 89, NotreDame_De_Paris.txt 17
doctors	NotreDame_De_Paris.txt 5, Miserables.txt 5
doctorum	NotreDame_De_Paris.txt 1
doctrina	NotreDame_De_Paris.txt 1
doctrinaires	Miserables.txt 1
doctrinarian	Miserables.txt 3
doctrinarians	Miserables.txt 3
doctrinary	Miserables.txt 1
doctrine	Miserables.txt 2
doctrines	Miserables.txt 4, NotreDame_De_Paris.txt 1
document	Miserables.txt 3, NotreDame_De_Paris.txt 1
documents	NotreDame_De_Paris.txt 6, Miserables.txt 6
dod	Miserables.txt 1
dodge	Miserables.txt 2
dodona	Miserables.txt 1
dodu	Miserables.txt 1
does	Miserables.txt 344, NotreDame_De_Paris.txt 71
doeskin	NotreDame_De_Paris.txt 1
doesn	Miserables.txt 6, NotreDame_De_Paris.txt 1
dog	Miserables.txt 62, NotreDame_De_Paris.txt 26
doge	NotreDame_De_Paris.txt 2
dogged	Miserables.txt 1
doggy	Miserables.txt 1
dogma	Miserables.txt 9, NotreDame_De_Paris.txt 3
dogmas	Miserables.txt 4
dogmatic	NotreDame_De_Paris.txt 1
dogmatism	Miserables.txt 1
dogs	Miserables.txt 28, NotreDame_De_Paris.txt 13
dogue	Miserables.txt 1
doing	Miserables.txt 78, NotreDame_De_Paris.txt 18
doings	Miserables.txt 2
doled	Miserables.txt 1
doleful	Miserables.txt 3, NotreDame_De_Paris.txt 2
dolefully	Miserables.txt 3
doll	Miserables.txt 53, NotreDame_De_Paris.txt 2
dolls	Miserables.txt 6
dolmans	Miserables.txt 1
dolmen	NotreDame_De_Paris.txt 1
dolorous	NotreDame_De_Paris.txt 1, Miserables.txt 1
dolphin	NotreDame_De_Paris.txt 4
dolt	NotreDame_De_Paris.txt 2
dolts	NotreDame_De_Paris.txt 1
dom	NotreDame_De_Paris.txt 66, Miserables.txt 2
domain	Miserables.txt 11, NotreDame_De_Paris.txt 8
domaine	NotreDame_De_Paris.txt 1
domains	NotreDame_De_Paris.txt 1, Miserables.txt 1
dome	Miserables.txt 11, NotreDame_De_Paris.txt 7
domes	NotreDame_De_Paris.txt 1, Miserables.txt 1
domestic	Miserables.txt 10, NotreDame_De_Paris.txt 5
domesticity	Miserables.txt 1
domestics	Miserables.txt 3, NotreDame_De_Paris.txt 1
domicile	Miserables.txt 3
domiciled	Miserables.txt 1
domiciles	Miserables.txt 2
domiciliary	Miserables.txt 1
dominant	NotreDame_De_Paris.txt 1, Miserables.txt 1
dominate	Miserables.txt 3
dominated	Miserables.txt 8, NotreDame_De_Paris.txt 4
dominating	NotreDame_De_Paris.txt 2, Miserables.txt 2
domination	Miserables.txt 4
domince	NotreDame_De_Paris.txt 1
domine	NotreDame_De_Paris.txt 2, Miserables.txt 1
dominicans	Miserables.txt 1
dominique	Miserables.txt 5, NotreDame_De_Paris.txt 1
domino	Miserables.txt 1
dominoe	NotreDame_De_Paris.txt 2
dominoes	Miserables.txt 2
dominos	Miserables.txt 1
dominum	NotreDame_De_Paris.txt 3
dominus	NotreDame_De_Paris.txt 1, Miserables.txt 1
domitian	Miserables.txt 2
domne	NotreDame_De_Paris.txt 1
domni	NotreDame_De_Paris.txt 1
domon	Miserables.txt 2
domum	NotreDame_De_Paris.txt 1, Miserables.txt 1
domus	NotreDame_De_Paris.txt 1
don	Miserables.txt 222, NotreDame_De_Paris.txt 34
dona	Miserables.txt 1
donate	NotreDame_De_Paris.txt 4, Miserables.txt 4
donation	NotreDame_De_Paris.txt 1, Miserables.txt 1
donations	Miserables.txt 16, NotreDame_De_Paris.txt 15
donc	Miserables.txt 1
done	Miserables.txt 228, NotreDame_De_Paris.txt 60
dong	Miserables.txt 2
donjon	NotreDame_De_Paris.txt 11
donkey	Miserables.txt 1
donnais	Miserables.txt 2
donne	Miserables.txt 1
donned	Miserables.txt 4, NotreDame_De_Paris.txt 2
donning	NotreDame_De_Paris.txt 1, Miserables.txt 1
donors	Miserables.txt 2, NotreDame_De_Paris.txt 1
dons	Miserables.txt 1
donzelot	Miserables.txt 2
doomed	Miserables.txt 1
door	Miserables.txt 483, NotreDame_De_Paris.txt 166
doorpost	Miserables.txt 1
doors	Miserables.txt 61, NotreDame_De_Paris.txt 24
doorsteps	Miserables.txt 2
doorway	Miserables.txt 6, NotreDame_De_Paris.txt 1
doorways	Miserables.txt 1
dora	NotreDame_De_Paris.txt 1
dorante	Miserables.txt 1
dore	Miserables.txt 1
doric	Miserables.txt 1
dorimon	Miserables.txt 1
doriolle	NotreDame_De_Paris.txt 1
doris	Miserables.txt 1
dormans	NotreDame_De_Paris.txt 2
dormer	Miserables.txt 9, NotreDame_De_Paris.txt 3
dormitories	Miserables.txt 6
dormitory	Miserables.txt 7, NotreDame_De_Paris.txt 1
dormiunt	Miserables.txt 1
dornberg	Miserables.txt 1
dorsal	Miserables.txt 2
dort	Miserables.txt 1
dos	NotreDame_De_Paris.txt 1
dose	Miserables.txt 1
doses	Miserables.txt 1
dossier	Miserables.txt 1
dost	Miserables.txt 14, NotreDame_De_Paris.txt 3
dotage	NotreDame_De_Paris.txt 1, Miserables.txt 1
dotards	Miserables.txt 1
doth	NotreDame_De_Paris.txt 8, Miserables.txt 1
dotted	Miserables.txt 3, NotreDame_De_Paris.txt 1
douai	Miserables.txt 2
double	Miserables.txt 67, NotreDame_De_Paris.txt 29
doubled	NotreDame_De_Paris.txt 6, Miserables.txt 6
doubles	Miserables.txt 1
doublet	NotreDame_De_Paris.txt 18
doublets	NotreDame_De_Paris.txt 4
doubling	NotreDame_De_Paris.txt 1
doubly	Miserables.txt 5, NotreDame_De_Paris.txt 3
doubt	Miserables.txt 109, NotreDame_De_Paris.txt 57
doubted	NotreDame_De_Paris.txt 5, Miserables.txt 4
doubtful	Miserables.txt 6, NotreDame_De_Paris.txt 2
doubting	NotreDame_De_Paris.txt 1
doubtless	Miserables.txt 8
doubts	Miserables.txt 9, NotreDame_De_Paris.txt 2
douce	Miserables.txt 1
doulx	NotreDame_De_Paris.txt 1
doumec	Miserables.txt 1
doux	Miserables.txt 2
dove	Miserables.txt 7, NotreDame_De_Paris.txt 2
doves	Miserables.txt 3, NotreDame_De_Paris.txt 1
dowager	Miserables.txt 2, NotreDame_De_Paris.txt 1
dowagers	Miserables.txt 2
dowered	Miserables.txt 1
down	Miserables.txt 331, NotreDame_De_Paris.txt 115
downcast	Miserables.txt 9, NotreDame_De_Paris.txt 1
downfall	Miserables.txt 3
downloading	NotreDame_De_Paris.txt 1, Miserables.txt 1
downpour	Miserables.txt 6
downright	Miserables.txt 4
downs	Miserables.txt 2
downstairs	Miserables.txt 1
downstream	Miserables.txt 1
downward	Miserables.txt 8, NotreDame_De_Paris.txt 3
downwards	Miserables.txt 3, NotreDame_De_Paris.txt 2
dowry	Miserables.txt 3, NotreDame_De_Paris.txt 1
doze	Miserables.txt 3
dozed	Miserables.txt 2
dozen	Miserables.txt 12, NotreDame_De_Paris.txt 3
dozens	Miserables.txt 1
dozing	NotreDame_De_Paris.txt 1, Miserables.txt 1
dr	NotreDame_De_Paris.txt 4, Miserables.txt 2
dracatholicum	Miserables.txt 1
draco	Miserables.txt 1
draft	Miserables.txt 3
drag	Miserables.txt 18, NotreDame_De_Paris.txt 12
dragged	Miserables.txt 25, NotreDame_De_Paris.txt 16
dragging	Miserables.txt 18, NotreDame_De_Paris.txt 10
dragon	Miserables.txt 11, NotreDame_De_Paris.txt 4
dragonfly	Miserables.txt 1
dragonnades	Miserables.txt 1
dragons	NotreDame_De_Paris.txt 2, Miserables.txt 1
dragoon	Miserables.txt 5
dragoons	Miserables.txt 18
drags	Miserables.txt 3, NotreDame_De_Paris.txt 1
draguignan	Miserables.txt 1
drain	Miserables.txt 8, NotreDame_De_Paris.txt 1
drainage	Miserables.txt 3
drained	Miserables.txt 2
drains	NotreDame_De_Paris.txt 1, Miserables.txt 1
dram	NotreDame_De_Paris.txt 8, Miserables.txt 6
drama	Miserables.txt 22, NotreDame_De_Paris.txt 5
dramas	NotreDame_De_Paris.txt 1, Miserables.txt 1
dramatic	Miserables.txt 8, NotreDame_De_Paris.txt 6
drancy	Miserables.txt 1
drank	Miserables.txt 22, NotreDame_De_Paris.txt 4
drapeau	Miserables.txt 6
draped	Miserables.txt 7, NotreDame_De_Paris.txt 4
draperie	NotreDame_De_Paris.txt 1
draperies	NotreDame_De_Paris.txt 3, Miserables.txt 1
drapery	NotreDame_De_Paris.txt 3, Miserables.txt 1
drapes	Miserables.txt 1
draught	Miserables.txt 5, NotreDame_De_Paris.txt 2
draughts	NotreDame_De_Paris.txt 1, Miserables.txt 1
draw	Miserables.txt 35, NotreDame_De_Paris.txt 14
drawbridge	NotreDame_De_Paris.txt 4
drawer	Miserables.txt 16, NotreDame_De_Paris.txt 3
drawers	Miserables.txt 5
drawing	Miserables.txt 71, NotreDame_De_Paris.txt 9
drawl	NotreDame_De_Paris.txt 1, Miserables.txt 1
drawled	NotreDame_De_Paris.txt 1
drawling	NotreDame_De_Paris.txt 1
drawn	Miserables.txt 53, NotreDame_De_Paris.txt 15
draws	Miserables.txt 10, NotreDame_De_Paris.txt 3
dray	Miserables.txt 10
drays	Miserables.txt 2
dread	NotreDame_De_Paris.txt 2, Miserables.txt 1
dreaded	Miserables.txt 4, NotreDame_De_Paris.txt 1
dreadful	Miserables.txt 4, NotreDame_De_Paris.txt 1
dream	Miserables.txt 64, NotreDame_De_Paris.txt 14
dreamed	Miserables.txt 19, NotreDame_De_Paris.txt 7
dreamer	Miserables.txt 12, NotreDame_De_Paris.txt 1
dreamers	Miserables.txt 7
dreamily	NotreDame_De_Paris.txt 4
dreaminess	Miserables.txt 2
dreaming	Miserables.txt 19, NotreDame_De_Paris.txt 8
dreams	Miserables.txt 47, NotreDame_De_Paris.txt 10
dreamy	NotreDame_De_Paris.txt 6, Miserables.txt 6
dreary	Miserables.txt 2
dregs	Miserables.txt 2, NotreDame_De_Paris.txt 1
drenched	Miserables.txt 5, NotreDame_De_Paris.txt 4
dresden	Miserables.txt 2
dresos	Miserables.txt 1
dress	Miserables.txt 40, NotreDame_De_Paris.txt 8
dressed	Miserables.txt 80, NotreDame_De_Paris.txt 19
dresser	Miserables.txt 11, NotreDame_De_Paris.txt 2
dressers	Miserables.txt 1
dresses	Miserables.txt 6
dressing	Miserables.txt 22, NotreDame_De_Paris.txt 8
dressings	Miserables.txt 3
dreux	NotreDame_De_Paris.txt 1
drew	Miserables.txt 113, NotreDame_De_Paris.txt 24
dried	Miserables.txt 13, NotreDame_De_Paris.txt 2
dries	Miserables.txt 1
drift	NotreDame_De_Paris.txt 1
drifted	NotreDame_De_Paris.txt 1
drifts	NotreDame_De_Paris.txt 1
drilled	Miserables.txt 1
drilling	Miserables.txt 1
drink	Miserables.txt 50, NotreDame_De_Paris.txt 18
drinkable	Miserables.txt 1
drinker	Miserables.txt 8, NotreDame_De_Paris.txt 2
drinkers	Miserables.txt 11, NotreDame_De_Paris.txt 5
drinking	Miserables.txt 29, NotreDame_De_Paris.txt 9
drinks	Miserables.txt 7
drip	NotreDame_De_Paris.txt 1, Miserables.txt 1
dripped	NotreDame_De_Paris.txt 1, Miserables.txt 1
dripping	Miserables.txt 14, NotreDame_De_Paris.txt 6
drippings	Miserables.txt 1
drips	Miserables.txt 1
drive	Miserables.txt 15, NotreDame_De_Paris.txt 2
driven	Miserables.txt 20, NotreDame_De_Paris.txt 6
driver	Miserables.txt 10
drivers	Miserables.txt 2
drives	Miserables.txt 2
driving	Miserables.txt 13, NotreDame_De_Paris.txt 6
drizzling	Miserables.txt 1
drogheda	Miserables.txt 1
droit	Miserables.txt 20
drolesses	Miserables.txt 1
droll	NotreDame_De_Paris.txt 4, Miserables.txt 2
drone	NotreDame_De_Paris.txt 1
droned	NotreDame_De_Paris.txt 2, Miserables.txt 2
drones	NotreDame_De_Paris.txt 1
droop	NotreDame_De_Paris.txt 2, Miserables.txt 2
drooped	NotreDame_De_Paris.txt 2, Miserables.txt 2
drooping	Miserables.txt 24, NotreDame_De_Paris.txt 6
drop	Miserables.txt 37, NotreDame_De_Paris.txt 24
dropped	Miserables.txt 62, NotreDame_De_Paris.txt 17
dropping	Miserables.txt 4, NotreDame_De_Paris.txt 1
drops	Miserables.txt 18, NotreDame_De_Paris.txt 7
dropsy	NotreDame_De_Paris.txt 1
drouet	Miserables.txt 3
drouot	Miserables.txt 1
drove	Miserables.txt 7, NotreDame_De_Paris.txt 2
drover	Miserables.txt 1
drown	Miserables.txt 6, NotreDame_De_Paris.txt 2
drowned	Miserables.txt 10, NotreDame_De_Paris.txt 9
drowning	Miserables.txt 7
drownings	NotreDame_De_Paris.txt 1
drowns	Miserables.txt 1
drowsiness	Miserables.txt 1
drudge	Miserables.txt 1
drugged	Miserables.txt 1
drugget	Miserables.txt 2
drugs	Miserables.txt 8, NotreDame_De_Paris.txt 1
druid	Miserables.txt 1
druids	Miserables.txt 1
drum	Miserables.txt 11, NotreDame_De_Paris.txt 2
drummer	Miserables.txt 4
drums	Miserables.txt 8, NotreDame_De_Paris.txt 2
drunk	Miserables.txt 33, NotreDame_De_Paris.txt 7
drunkard	Miserables.txt 5
drunkards	Miserables.txt 1
drunken	Miserables.txt 16, NotreDame_De_Paris.txt 5
drunkenness	Miserables.txt 6
dry	Miserables.txt 31, NotreDame_De_Paris.txt 17
dryads	Miserables.txt 1
drying	Miserables.txt 5
dryly	NotreDame_De_Paris.txt 3, Miserables.txt 2
dryness	NotreDame_De_Paris.txt 1
ds	Miserables.txt 1
du	Miserables.txt 152, NotreDame_De_Paris.txt 55
dubarry	NotreDame_De_Paris.txt 1, Miserables.txt 1
dubartas	NotreDame_De_Paris.txt 1
dubbed	Miserables.txt 2, NotreDame_De_Paris.txt 1
dubious	Miserables.txt 2
dubois	Miserables.txt 3
duc	Miserables.txt 32, NotreDame_De_Paris.txt 3
ducal	Miserables.txt 2
duce	Miserables.txt 2
duchene	Miserables.txt 2
duchesne	Miserables.txt 1
duchess	Miserables.txt 4
duchesse	Miserables.txt 4, NotreDame_De_Paris.txt 1
duchesses	Miserables.txt 4, NotreDame_De_Paris.txt 1
duchy	NotreDame_De_Paris.txt 1
duck	Miserables.txt 3
ducked	Miserables.txt 1
ducks	Miserables.txt 2
duclos	Miserables.txt 1
ducray	Miserables.txt 2
ducts	Miserables.txt 3
ducum	NotreDame_De_Paris.txt 1
duds	Miserables.txt 7
due	Miserables.txt 21, NotreDame_De_Paris.txt 1
duel	Miserables.txt 7
duels	NotreDame_De_Paris.txt 1, Miserables.txt 1
duenna	Miserables.txt 1
dues	NotreDame_De_Paris.txt 1
duet	NotreDame_De_Paris.txt 2
duffer	Miserables.txt 1
dufond	Miserables.txt 1
dufour	Miserables.txt 1
dufresne	Miserables.txt 1
dug	Miserables.txt 8, NotreDame_De_Paris.txt 1
duhesme	Miserables.txt 1
duke	NotreDame_De_Paris.txt 33, Miserables.txt 12
dukes	Miserables.txt 2
duleau	Miserables.txt 1
dull	Miserables.txt 43, NotreDame_De_Paris.txt 9
dullards	Miserables.txt 1
dulled	Miserables.txt 3, NotreDame_De_Paris.txt 1
dulls	Miserables.txt 2
dully	Miserables.txt 1
dulness	Miserables.txt 1
duly	Miserables.txt 2
dum	Miserables.txt 1
dumarsais	Miserables.txt 1
dumb	NotreDame_De_Paris.txt 7, Miserables.txt 5
dumbfounded	NotreDame_De_Paris.txt 4
dumenil	Miserables.txt 1
duminil	Miserables.txt 1
dumollard	Miserables.txt 1
dumont	Miserables.txt 2
dumouriez	Miserables.txt 1
dung	Miserables.txt 15, NotreDame_De_Paris.txt 2
dungeon	Miserables.txt 10, NotreDame_De_Paris.txt 7
dungeons	Miserables.txt 7
dunghill	Miserables.txt 2, NotreDame_De_Paris.txt 1
dunkerque	Miserables.txt 1
dupe	Miserables.txt 6
duped	Miserables.txt 1
duperre	Miserables.txt 1
duplat	Miserables.txt 3
duplicates	Miserables.txt 1
dupont	Miserables.txt 1
duprat	Miserables.txt 1
dupuytren	Miserables.txt 2
duquesne	Miserables.txt 1
durable	NotreDame_De_Paris.txt 6
durance	Miserables.txt 1
duras	Miserables.txt 1
duration	Miserables.txt 3, NotreDame_De_Paris.txt 1
dure	Miserables.txt 1
durer	Miserables.txt 3
durham	Miserables.txt 1
duri	NotreDame_De_Paris.txt 1
during	Miserables.txt 131, NotreDame_De_Paris.txt 47
durs	Miserables.txt 1
durutte	Miserables.txt 3
dusk	Miserables.txt 15
dusky	NotreDame_De_Paris.txt 1, Miserables.txt 1
dust	Miserables.txt 33, NotreDame_De_Paris.txt 8
dusted	NotreDame_De_Paris.txt 1, Miserables.txt 1
duster	Miserables.txt 2
dusting	Miserables.txt 1
dusty	Miserables.txt 3, NotreDame_De_Paris.txt 1
dutch	Miserables.txt 5
dutemple	Miserables.txt 1
duties	Miserables.txt 30
duty	Miserables.txt 94, NotreDame_De_Paris.txt 6
duvivier	Miserables.txt 1
dwarf	Miserables.txt 6, NotreDame_De_Paris.txt 2
dwarfed	Miserables.txt 2
dwell	Miserables.txt 9, NotreDame_De_Paris.txt 2
dwellers	Miserables.txt 2
dwellest	Miserables.txt 1
dwelling	Miserables.txt 18, NotreDame_De_Paris.txt 4
dwellings	Miserables.txt 8, NotreDame_De_Paris.txt 2
dwells	Miserables.txt 2, NotreDame_De_Paris.txt 1
dwelt	Miserables.txt 14, NotreDame_De_Paris.txt 1
dwindle	Miserables.txt 1
dy	NotreDame_De_Paris.txt 2
dye	NotreDame_De_Paris.txt 1, Miserables.txt 1
dyer	NotreDame_De_Paris.txt 1
dying	Miserables.txt 51, NotreDame_De_Paris.txt 16
dyle	Miserables.txt 1
dymaerzelle	NotreDame_De_Paris.txt 1
dynamic	Miserables.txt 1
dynasties	Miserables.txt 1
dynasty	Miserables.txt 12
