wachau	Miserables.txt 1
wad	Miserables.txt 1
wadded	Miserables.txt 5
wadding	Miserables.txt 2
wading	Miserables.txt 1
wafer	Miserables.txt 2
wafers	Miserables.txt 3
wafted	NotreDame_De_Paris.txt 1, Miserables.txt 1
wag	Miserables.txt 2
wage	Miserables.txt 1
wager	NotreDame_De_Paris.txt 3, Miserables.txt 3
wages	NotreDame_De_Paris.txt 5, Miserables.txt 7
wagged	NotreDame_De_Paris.txt 1
waging	Miserables.txt 1
wagon	NotreDame_De_Paris.txt 1, Miserables.txt 19
wagoner	Miserables.txt 1
wagoners	Miserables.txt 3
wagons	Miserables.txt 13
wagram	Miserables.txt 3
wagramme	Miserables.txt 1
wags	Miserables.txt 1
wagtail	NotreDame_De_Paris.txt 1, Miserables.txt 1
wagtails	NotreDame_De_Paris.txt 1, Miserables.txt 1
waif	Miserables.txt 1
waifs	Miserables.txt 1
wail	Miserables.txt 1
wailed	NotreDame_De_Paris.txt 1
wailing	NotreDame_De_Paris.txt 1, Miserables.txt 1
wails	Miserables.txt 1
wainscoated	NotreDame_De_Paris.txt 1
wainscoating	NotreDame_De_Paris.txt 1
wainscot	Miserables.txt 1
wainscoted	Miserables.txt 2
wainscoting	Miserables.txt 1
waist	NotreDame_De_Paris.txt 11, Miserables.txt 17
waistcoat	NotreDame_De_Paris.txt 1, Miserables.txt 29
waistcoats	Miserables.txt 2
waisted	Miserables.txt 1
waists	Miserables.txt 1
wait	NotreDame_De_Paris.txt 18, Miserables.txt 55
waited	NotreDame_De_Paris.txt 10, Miserables.txt 33
waiter	Miserables.txt 7
waiters	NotreDame_De_Paris.txt 1
waiting	NotreDame_De_Paris.txt 24, Miserables.txt 68
waitress	NotreDame_De_Paris.txt 1
waits	Miserables.txt 1
wake	NotreDame_De_Paris.txt 1, Miserables.txt 7
waked	NotreDame_De_Paris.txt 3, Miserables.txt 7
waken	Miserables.txt 1
wakening	NotreDame_De_Paris.txt 1
wakes	Miserables.txt 3
waking	NotreDame_De_Paris.txt 3, Miserables.txt 15
walk	NotreDame_De_Paris.txt 12, Miserables.txt 72
walked	NotreDame_De_Paris.txt 22, Miserables.txt 83
walker	Miserables.txt 1
walking	NotreDame_De_Paris.txt 17, Miserables.txt 67
walks	NotreDame_De_Paris.txt 6, Miserables.txt 20
wall	NotreDame_De_Paris.txt 95, Miserables.txt 288
walled	NotreDame_De_Paris.txt 4, Miserables.txt 14
wallet	NotreDame_De_Paris.txt 1
wallflowers	NotreDame_De_Paris.txt 1
walling	NotreDame_De_Paris.txt 1
wallow	Miserables.txt 1
wallowed	Miserables.txt 1
wallows	Miserables.txt 2
walls	NotreDame_De_Paris.txt 44, Miserables.txt 101
walnut	Miserables.txt 1
walter	Miserables.txt 1
wan	NotreDame_De_Paris.txt 4, Miserables.txt 13
wand	NotreDame_De_Paris.txt 3, Miserables.txt 2
wander	Miserables.txt 3
wandered	Miserables.txt 7
wanderer	Miserables.txt 1
wandering	NotreDame_De_Paris.txt 3, Miserables.txt 8
wanders	Miserables.txt 1
wands	NotreDame_De_Paris.txt 1
wane	Miserables.txt 1
want	NotreDame_De_Paris.txt 29, Miserables.txt 131
wanted	NotreDame_De_Paris.txt 10, Miserables.txt 30
wanting	Miserables.txt 8
wanton	NotreDame_De_Paris.txt 3, Miserables.txt 4
wantonly	Miserables.txt 2
wants	NotreDame_De_Paris.txt 6, Miserables.txt 17
war	NotreDame_De_Paris.txt 8, Miserables.txt 136
warble	Miserables.txt 1
warbled	Miserables.txt 1
warbler	NotreDame_De_Paris.txt 2, Miserables.txt 2
warblers	NotreDame_De_Paris.txt 2, Miserables.txt 1
warbling	Miserables.txt 1
ward	NotreDame_De_Paris.txt 1, Miserables.txt 2
warden	NotreDame_De_Paris.txt 2, Miserables.txt 14
wardens	NotreDame_De_Paris.txt 1
warder	NotreDame_De_Paris.txt 1
wardrobe	Miserables.txt 3
wards	Miserables.txt 1
ware	Miserables.txt 3
warehouse	NotreDame_De_Paris.txt 1
warehouses	Miserables.txt 1
wares	Miserables.txt 1
warlike	NotreDame_De_Paris.txt 1, Miserables.txt 2
warm	NotreDame_De_Paris.txt 13, Miserables.txt 40
warmed	NotreDame_De_Paris.txt 1, Miserables.txt 12
warmer	NotreDame_De_Paris.txt 3
warming	NotreDame_De_Paris.txt 2, Miserables.txt 4
warmly	NotreDame_De_Paris.txt 2, Miserables.txt 5
warms	NotreDame_De_Paris.txt 2
warmth	NotreDame_De_Paris.txt 2, Miserables.txt 8
warn	NotreDame_De_Paris.txt 3, Miserables.txt 14
warned	NotreDame_De_Paris.txt 5, Miserables.txt 18
warning	NotreDame_De_Paris.txt 3, Miserables.txt 15
warnings	Miserables.txt 1
warns	Miserables.txt 2
warp	NotreDame_De_Paris.txt 1
warped	Miserables.txt 1
warrant	NotreDame_De_Paris.txt 1, Miserables.txt 2
warranties	NotreDame_De_Paris.txt 3, Miserables.txt 3
warranty	NotreDame_De_Paris.txt 2, Miserables.txt 2
warren	Miserables.txt 1
warrior	Miserables.txt 6
warriors	Miserables.txt 1
wars	Miserables.txt 16
warsaw	Miserables.txt 3
wart	NotreDame_De_Paris.txt 5, Miserables.txt 4
warts	NotreDame_De_Paris.txt 4, Miserables.txt 4
was	NotreDame_De_Paris.txt 2245, Miserables.txt 8621
wash	NotreDame_De_Paris.txt 2, Miserables.txt 11
washed	NotreDame_De_Paris.txt 1, Miserables.txt 11
washer	Miserables.txt 2
washerwoman	Miserables.txt 1
washerwomen	Miserables.txt 2
washes	Miserables.txt 1
washing	NotreDame_De_Paris.txt 1, Miserables.txt 9
washington	Miserables.txt 6
wasn	NotreDame_De_Paris.txt 1, Miserables.txt 4
wasp	NotreDame_De_Paris.txt 4, Miserables.txt 1
wasps	Miserables.txt 2
waste	Miserables.txt 27
wasted	NotreDame_De_Paris.txt 2, Miserables.txt 11
wastefulness	Miserables.txt 1
wastes	NotreDame_De_Paris.txt 1, Miserables.txt 6
wasting	NotreDame_De_Paris.txt 1, Miserables.txt 8
watch	NotreDame_De_Paris.txt 41, Miserables.txt 80
watchdog	Miserables.txt 1
watched	NotreDame_De_Paris.txt 15, Miserables.txt 31
watcher	Miserables.txt 4
watchers	Miserables.txt 1
watches	NotreDame_De_Paris.txt 3, Miserables.txt 5
watchfulness	Miserables.txt 1
watching	NotreDame_De_Paris.txt 9, Miserables.txt 33
watchmaker	Miserables.txt 2
watchman	Miserables.txt 1
watchmen	Miserables.txt 1
watchwords	Miserables.txt 1
water	NotreDame_De_Paris.txt 72, Miserables.txt 204
watered	Miserables.txt 9
watering	NotreDame_De_Paris.txt 1, Miserables.txt 7
waterloo	Miserables.txt 111
waters	NotreDame_De_Paris.txt 4, Miserables.txt 10
watershed	Miserables.txt 1
waterside	Miserables.txt 1
waterspout	Miserables.txt 1
waterspouts	NotreDame_De_Paris.txt 1
waterworks	Miserables.txt 1
wathier	Miserables.txt 2
watteau	Miserables.txt 3
wattles	Miserables.txt 1
wave	NotreDame_De_Paris.txt 2, Miserables.txt 6
waved	Miserables.txt 3
waver	Miserables.txt 4
wavered	NotreDame_De_Paris.txt 7, Miserables.txt 6
wavering	NotreDame_De_Paris.txt 2, Miserables.txt 3
wavers	NotreDame_De_Paris.txt 1, Miserables.txt 1
waves	NotreDame_De_Paris.txt 11, Miserables.txt 16
waving	NotreDame_De_Paris.txt 4, Miserables.txt 4
wavre	Miserables.txt 2
wax	NotreDame_De_Paris.txt 13, Miserables.txt 16
waxed	Miserables.txt 6
waxen	Miserables.txt 2
waxing	Miserables.txt 1
way	NotreDame_De_Paris.txt 116, Miserables.txt 424
wayfarer	Miserables.txt 10
ways	NotreDame_De_Paris.txt 9, Miserables.txt 26
wayside	Miserables.txt 1
we	NotreDame_De_Paris.txt 339, Miserables.txt 1316
weak	NotreDame_De_Paris.txt 7, Miserables.txt 19
weaken	NotreDame_De_Paris.txt 1
weakened	Miserables.txt 6
weakening	Miserables.txt 1
weaker	NotreDame_De_Paris.txt 2, Miserables.txt 1
weakly	NotreDame_De_Paris.txt 1, Miserables.txt 2
weakness	NotreDame_De_Paris.txt 2, Miserables.txt 9
weaknesses	Miserables.txt 2
wealth	NotreDame_De_Paris.txt 2, Miserables.txt 13
wealthy	NotreDame_De_Paris.txt 2, Miserables.txt 21
weapon	NotreDame_De_Paris.txt 4, Miserables.txt 10
weapons	NotreDame_De_Paris.txt 4, Miserables.txt 7
wear	NotreDame_De_Paris.txt 7, Miserables.txt 29
wearer	Miserables.txt 1
wearers	Miserables.txt 1
wearest	NotreDame_De_Paris.txt 1
wearied	Miserables.txt 2
wearies	NotreDame_De_Paris.txt 2
weariness	NotreDame_De_Paris.txt 4, Miserables.txt 4
wearing	NotreDame_De_Paris.txt 1, Miserables.txt 27
wearisome	NotreDame_De_Paris.txt 1, Miserables.txt 1
wears	NotreDame_De_Paris.txt 5, Miserables.txt 6
weary	NotreDame_De_Paris.txt 7, Miserables.txt 22
weasel	NotreDame_De_Paris.txt 1
weather	NotreDame_De_Paris.txt 3, Miserables.txt 24
weathercocks	NotreDame_De_Paris.txt 1
weathervane	Miserables.txt 1
weave	Miserables.txt 2
weaver	Miserables.txt 2
weaving	NotreDame_De_Paris.txt 1, Miserables.txt 1
weazand	NotreDame_De_Paris.txt 3
web	NotreDame_De_Paris.txt 14, Miserables.txt 13
weber	Miserables.txt 1
webs	NotreDame_De_Paris.txt 3, Miserables.txt 5
wed	NotreDame_De_Paris.txt 3, Miserables.txt 4
wedded	NotreDame_De_Paris.txt 1, Miserables.txt 10
wedding	NotreDame_De_Paris.txt 3, Miserables.txt 46
weddings	Miserables.txt 1
wedge	NotreDame_De_Paris.txt 2
wednesday	Miserables.txt 3
weeding	Miserables.txt 2
weeds	Miserables.txt 7
week	NotreDame_De_Paris.txt 8, Miserables.txt 38
weekly	Miserables.txt 2
weeks	NotreDame_De_Paris.txt 3, Miserables.txt 23
weep	NotreDame_De_Paris.txt 9, Miserables.txt 28
weeping	NotreDame_De_Paris.txt 6, Miserables.txt 19
weeps	Miserables.txt 3
weevils	Miserables.txt 1
weigh	Miserables.txt 2
weighed	NotreDame_De_Paris.txt 2, Miserables.txt 15
weighing	NotreDame_De_Paris.txt 4, Miserables.txt 4
weighs	Miserables.txt 7
weight	NotreDame_De_Paris.txt 11, Miserables.txt 22
weights	Miserables.txt 3
weimar	Miserables.txt 1
welcome	NotreDame_De_Paris.txt 5, Miserables.txt 21
welcomed	Miserables.txt 2
welded	Miserables.txt 2
welding	Miserables.txt 1
well	NotreDame_De_Paris.txt 159, Miserables.txt 643
welled	NotreDame_De_Paris.txt 2, Miserables.txt 3
wellington	Miserables.txt 67
wells	NotreDame_De_Paris.txt 3, Miserables.txt 4
weltingen	Miserables.txt 1
wench	NotreDame_De_Paris.txt 22, Miserables.txt 4
wenches	NotreDame_De_Paris.txt 7, Miserables.txt 1
went	NotreDame_De_Paris.txt 66, Miserables.txt 412
wentest	Miserables.txt 1
wept	NotreDame_De_Paris.txt 13, Miserables.txt 25
were	NotreDame_De_Paris.txt 520, Miserables.txt 1824
weren	Miserables.txt 2
werewolf	Miserables.txt 1
wert	NotreDame_De_Paris.txt 1, Miserables.txt 9
werther	Miserables.txt 1
west	NotreDame_De_Paris.txt 11, Miserables.txt 10
western	NotreDame_De_Paris.txt 6, Miserables.txt 1
wet	NotreDame_De_Paris.txt 3, Miserables.txt 23
wets	Miserables.txt 1
wetting	Miserables.txt 2
whack	Miserables.txt 1
whale	NotreDame_De_Paris.txt 1, Miserables.txt 1
wharf	NotreDame_De_Paris.txt 1
what	NotreDame_De_Paris.txt 505, Miserables.txt 1857
whatever	NotreDame_De_Paris.txt 10, Miserables.txt 71
whatsoever	NotreDame_De_Paris.txt 2, Miserables.txt 4
wheat	NotreDame_De_Paris.txt 12, Miserables.txt 13
wheedling	Miserables.txt 1
wheel	NotreDame_De_Paris.txt 17, Miserables.txt 29
wheelbarrows	Miserables.txt 1
wheeled	NotreDame_De_Paris.txt 3, Miserables.txt 19
wheels	NotreDame_De_Paris.txt 10, Miserables.txt 37
wheelwright	Miserables.txt 16
whelp	NotreDame_De_Paris.txt 1
whelps	Miserables.txt 1
when	NotreDame_De_Paris.txt 441, Miserables.txt 1366
whence	NotreDame_De_Paris.txt 20, Miserables.txt 76
whenever	NotreDame_De_Paris.txt 1, Miserables.txt 18
where	NotreDame_De_Paris.txt 164, Miserables.txt 620
whereabouts	Miserables.txt 2
whereas	Miserables.txt 1
whereat	NotreDame_De_Paris.txt 1
wherein	NotreDame_De_Paris.txt 5, Miserables.txt 11
whereon	NotreDame_De_Paris.txt 1, Miserables.txt 3
whereupon	NotreDame_De_Paris.txt 1
wherever	Miserables.txt 12
wherewith	NotreDame_De_Paris.txt 3, Miserables.txt 2
wherewithal	NotreDame_De_Paris.txt 4, Miserables.txt 2
whet	Miserables.txt 2
whether	NotreDame_De_Paris.txt 37, Miserables.txt 114
whetted	Miserables.txt 1
whew	NotreDame_De_Paris.txt 1
which	NotreDame_De_Paris.txt 1759, Miserables.txt 5149
whiffle	Miserables.txt 3
while	NotreDame_De_Paris.txt 105, Miserables.txt 284
whilst	NotreDame_De_Paris.txt 1
whim	Miserables.txt 2
whimsical	NotreDame_De_Paris.txt 4, Miserables.txt 1
whine	NotreDame_De_Paris.txt 1
whining	Miserables.txt 3
whip	NotreDame_De_Paris.txt 2, Miserables.txt 15
whipped	Miserables.txt 5
whippers	Miserables.txt 1
whipping	NotreDame_De_Paris.txt 1, Miserables.txt 1
whips	NotreDame_De_Paris.txt 2, Miserables.txt 4
whirl	Miserables.txt 4
whirled	NotreDame_De_Paris.txt 6, Miserables.txt 3
whirling	NotreDame_De_Paris.txt 1, Miserables.txt 3
whirlpools	NotreDame_De_Paris.txt 1, Miserables.txt 1
whirls	NotreDame_De_Paris.txt 1, Miserables.txt 2
whirlwind	NotreDame_De_Paris.txt 5, Miserables.txt 18
whirlwinds	NotreDame_De_Paris.txt 1, Miserables.txt 3
whiskered	NotreDame_De_Paris.txt 1
whiskers	NotreDame_De_Paris.txt 1, Miserables.txt 5
whisper	NotreDame_De_Paris.txt 3, Miserables.txt 12
whispered	NotreDame_De_Paris.txt 4, Miserables.txt 17
whispering	NotreDame_De_Paris.txt 3, Miserables.txt 10
whisperings	Miserables.txt 1
whispers	NotreDame_De_Paris.txt 1, Miserables.txt 8
whist	Miserables.txt 3
whistle	NotreDame_De_Paris.txt 7, Miserables.txt 3
whistled	NotreDame_De_Paris.txt 2, Miserables.txt 5
whistles	Miserables.txt 1
whistling	NotreDame_De_Paris.txt 8, Miserables.txt 6
whit	Miserables.txt 1
white	NotreDame_De_Paris.txt 86, Miserables.txt 245
whiten	Miserables.txt 1
whitened	Miserables.txt 2
whiteness	NotreDame_De_Paris.txt 4, Miserables.txt 19
whitening	NotreDame_De_Paris.txt 1, Miserables.txt 2
whiter	Miserables.txt 1
whitest	NotreDame_De_Paris.txt 1, Miserables.txt 1
whitewash	Miserables.txt 1
whitewashed	NotreDame_De_Paris.txt 1, Miserables.txt 5
whitewashes	NotreDame_De_Paris.txt 1
whither	NotreDame_De_Paris.txt 17, Miserables.txt 44
whiting	Miserables.txt 3
whitish	NotreDame_De_Paris.txt 2, Miserables.txt 12
whizzed	NotreDame_De_Paris.txt 1
who	NotreDame_De_Paris.txt 701, Miserables.txt 2558
whoever	NotreDame_De_Paris.txt 2, Miserables.txt 21
whole	NotreDame_De_Paris.txt 106, Miserables.txt 344
wholesale	Miserables.txt 5
wholesome	Miserables.txt 3
wholesomeness	Miserables.txt 1
wholly	NotreDame_De_Paris.txt 17, Miserables.txt 37
whom	NotreDame_De_Paris.txt 126, Miserables.txt 358
whomsoever	Miserables.txt 2
whorls	NotreDame_De_Paris.txt 1
whose	NotreDame_De_Paris.txt 147, Miserables.txt 192
why	NotreDame_De_Paris.txt 60, Miserables.txt 263
wick	NotreDame_De_Paris.txt 3, Miserables.txt 3
wicked	NotreDame_De_Paris.txt 4, Miserables.txt 26
wicker	Miserables.txt 3
wicket	NotreDame_De_Paris.txt 6, Miserables.txt 9
wickets	NotreDame_De_Paris.txt 1, Miserables.txt 1
wide	NotreDame_De_Paris.txt 21, Miserables.txt 38
widely	NotreDame_De_Paris.txt 1, Miserables.txt 4
widened	Miserables.txt 1
widening	Miserables.txt 3
wider	NotreDame_De_Paris.txt 2, Miserables.txt 1
widespread	Miserables.txt 1
widest	NotreDame_De_Paris.txt 2, Miserables.txt 2
widow	NotreDame_De_Paris.txt 5, Miserables.txt 16
widowed	Miserables.txt 4
widower	Miserables.txt 3
widowers	Miserables.txt 1
widowhood	Miserables.txt 4
widows	NotreDame_De_Paris.txt 4, Miserables.txt 3
width	NotreDame_De_Paris.txt 1, Miserables.txt 3
wield	NotreDame_De_Paris.txt 1
wielded	Miserables.txt 1
wife	NotreDame_De_Paris.txt 27, Miserables.txt 98
wig	Miserables.txt 7
wigmaker	Miserables.txt 1
wigs	Miserables.txt 4
wigwam	Miserables.txt 1
wild	NotreDame_De_Paris.txt 33, Miserables.txt 72
wilda	Miserables.txt 1
wildest	NotreDame_De_Paris.txt 1, Miserables.txt 2
wildly	NotreDame_De_Paris.txt 3, Miserables.txt 6
wildness	Miserables.txt 3
will	NotreDame_De_Paris.txt 413, Miserables.txt 1232
willed	NotreDame_De_Paris.txt 3, Miserables.txt 5
william	NotreDame_De_Paris.txt 1, Miserables.txt 3
willing	NotreDame_De_Paris.txt 9, Miserables.txt 16
willingly	NotreDame_De_Paris.txt 2, Miserables.txt 8
willingness	Miserables.txt 1
willow	Miserables.txt 3
willows	Miserables.txt 2
wills	NotreDame_De_Paris.txt 3, Miserables.txt 9
wilt	NotreDame_De_Paris.txt 4, Miserables.txt 6
win	NotreDame_De_Paris.txt 2, Miserables.txt 7
wince	NotreDame_De_Paris.txt 1
winchestre	NotreDame_De_Paris.txt 1
wincing	NotreDame_De_Paris.txt 2
wincke	Miserables.txt 1
wind	NotreDame_De_Paris.txt 19, Miserables.txt 88
winded	Miserables.txt 1
windfall	Miserables.txt 1
windfalls	Miserables.txt 3
winding	NotreDame_De_Paris.txt 3, Miserables.txt 15
windings	NotreDame_De_Paris.txt 2, Miserables.txt 1
windmill	NotreDame_De_Paris.txt 1
windmills	NotreDame_De_Paris.txt 2
window	NotreDame_De_Paris.txt 116, Miserables.txt 182
windows	NotreDame_De_Paris.txt 62, Miserables.txt 85
windowsills	Miserables.txt 1
winds	NotreDame_De_Paris.txt 2, Miserables.txt 12
windsor	Miserables.txt 1
wine	NotreDame_De_Paris.txt 29, Miserables.txt 146
winedocks	Miserables.txt 1
wines	Miserables.txt 2
wineshops	Miserables.txt 1
wing	NotreDame_De_Paris.txt 1, Miserables.txt 28
winged	NotreDame_De_Paris.txt 5, Miserables.txt 7
wings	NotreDame_De_Paris.txt 20, Miserables.txt 42
wink	Miserables.txt 2
winked	Miserables.txt 5
winking	NotreDame_De_Paris.txt 2, Miserables.txt 1
winks	Miserables.txt 1
winner	Miserables.txt 3
winning	Miserables.txt 3
wins	Miserables.txt 4
winter	NotreDame_De_Paris.txt 20, Miserables.txt 73
winters	Miserables.txt 1
wintry	Miserables.txt 3
wion	Miserables.txt 1
wipe	NotreDame_De_Paris.txt 2, Miserables.txt 5
wiped	NotreDame_De_Paris.txt 2, Miserables.txt 4
wiping	NotreDame_De_Paris.txt 2, Miserables.txt 3
wire	NotreDame_De_Paris.txt 1, Miserables.txt 6
wisdom	NotreDame_De_Paris.txt 3, Miserables.txt 24
wise	NotreDame_De_Paris.txt 14, Miserables.txt 33
wisely	NotreDame_De_Paris.txt 1, Miserables.txt 4
wisest	Miserables.txt 2
wish	NotreDame_De_Paris.txt 36, Miserables.txt 99
wished	NotreDame_De_Paris.txt 19, Miserables.txt 45
wishes	NotreDame_De_Paris.txt 5, Miserables.txt 11
wishing	NotreDame_De_Paris.txt 1, Miserables.txt 5
wisp	Miserables.txt 2
wisps	Miserables.txt 1
wit	NotreDame_De_Paris.txt 2, Miserables.txt 23
witch	NotreDame_De_Paris.txt 17
witchcraft	NotreDame_De_Paris.txt 6
witchcrafts	NotreDame_De_Paris.txt 1
witches	NotreDame_De_Paris.txt 19, Miserables.txt 1
with	NotreDame_De_Paris.txt 1861, Miserables.txt 4528
withal	Miserables.txt 2
withdraw	NotreDame_De_Paris.txt 3, Miserables.txt 13
withdrawing	NotreDame_De_Paris.txt 1, Miserables.txt 10
withdrawn	NotreDame_De_Paris.txt 3, Miserables.txt 7
withdraws	Miserables.txt 1
withdrew	NotreDame_De_Paris.txt 11, Miserables.txt 12
wither	NotreDame_De_Paris.txt 1
withered	NotreDame_De_Paris.txt 4, Miserables.txt 2
withering	NotreDame_De_Paris.txt 1, Miserables.txt 3
withers	NotreDame_De_Paris.txt 1
withheld	NotreDame_De_Paris.txt 1, Miserables.txt 3
within	NotreDame_De_Paris.txt 37, Miserables.txt 154
without	NotreDame_De_Paris.txt 220, Miserables.txt 699
withstood	Miserables.txt 1
witness	NotreDame_De_Paris.txt 7, Miserables.txt 23
witnessed	NotreDame_De_Paris.txt 2, Miserables.txt 13
witnesses	NotreDame_De_Paris.txt 1, Miserables.txt 16
witnessing	Miserables.txt 2
wits	NotreDame_De_Paris.txt 2, Miserables.txt 4
witted	NotreDame_De_Paris.txt 1
witticisms	Miserables.txt 1
witty	Miserables.txt 7
wives	NotreDame_De_Paris.txt 3, Miserables.txt 10
woe	NotreDame_De_Paris.txt 2, Miserables.txt 16
woes	Miserables.txt 2
woke	NotreDame_De_Paris.txt 3, Miserables.txt 15
wolf	NotreDame_De_Paris.txt 6, Miserables.txt 30
wolves	NotreDame_De_Paris.txt 2, Miserables.txt 7
woman	NotreDame_De_Paris.txt 112, Miserables.txt 435
womanhood	Miserables.txt 1
women	NotreDame_De_Paris.txt 80, Miserables.txt 162
won	NotreDame_De_Paris.txt 3, Miserables.txt 50
wonder	Miserables.txt 2
wonderful	NotreDame_De_Paris.txt 3, Miserables.txt 20
wonderfully	Miserables.txt 5
wondering	Miserables.txt 1
wonderment	NotreDame_De_Paris.txt 1, Miserables.txt 1
wonders	NotreDame_De_Paris.txt 1, Miserables.txt 1
wondrous	NotreDame_De_Paris.txt 1
wont	NotreDame_De_Paris.txt 4, Miserables.txt 11
wood	NotreDame_De_Paris.txt 28, Miserables.txt 64
woodcutter	NotreDame_De_Paris.txt 1
woodcutters	NotreDame_De_Paris.txt 1
wooded	Miserables.txt 1
wooden	NotreDame_De_Paris.txt 18, Miserables.txt 50
woodland	NotreDame_De_Paris.txt 1
woodpeckers	Miserables.txt 2
woods	NotreDame_De_Paris.txt 4, Miserables.txt 15
woodwork	NotreDame_De_Paris.txt 8, Miserables.txt 6
wool	NotreDame_De_Paris.txt 2, Miserables.txt 5
woolen	NotreDame_De_Paris.txt 2
woollen	Miserables.txt 26
woolsey	NotreDame_De_Paris.txt 2
word	NotreDame_De_Paris.txt 105, Miserables.txt 297
words	NotreDame_De_Paris.txt 75, Miserables.txt 260
wore	NotreDame_De_Paris.txt 28, Miserables.txt 71
work	NotreDame_De_Paris.txt 114, Miserables.txt 250
worked	NotreDame_De_Paris.txt 2, Miserables.txt 19
worker	NotreDame_De_Paris.txt 1, Miserables.txt 4
workers	NotreDame_De_Paris.txt 1, Miserables.txt 5
working	NotreDame_De_Paris.txt 4, Miserables.txt 25
workingman	Miserables.txt 16
workingmen	Miserables.txt 4
workings	Miserables.txt 1
workman	NotreDame_De_Paris.txt 1, Miserables.txt 16
workmanship	Miserables.txt 1
workmen	NotreDame_De_Paris.txt 4, Miserables.txt 17
workpeople	Miserables.txt 1
workroom	Miserables.txt 6
workrooms	Miserables.txt 1
works	NotreDame_De_Paris.txt 42, Miserables.txt 58
workshop	NotreDame_De_Paris.txt 1, Miserables.txt 2
workshops	Miserables.txt 5
workwoman	Miserables.txt 3
workwomen	Miserables.txt 1
world	NotreDame_De_Paris.txt 67, Miserables.txt 201
worldlings	Miserables.txt 1
worlds	NotreDame_De_Paris.txt 1, Miserables.txt 2
worm	NotreDame_De_Paris.txt 2, Miserables.txt 10
wormeaten	NotreDame_De_Paris.txt 6
worms	NotreDame_De_Paris.txt 1, Miserables.txt 3
worn	NotreDame_De_Paris.txt 11, Miserables.txt 38
worry	NotreDame_De_Paris.txt 1, Miserables.txt 2
worrying	Miserables.txt 1
worse	NotreDame_De_Paris.txt 8, Miserables.txt 39
worship	NotreDame_De_Paris.txt 1, Miserables.txt 6
worst	NotreDame_De_Paris.txt 2, Miserables.txt 10
worsted	NotreDame_De_Paris.txt 1, Miserables.txt 3
worth	NotreDame_De_Paris.txt 17, Miserables.txt 38
worthy	NotreDame_De_Paris.txt 23, Miserables.txt 67
would	NotreDame_De_Paris.txt 320, Miserables.txt 1053
wouldn	Miserables.txt 6
wouldst	NotreDame_De_Paris.txt 1
wound	NotreDame_De_Paris.txt 14, Miserables.txt 35
wounded	NotreDame_De_Paris.txt 7, Miserables.txt 67
wounds	NotreDame_De_Paris.txt 5, Miserables.txt 31
wove	Miserables.txt 2
woven	NotreDame_De_Paris.txt 1, Miserables.txt 1
wows	Miserables.txt 1
wrap	Miserables.txt 2
wrapped	Miserables.txt 13
wrapper	Miserables.txt 1
wrapping	Miserables.txt 1
wrath	NotreDame_De_Paris.txt 22, Miserables.txt 63
wrathful	NotreDame_De_Paris.txt 2
wraths	Miserables.txt 2
wreak	NotreDame_De_Paris.txt 1
wreaking	Miserables.txt 1
wreath	Miserables.txt 3
wreathing	Miserables.txt 1
wreaths	Miserables.txt 1
wrecked	Miserables.txt 1
wrecks	Miserables.txt 1
wrenched	NotreDame_De_Paris.txt 3, Miserables.txt 5
wrenching	NotreDame_De_Paris.txt 1
wrestler	Miserables.txt 1
wrestlers	Miserables.txt 1
wrestling	NotreDame_De_Paris.txt 1
wretch	NotreDame_De_Paris.txt 24, Miserables.txt 49
wretched	NotreDame_De_Paris.txt 24, Miserables.txt 37
wretchedness	NotreDame_De_Paris.txt 1, Miserables.txt 35
wretches	NotreDame_De_Paris.txt 6, Miserables.txt 15
wriggle	Miserables.txt 1
wring	Miserables.txt 4
wringers	NotreDame_De_Paris.txt 1
wringing	NotreDame_De_Paris.txt 1, Miserables.txt 4
wrings	Miserables.txt 1
wrinkle	NotreDame_De_Paris.txt 3, Miserables.txt 6
wrinkled	NotreDame_De_Paris.txt 12, Miserables.txt 15
wrinkles	NotreDame_De_Paris.txt 4, Miserables.txt 11
wrinkling	Miserables.txt 1
wrist	Miserables.txt 5
wrists	NotreDame_De_Paris.txt 1, Miserables.txt 3
writ	Miserables.txt 1
write	NotreDame_De_Paris.txt 11, Miserables.txt 44
writer	NotreDame_De_Paris.txt 1, Miserables.txt 13
writers	Miserables.txt 3
writes	NotreDame_De_Paris.txt 3, Miserables.txt 6
writhe	NotreDame_De_Paris.txt 1, Miserables.txt 4
writhed	NotreDame_De_Paris.txt 11, Miserables.txt 3
writhes	NotreDame_De_Paris.txt 1, Miserables.txt 1
writhing	NotreDame_De_Paris.txt 3, Miserables.txt 2
writing	NotreDame_De_Paris.txt 8, Miserables.txt 35
writings	Miserables.txt 3
written	NotreDame_De_Paris.txt 26, Miserables.txt 70
wrong	NotreDame_De_Paris.txt 8, Miserables.txt 66
wronged	Miserables.txt 1
wrongfully	Miserables.txt 2
wronging	Miserables.txt 1
wrongly	Miserables.txt 6
wrongs	Miserables.txt 4
wrote	NotreDame_De_Paris.txt 9, Miserables.txt 52
wroth	Miserables.txt 1
wrought	NotreDame_De_Paris.txt 5, Miserables.txt 4
wrung	NotreDame_De_Paris.txt 3, Miserables.txt 3
wry	NotreDame_De_Paris.txt 1
wurmser	Miserables.txt 5
www	NotreDame_De_Paris.txt 6, Miserables.txt 6
wynter	Miserables.txt 1
