t	Miserables.txt 380, NotreDame_De_Paris.txt 61
ta	Miserables.txt 6, NotreDame_De_Paris.txt 1
tabaraud	Miserables.txt 1
tabernacle	NotreDame_De_Paris.txt 1
tabernacles	NotreDame_De_Paris.txt 1
table	Miserables.txt 228, NotreDame_De_Paris.txt 56
tablecloth	Miserables.txt 1
tables	Miserables.txt 25, NotreDame_De_Paris.txt 11
tablet	Miserables.txt 1
tabs	Miserables.txt 1
taches	Miserables.txt 1
tacit	Miserables.txt 3
tacitly	Miserables.txt 2
taciturn	Miserables.txt 5, NotreDame_De_Paris.txt 1
taciturnity	Miserables.txt 2
tacitus	Miserables.txt 10
tacituses	Miserables.txt 1
tack	NotreDame_De_Paris.txt 1
tact	Miserables.txt 1
tactics	Miserables.txt 9
tadpoles	Miserables.txt 1
taf	Miserables.txt 1
taffeta	Miserables.txt 2
tail	Miserables.txt 17, NotreDame_De_Paris.txt 12
tailors	Miserables.txt 1
tails	Miserables.txt 8
taint	Miserables.txt 2
tainted	Miserables.txt 2
tainville	Miserables.txt 1
take	Miserables.txt 372, NotreDame_De_Paris.txt 114
taken	Miserables.txt 295, NotreDame_De_Paris.txt 54
takes	Miserables.txt 63, NotreDame_De_Paris.txt 11
taketh	NotreDame_De_Paris.txt 1
taking	Miserables.txt 130, NotreDame_De_Paris.txt 28
tal	Miserables.txt 1
talapoins	Miserables.txt 1
talavera	Miserables.txt 2
talbot	Miserables.txt 1
tale	Miserables.txt 12, NotreDame_De_Paris.txt 6
talent	Miserables.txt 10, NotreDame_De_Paris.txt 1
talents	Miserables.txt 9
tales	Miserables.txt 3
talisman	Miserables.txt 1
talk	Miserables.txt 61, NotreDame_De_Paris.txt 12
talkative	Miserables.txt 4
talked	Miserables.txt 42, NotreDame_De_Paris.txt 7
talker	Miserables.txt 4
talking	Miserables.txt 66, NotreDame_De_Paris.txt 11
talks	Miserables.txt 9, NotreDame_De_Paris.txt 3
tall	Miserables.txt 42, NotreDame_De_Paris.txt 8
taller	Miserables.txt 5, NotreDame_De_Paris.txt 1
talleyrand	Miserables.txt 6
tallow	NotreDame_De_Paris.txt 3, Miserables.txt 3
tally	Miserables.txt 1
talma	Miserables.txt 5
talon	NotreDame_De_Paris.txt 1, Miserables.txt 1
talons	Miserables.txt 3, NotreDame_De_Paris.txt 2
tambour	Miserables.txt 1
tambourine	NotreDame_De_Paris.txt 24
tambourines	NotreDame_De_Paris.txt 2
tame	Miserables.txt 1
tamed	NotreDame_De_Paris.txt 1
tamen	NotreDame_De_Paris.txt 2
tan	NotreDame_De_Paris.txt 3, Miserables.txt 2
tancarville	NotreDame_De_Paris.txt 1
tandem	Miserables.txt 1
tanflute	Miserables.txt 1
tangible	Miserables.txt 1
tangle	Miserables.txt 1
tangled	NotreDame_De_Paris.txt 2, Miserables.txt 2
tank	Miserables.txt 1
tanned	Miserables.txt 2
tannerie	NotreDame_De_Paris.txt 1
tanneries	Miserables.txt 1
tanners	NotreDame_De_Paris.txt 1
tantalus	Miserables.txt 2, NotreDame_De_Paris.txt 1
tantamount	Miserables.txt 1
tantrums	NotreDame_De_Paris.txt 1
tap	Miserables.txt 27, NotreDame_De_Paris.txt 1
tape	Miserables.txt 2
tapecu	Miserables.txt 1
taper	Miserables.txt 6
tapering	NotreDame_De_Paris.txt 1
tapers	Miserables.txt 1
tapestried	NotreDame_De_Paris.txt 1
tapestries	NotreDame_De_Paris.txt 5, Miserables.txt 2
tapestry	NotreDame_De_Paris.txt 11, Miserables.txt 3
tapissieres	Miserables.txt 1
tapped	Miserables.txt 10
tapping	NotreDame_De_Paris.txt 1, Miserables.txt 1
taps	Miserables.txt 3, NotreDame_De_Paris.txt 1
tarantula	Miserables.txt 1
tarascon	NotreDame_De_Paris.txt 1
tarasques	NotreDame_De_Paris.txt 1
tardy	Miserables.txt 4, NotreDame_De_Paris.txt 1
tares	Miserables.txt 2, NotreDame_De_Paris.txt 1
targe	NotreDame_De_Paris.txt 1
targes	NotreDame_De_Paris.txt 3
target	NotreDame_De_Paris.txt 2, Miserables.txt 2
tariff	Miserables.txt 5
tarme	NotreDame_De_Paris.txt 3
tarnish	NotreDame_De_Paris.txt 1
tarnished	NotreDame_De_Paris.txt 1
tarpaulin	Miserables.txt 1
tarpaulins	Miserables.txt 1
tarrying	Miserables.txt 1
tarsus	Miserables.txt 1
tartan	Miserables.txt 1
tartar	Miserables.txt 1
tartarus	NotreDame_De_Paris.txt 3
tartary	NotreDame_De_Paris.txt 1
tarts	Miserables.txt 1
tartuffe	Miserables.txt 3
task	Miserables.txt 25, NotreDame_De_Paris.txt 5
tasse	Miserables.txt 1
tassel	Miserables.txt 1
tassels	Miserables.txt 1
tassin	NotreDame_De_Paris.txt 1
taste	Miserables.txt 38, NotreDame_De_Paris.txt 18
tasted	Miserables.txt 4, NotreDame_De_Paris.txt 2
tastefully	NotreDame_De_Paris.txt 1
tastes	NotreDame_De_Paris.txt 2, Miserables.txt 1
tasting	NotreDame_De_Paris.txt 2, Miserables.txt 2
tatter	Miserables.txt 1
tatterdemalions	Miserables.txt 1
tattered	Miserables.txt 17, NotreDame_De_Paris.txt 1
tatters	NotreDame_De_Paris.txt 5, Miserables.txt 4
tattle	NotreDame_De_Paris.txt 1
tattooed	Miserables.txt 3, NotreDame_De_Paris.txt 1
taudis	Miserables.txt 1
taught	Miserables.txt 17, NotreDame_De_Paris.txt 5
taule	Miserables.txt 2
taurinum	NotreDame_De_Paris.txt 1
tavannes	Miserables.txt 1
tavern	Miserables.txt 26, NotreDame_De_Paris.txt 14
taverns	Miserables.txt 5, NotreDame_De_Paris.txt 2
tawers	NotreDame_De_Paris.txt 1
tawny	NotreDame_De_Paris.txt 2
taws	NotreDame_De_Paris.txt 1
tax	Miserables.txt 10, NotreDame_De_Paris.txt 8
taxes	Miserables.txt 8, NotreDame_De_Paris.txt 5
te	NotreDame_De_Paris.txt 18, Miserables.txt 10
tea	Miserables.txt 6
teach	Miserables.txt 11, NotreDame_De_Paris.txt 6
teacher	NotreDame_De_Paris.txt 1, Miserables.txt 1
teachers	Miserables.txt 2
teaching	Miserables.txt 2, NotreDame_De_Paris.txt 1
teachings	Miserables.txt 1
team	Miserables.txt 5, NotreDame_De_Paris.txt 1
teams	Miserables.txt 3
tear	Miserables.txt 35, NotreDame_De_Paris.txt 24
tearer	Miserables.txt 1
tearing	Miserables.txt 12, NotreDame_De_Paris.txt 2
tearless	NotreDame_De_Paris.txt 3, Miserables.txt 1
tears	Miserables.txt 41, NotreDame_De_Paris.txt 32
tease	Miserables.txt 2
teasing	Miserables.txt 5, NotreDame_De_Paris.txt 2
teau	NotreDame_De_Paris.txt 4
teaufort	NotreDame_De_Paris.txt 1
teaumorant	NotreDame_De_Paris.txt 1
teaupers	NotreDame_De_Paris.txt 21
tecelin	Miserables.txt 1
tedium	NotreDame_De_Paris.txt 1
teeth	Miserables.txt 94, NotreDame_De_Paris.txt 58
teglath	Miserables.txt 1
tel	NotreDame_De_Paris.txt 45
telegraph	Miserables.txt 2, NotreDame_De_Paris.txt 1
telegraphic	Miserables.txt 1
telemachus	Miserables.txt 1
telescope	Miserables.txt 3
telet	NotreDame_De_Paris.txt 30
tell	Miserables.txt 173, NotreDame_De_Paris.txt 70
teller	Miserables.txt 4
tellers	Miserables.txt 1
telling	Miserables.txt 20, NotreDame_De_Paris.txt 3
tells	Miserables.txt 10, NotreDame_De_Paris.txt 1
tels	NotreDame_De_Paris.txt 6
temerity	Miserables.txt 1
temper	NotreDame_De_Paris.txt 5, Miserables.txt 4
temperament	NotreDame_De_Paris.txt 1, Miserables.txt 1
temperaments	Miserables.txt 1
temperate	Miserables.txt 2
temperature	Miserables.txt 3, NotreDame_De_Paris.txt 2
tempered	Miserables.txt 7
tempers	Miserables.txt 1
tempest	Miserables.txt 16, NotreDame_De_Paris.txt 8
tempests	Miserables.txt 1
tempestuous	NotreDame_De_Paris.txt 1
templars	NotreDame_De_Paris.txt 1
temple	Miserables.txt 42, NotreDame_De_Paris.txt 22
temples	Miserables.txt 11, NotreDame_De_Paris.txt 3
temporal	NotreDame_De_Paris.txt 4, Miserables.txt 1
temporarily	NotreDame_De_Paris.txt 2, Miserables.txt 1
temporary	Miserables.txt 7
temporizing	NotreDame_De_Paris.txt 1
temps	Miserables.txt 3, NotreDame_De_Paris.txt 1
temptation	Miserables.txt 6, NotreDame_De_Paris.txt 3
temptations	Miserables.txt 3, NotreDame_De_Paris.txt 1
tempted	Miserables.txt 9
tempting	Miserables.txt 4
tempus	NotreDame_De_Paris.txt 1
ten	Miserables.txt 118, NotreDame_De_Paris.txt 19
tenable	NotreDame_De_Paris.txt 1, Miserables.txt 1
tenacious	Miserables.txt 4, NotreDame_De_Paris.txt 2
tenaciously	Miserables.txt 1
tenacity	Miserables.txt 4
tenait	Miserables.txt 2
tenant	Miserables.txt 7, NotreDame_De_Paris.txt 1
tenants	Miserables.txt 1
tend	Miserables.txt 2
tende	Miserables.txt 1
tended	NotreDame_De_Paris.txt 1, Miserables.txt 1
tendencies	Miserables.txt 1
tendency	Miserables.txt 6
tender	Miserables.txt 38, NotreDame_De_Paris.txt 15
tenderest	Miserables.txt 3, NotreDame_De_Paris.txt 1
tenderly	Miserables.txt 8, NotreDame_De_Paris.txt 6
tenderness	Miserables.txt 26, NotreDame_De_Paris.txt 12
tending	Miserables.txt 2
tendras	NotreDame_De_Paris.txt 1
tendre	Miserables.txt 1
tendrils	Miserables.txt 2
tends	Miserables.txt 2
tenebrae	NotreDame_De_Paris.txt 1
tenfold	Miserables.txt 2, NotreDame_De_Paris.txt 1
teniers	NotreDame_De_Paris.txt 1
tennine	Miserables.txt 1
tennis	Miserables.txt 3, NotreDame_De_Paris.txt 2
tenon	NotreDame_De_Paris.txt 1
tenor	NotreDame_De_Paris.txt 3, Miserables.txt 1
tenore	NotreDame_De_Paris.txt 1
tens	Miserables.txt 1
tension	Miserables.txt 5
tent	Miserables.txt 2
tenth	Miserables.txt 5, NotreDame_De_Paris.txt 3
tenthly	Miserables.txt 1
terentius	Miserables.txt 1
tergiversation	Miserables.txt 1
term	Miserables.txt 7, NotreDame_De_Paris.txt 1
termed	Miserables.txt 4
terminate	Miserables.txt 5, NotreDame_De_Paris.txt 1
terminated	Miserables.txt 15, NotreDame_De_Paris.txt 7
terminates	Miserables.txt 3
terminating	Miserables.txt 2
termination	Miserables.txt 7
termites	Miserables.txt 1
terms	Miserables.txt 47, NotreDame_De_Paris.txt 24
ternaux	Miserables.txt 1
terra	Miserables.txt 1
terrace	Miserables.txt 4
terraces	Miserables.txt 2
terrae	Miserables.txt 1
terrain	NotreDame_De_Paris.txt 9
terram	Miserables.txt 1
terraqueous	Miserables.txt 1
terray	Miserables.txt 1
terre	Miserables.txt 3
terrestrem	NotreDame_De_Paris.txt 1
terrestrial	Miserables.txt 9, NotreDame_De_Paris.txt 2
terreur	Miserables.txt 1
terrible	Miserables.txt 223, NotreDame_De_Paris.txt 42
terribly	Miserables.txt 1
terrific	NotreDame_De_Paris.txt 1, Miserables.txt 1
terrified	Miserables.txt 52, NotreDame_De_Paris.txt 15
terrifies	Miserables.txt 3
terrify	Miserables.txt 2
terrifying	Miserables.txt 11, NotreDame_De_Paris.txt 1
territory	Miserables.txt 4
terror	Miserables.txt 76, NotreDame_De_Paris.txt 40
terrorem	NotreDame_De_Paris.txt 1
terrorism	Miserables.txt 3
terrorist	Miserables.txt 1
terrors	Miserables.txt 6
tertio	NotreDame_De_Paris.txt 2
tertullian	Miserables.txt 1
tes	Miserables.txt 3
tessier	Miserables.txt 1
test	Miserables.txt 4
testament	Miserables.txt 6, NotreDame_De_Paris.txt 1
testaments	NotreDame_De_Paris.txt 1
tested	NotreDame_De_Paris.txt 2, Miserables.txt 1
tester	Miserables.txt 1
testers	NotreDame_De_Paris.txt 1
testify	Miserables.txt 2
testimony	Miserables.txt 5, NotreDame_De_Paris.txt 3
testudo	NotreDame_De_Paris.txt 1
tete	Miserables.txt 5
tetes	Miserables.txt 1
tetons	Miserables.txt 1
tetrahedral	NotreDame_De_Paris.txt 1
teucer	Miserables.txt 1
teuthranis	Miserables.txt 1
teuton	Miserables.txt 1
text	Miserables.txt 11, NotreDame_De_Paris.txt 7
texts	Miserables.txt 3
th	Miserables.txt 129, NotreDame_De_Paris.txt 7
thales	Miserables.txt 1
thames	Miserables.txt 1
than	Miserables.txt 866, NotreDame_De_Paris.txt 322
thank	Miserables.txt 15, NotreDame_De_Paris.txt 4
thanked	Miserables.txt 6, NotreDame_De_Paris.txt 2
thanking	Miserables.txt 1
thanks	Miserables.txt 65, NotreDame_De_Paris.txt 18
that	Miserables.txt 7924, NotreDame_De_Paris.txt 2464
thatched	Miserables.txt 9, NotreDame_De_Paris.txt 1
thaw	Miserables.txt 2
thawed	Miserables.txt 1
the	Miserables.txt 41093, NotreDame_De_Paris.txt 14760
theatre	Miserables.txt 28, NotreDame_De_Paris.txt 10
theatres	Miserables.txt 6, NotreDame_De_Paris.txt 1
theatrical	NotreDame_De_Paris.txt 5, Miserables.txt 3
thebaid	Miserables.txt 1
theban	Miserables.txt 1
thebes	Miserables.txt 4
thee	Miserables.txt 34, NotreDame_De_Paris.txt 26
theft	Miserables.txt 51, NotreDame_De_Paris.txt 2
thefts	Miserables.txt 1
their	Miserables.txt 1252, NotreDame_De_Paris.txt 423
theirs	Miserables.txt 7
them	Miserables.txt 1068, NotreDame_De_Paris.txt 326
theme	Miserables.txt 1
themis	NotreDame_De_Paris.txt 1, Miserables.txt 1
themselves	Miserables.txt 250, NotreDame_De_Paris.txt 67
then	Miserables.txt 1038, NotreDame_De_Paris.txt 463
thenard	Miserables.txt 5
thenardier	Miserables.txt 534
thenardiers	Miserables.txt 54
thence	Miserables.txt 16, NotreDame_De_Paris.txt 4
thenceforth	Miserables.txt 11, NotreDame_De_Paris.txt 2
theocracy	NotreDame_De_Paris.txt 5
theocratic	NotreDame_De_Paris.txt 5
theocritus	Miserables.txt 1
theodore	NotreDame_De_Paris.txt 2, Miserables.txt 1
theodule	Miserables.txt 49
theologians	NotreDame_De_Paris.txt 4
theological	Miserables.txt 2
theology	NotreDame_De_Paris.txt 4, Miserables.txt 2
theophilus	Miserables.txt 1
theorem	Miserables.txt 1
theoretical	Miserables.txt 1
theories	Miserables.txt 7, NotreDame_De_Paris.txt 1
theorists	Miserables.txt 2
theory	Miserables.txt 7
theramene	Miserables.txt 1
therapontigonus	Miserables.txt 1
there	Miserables.txt 2682, NotreDame_De_Paris.txt 631
thereabouts	Miserables.txt 2
thereafter	Miserables.txt 4, NotreDame_De_Paris.txt 1
thereby	Miserables.txt 6, NotreDame_De_Paris.txt 4
therefor	NotreDame_De_Paris.txt 1
therefore	Miserables.txt 30, NotreDame_De_Paris.txt 7
therefrom	Miserables.txt 1
therein	Miserables.txt 25, NotreDame_De_Paris.txt 3
thereon	NotreDame_De_Paris.txt 1
theresa	Miserables.txt 1
therese	Miserables.txt 5
thereto	NotreDame_De_Paris.txt 3, Miserables.txt 3
thereupon	Miserables.txt 10, NotreDame_De_Paris.txt 3
therewith	Miserables.txt 1
thermaturgist	NotreDame_De_Paris.txt 1
thermes	Miserables.txt 1
thermidor	Miserables.txt 3
thermometer	Miserables.txt 2
thermometers	Miserables.txt 1
thermopylae	Miserables.txt 4
thesaurarii	NotreDame_De_Paris.txt 1
thesauros	Miserables.txt 1
these	Miserables.txt 1008, NotreDame_De_Paris.txt 246
theses	Miserables.txt 1
theseus	Miserables.txt 1
thesis	Miserables.txt 1
thespis	Miserables.txt 1
thesprion	Miserables.txt 1
thessaly	Miserables.txt 1
they	Miserables.txt 2127, NotreDame_De_Paris.txt 516
thibaud	NotreDame_De_Paris.txt 1
thibaude	NotreDame_De_Paris.txt 2
thibauld	NotreDame_De_Paris.txt 3
thibaut	NotreDame_De_Paris.txt 9
thibautod	NotreDame_De_Paris.txt 2
thibet	Miserables.txt 1
thibord	Miserables.txt 1
thiboust	NotreDame_De_Paris.txt 1
thick	Miserables.txt 24, NotreDame_De_Paris.txt 17
thicker	Miserables.txt 2
thickest	NotreDame_De_Paris.txt 2
thicket	Miserables.txt 24, NotreDame_De_Paris.txt 7
thickets	Miserables.txt 5, NotreDame_De_Paris.txt 4
thickly	NotreDame_De_Paris.txt 3
thickness	Miserables.txt 6, NotreDame_De_Paris.txt 4
thicknesses	Miserables.txt 2
thickset	NotreDame_De_Paris.txt 4, Miserables.txt 2
thief	Miserables.txt 44, NotreDame_De_Paris.txt 13
thierry	Miserables.txt 2, NotreDame_De_Paris.txt 1
thierrye	NotreDame_De_Paris.txt 3
thiers	Miserables.txt 1
thieves	NotreDame_De_Paris.txt 31, Miserables.txt 17
thieving	NotreDame_De_Paris.txt 2, Miserables.txt 2
thigh	Miserables.txt 1
thighs	Miserables.txt 3, NotreDame_De_Paris.txt 2
thil	Miserables.txt 1
thimble	NotreDame_De_Paris.txt 1
thin	Miserables.txt 49, NotreDame_De_Paris.txt 13
thine	NotreDame_De_Paris.txt 6, Miserables.txt 3
thing	Miserables.txt 323, NotreDame_De_Paris.txt 77
things	Miserables.txt 303, NotreDame_De_Paris.txt 71
think	Miserables.txt 224, NotreDame_De_Paris.txt 49
thinker	Miserables.txt 15, NotreDame_De_Paris.txt 2
thinkers	Miserables.txt 10
thinkest	NotreDame_De_Paris.txt 1
thinking	Miserables.txt 74, NotreDame_De_Paris.txt 23
thinks	Miserables.txt 22, NotreDame_De_Paris.txt 7
thinned	Miserables.txt 3
thinner	NotreDame_De_Paris.txt 3, Miserables.txt 2
thinness	NotreDame_De_Paris.txt 1, Miserables.txt 1
third	Miserables.txt 96, NotreDame_De_Paris.txt 26
thirdly	Miserables.txt 2
thirds	Miserables.txt 4
thirst	Miserables.txt 10, NotreDame_De_Paris.txt 3
thirsting	Miserables.txt 1
thirsts	Miserables.txt 2
thirsty	Miserables.txt 11
thirteen	Miserables.txt 12, NotreDame_De_Paris.txt 3
thirteenth	Miserables.txt 6, NotreDame_De_Paris.txt 5
thirty	Miserables.txt 101, NotreDame_De_Paris.txt 17
this	Miserables.txt 4008, NotreDame_De_Paris.txt 1010
thisbe	Miserables.txt 1
thistle	NotreDame_De_Paris.txt 1
thistles	Miserables.txt 1
thither	Miserables.txt 56, NotreDame_De_Paris.txt 9
tholomyes	Miserables.txt 66
thomas	Miserables.txt 3, NotreDame_De_Paris.txt 2
thomasse	NotreDame_De_Paris.txt 1
thongs	NotreDame_De_Paris.txt 8, Miserables.txt 1
thonne	NotreDame_De_Paris.txt 1
thorigny	Miserables.txt 2
thorn	Miserables.txt 4
thorns	Miserables.txt 3, NotreDame_De_Paris.txt 1
thorny	Miserables.txt 2
thorough	Miserables.txt 5, NotreDame_De_Paris.txt 1
thoroughbred	Miserables.txt 1
thoroughfare	Miserables.txt 1
thoroughfares	NotreDame_De_Paris.txt 3
thoroughly	Miserables.txt 40, NotreDame_De_Paris.txt 11
thorrettes	NotreDame_De_Paris.txt 1
those	Miserables.txt 735, NotreDame_De_Paris.txt 181
thou	Miserables.txt 125, NotreDame_De_Paris.txt 48
thouars	Miserables.txt 1
though	Miserables.txt 355, NotreDame_De_Paris.txt 91
thought	Miserables.txt 496, NotreDame_De_Paris.txt 147
thoughtful	Miserables.txt 42, NotreDame_De_Paris.txt 8
thoughtfully	Miserables.txt 13, NotreDame_De_Paris.txt 1
thoughtfulness	Miserables.txt 2
thoughtless	Miserables.txt 2
thoughts	Miserables.txt 85, NotreDame_De_Paris.txt 20
thousand	Miserables.txt 187, NotreDame_De_Paris.txt 95
thousands	NotreDame_De_Paris.txt 12, Miserables.txt 4
thracius	Miserables.txt 1
thrash	NotreDame_De_Paris.txt 1
thrashed	NotreDame_De_Paris.txt 1
thrashings	Miserables.txt 1
thrasybulus	Miserables.txt 1
thread	Miserables.txt 38, NotreDame_De_Paris.txt 12
threadbare	Miserables.txt 16, NotreDame_De_Paris.txt 3
threads	Miserables.txt 14, NotreDame_De_Paris.txt 2
threat	Miserables.txt 1
threaten	Miserables.txt 2
threatened	Miserables.txt 7
threatening	Miserables.txt 15, NotreDame_De_Paris.txt 3
threatens	Miserables.txt 5
threats	NotreDame_De_Paris.txt 2, Miserables.txt 1
three	Miserables.txt 477, NotreDame_De_Paris.txt 147
threshold	Miserables.txt 28, NotreDame_De_Paris.txt 15
thresholds	Miserables.txt 5, NotreDame_De_Paris.txt 1
threw	Miserables.txt 43, NotreDame_De_Paris.txt 24
thrice	Miserables.txt 3, NotreDame_De_Paris.txt 1
thrill	Miserables.txt 2
thrilled	Miserables.txt 1
thrilling	NotreDame_De_Paris.txt 1
thrive	NotreDame_De_Paris.txt 1
thrives	Miserables.txt 1
throat	Miserables.txt 36, NotreDame_De_Paris.txt 15
throats	Miserables.txt 7, NotreDame_De_Paris.txt 3
throbbed	Miserables.txt 1
throbbing	Miserables.txt 2
throes	Miserables.txt 2
throne	Miserables.txt 21, NotreDame_De_Paris.txt 6
thrones	Miserables.txt 7
throng	NotreDame_De_Paris.txt 35, Miserables.txt 35
thronged	NotreDame_De_Paris.txt 5
thronging	Miserables.txt 1
throngs	Miserables.txt 8
through	Miserables.txt 531, NotreDame_De_Paris.txt 176
throughout	Miserables.txt 15, NotreDame_De_Paris.txt 3
throve	Miserables.txt 1
throw	Miserables.txt 31, NotreDame_De_Paris.txt 2
throwing	Miserables.txt 14, NotreDame_De_Paris.txt 5
thrown	Miserables.txt 50, NotreDame_De_Paris.txt 9
throws	Miserables.txt 2, NotreDame_De_Paris.txt 1
thrummed	NotreDame_De_Paris.txt 1
thrushes	Miserables.txt 1
thrust	Miserables.txt 75, NotreDame_De_Paris.txt 22
thrusting	Miserables.txt 13, NotreDame_De_Paris.txt 5
thrusts	Miserables.txt 6, NotreDame_De_Paris.txt 1
thuin	Miserables.txt 1
thumb	Miserables.txt 18, NotreDame_De_Paris.txt 3
thumbs	Miserables.txt 2
thumped	Miserables.txt 1
thunder	Miserables.txt 39, NotreDame_De_Paris.txt 15
thunderbolt	Miserables.txt 5, NotreDame_De_Paris.txt 1
thunderbolts	Miserables.txt 3, NotreDame_De_Paris.txt 1
thunderclap	Miserables.txt 1
thundered	Miserables.txt 3
thundering	Miserables.txt 8
thunderous	NotreDame_De_Paris.txt 1
thunders	Miserables.txt 6
thunderstruck	Miserables.txt 2, NotreDame_De_Paris.txt 1
thunes	NotreDame_De_Paris.txt 22, Miserables.txt 3
thuneurs	Miserables.txt 1
thus	Miserables.txt 227, NotreDame_De_Paris.txt 131
thuya	Miserables.txt 1
thwacks	NotreDame_De_Paris.txt 1
thwarted	Miserables.txt 1
thy	Miserables.txt 40, NotreDame_De_Paris.txt 18
thygelion	Miserables.txt 1
thym	Miserables.txt 1
thyme	Miserables.txt 3
thyself	NotreDame_De_Paris.txt 3, Miserables.txt 1
tiara	NotreDame_De_Paris.txt 3, Miserables.txt 2
tiber	Miserables.txt 4
tiberii	Miserables.txt 1
tiberim	Miserables.txt 2
tiberius	Miserables.txt 3
tibi	NotreDame_De_Paris.txt 1
tibullus	Miserables.txt 1
ticketed	Miserables.txt 1
tickets	Miserables.txt 2
ticking	Miserables.txt 2
tickled	NotreDame_De_Paris.txt 3, Miserables.txt 1
ticklish	Miserables.txt 1
tide	Miserables.txt 5, NotreDame_De_Paris.txt 4
tidy	Miserables.txt 2
tie	Miserables.txt 3
tied	Miserables.txt 9, NotreDame_De_Paris.txt 5
tierce	Miserables.txt 1
tiercelin	Miserables.txt 1
tierra	NotreDame_De_Paris.txt 1
tiers	Miserables.txt 1
tiger	Miserables.txt 25, NotreDame_De_Paris.txt 6
tigers	Miserables.txt 3, NotreDame_De_Paris.txt 2
tight	Miserables.txt 3
tighter	NotreDame_De_Paris.txt 1
tightly	Miserables.txt 3
tights	Miserables.txt 2
tigre	Miserables.txt 1
tigress	NotreDame_De_Paris.txt 3, Miserables.txt 2
tilbury	Miserables.txt 19
tile	NotreDame_De_Paris.txt 2
tiled	Miserables.txt 2, NotreDame_De_Paris.txt 1
tiler	Miserables.txt 1
tiles	NotreDame_De_Paris.txt 2, Miserables.txt 1
till	Miserables.txt 6, NotreDame_De_Paris.txt 5
tillac	Miserables.txt 2
tilled	Miserables.txt 1
tilloy	NotreDame_De_Paris.txt 1
tilly	Miserables.txt 1
tilsit	Miserables.txt 1
tilted	Miserables.txt 1
timaloumisaine	Miserables.txt 1
timaloumison	Miserables.txt 1
timantis	NotreDame_De_Paris.txt 1
timber	Miserables.txt 16, NotreDame_De_Paris.txt 6
timbers	NotreDame_De_Paris.txt 1
time	Miserables.txt 762, NotreDame_De_Paris.txt 276
timebo	NotreDame_De_Paris.txt 1
times	Miserables.txt 135, NotreDame_De_Paris.txt 29
timid	Miserables.txt 20, NotreDame_De_Paris.txt 7
timidity	Miserables.txt 9, NotreDame_De_Paris.txt 2
timidly	Miserables.txt 9, NotreDame_De_Paris.txt 3
timing	NotreDame_De_Paris.txt 1
timoleon	Miserables.txt 1
tin	Miserables.txt 11, NotreDame_De_Paris.txt 3
tincture	Miserables.txt 1
tine	Miserables.txt 1
tinge	NotreDame_De_Paris.txt 1, Miserables.txt 1
tinged	NotreDame_De_Paris.txt 1, Miserables.txt 1
tingueux	NotreDame_De_Paris.txt 1
tiniest	Miserables.txt 3
tinkling	Miserables.txt 1
tinques	Miserables.txt 5
tinsel	NotreDame_De_Paris.txt 7, Miserables.txt 2
tint	NotreDame_De_Paris.txt 1, Miserables.txt 1
tinted	Miserables.txt 1
tiny	Miserables.txt 42, NotreDame_De_Paris.txt 29
tip	Miserables.txt 20, NotreDame_De_Paris.txt 9
tipped	Miserables.txt 3
tips	Miserables.txt 8, NotreDame_De_Paris.txt 2
tipsy	Miserables.txt 2, NotreDame_De_Paris.txt 1
tiptoe	Miserables.txt 11, NotreDame_De_Paris.txt 6
tirades	NotreDame_De_Paris.txt 1
tiraient	Miserables.txt 1
tirais	Miserables.txt 1
tirait	Miserables.txt 1
tire	Miserables.txt 1
tirechappe	NotreDame_De_Paris.txt 6
tirecuir	Miserables.txt 1
tired	Miserables.txt 7, NotreDame_De_Paris.txt 1
tirer	Miserables.txt 1
tires	Miserables.txt 2
tiresome	NotreDame_De_Paris.txt 3, Miserables.txt 1
tiridate	Miserables.txt 1
tis	NotreDame_De_Paris.txt 230, Miserables.txt 14
titan	NotreDame_De_Paris.txt 1, Miserables.txt 1
titanic	Miserables.txt 8
titans	Miserables.txt 5
tithes	Miserables.txt 1
titi	Miserables.txt 4
titian	Miserables.txt 1
title	Miserables.txt 20, NotreDame_De_Paris.txt 7
titlepage	Miserables.txt 9
titles	NotreDame_De_Paris.txt 5, Miserables.txt 2
titus	Miserables.txt 1
tityrus	Miserables.txt 1
tivoli	Miserables.txt 2
tixeranderie	NotreDame_De_Paris.txt 2
tm	NotreDame_De_Paris.txt 57, Miserables.txt 57
to	Miserables.txt 13950, NotreDame_De_Paris.txt 4237
toad	Miserables.txt 5, NotreDame_De_Paris.txt 1
toads	Miserables.txt 2
toast	Miserables.txt 1
tobacco	Miserables.txt 13
tocsin	Miserables.txt 7, NotreDame_De_Paris.txt 1
tocsins	Miserables.txt 2
toda	Miserables.txt 1
today	Miserables.txt 3
toddle	Miserables.txt 1
toe	NotreDame_De_Paris.txt 2, Miserables.txt 1
toed	NotreDame_De_Paris.txt 1
toes	Miserables.txt 3
toga	Miserables.txt 1
together	Miserables.txt 106, NotreDame_De_Paris.txt 42
toi	Miserables.txt 2
toil	Miserables.txt 34
toiled	Miserables.txt 5
toilers	Miserables.txt 2
toilet	Miserables.txt 17, NotreDame_De_Paris.txt 5
toilette	Miserables.txt 4
toilettes	Miserables.txt 2
toils	Miserables.txt 6, NotreDame_De_Paris.txt 1
toilsome	Miserables.txt 1
toises	NotreDame_De_Paris.txt 3
token	NotreDame_De_Paris.txt 2
tolbiac	Miserables.txt 1
told	Miserables.txt 134, NotreDame_De_Paris.txt 24
tolerable	Miserables.txt 9, NotreDame_De_Paris.txt 1
tolerably	Miserables.txt 47, NotreDame_De_Paris.txt 13
tolerance	Miserables.txt 1
tolerant	Miserables.txt 1
tolerate	Miserables.txt 1
tolerated	Miserables.txt 7
toll	Miserables.txt 4, NotreDame_De_Paris.txt 3
tolleron	Miserables.txt 2
tollgates	NotreDame_De_Paris.txt 1
tolls	NotreDame_De_Paris.txt 1, Miserables.txt 1
tolosa	Miserables.txt 1
tom	NotreDame_De_Paris.txt 1
tomb	Miserables.txt 61, NotreDame_De_Paris.txt 15
tombe	Miserables.txt 3
tombs	Miserables.txt 7, NotreDame_De_Paris.txt 2
tomcat	Miserables.txt 1
tomorrow	Miserables.txt 2
tomtits	Miserables.txt 1
ton	Miserables.txt 13, NotreDame_De_Paris.txt 1
tone	Miserables.txt 85, NotreDame_De_Paris.txt 51
toned	NotreDame_De_Paris.txt 2, Miserables.txt 1
tones	Miserables.txt 13, NotreDame_De_Paris.txt 8
tongres	Miserables.txt 1
tongs	NotreDame_De_Paris.txt 2, Miserables.txt 2
tongue	Miserables.txt 45, NotreDame_De_Paris.txt 30
tongues	NotreDame_De_Paris.txt 8, Miserables.txt 8
tonnerre	NotreDame_De_Paris.txt 4, Miserables.txt 2
tonnier	NotreDame_De_Paris.txt 1
tons	NotreDame_De_Paris.txt 1
tonsure	NotreDame_De_Paris.txt 2, Miserables.txt 1
tonum	NotreDame_De_Paris.txt 1
too	Miserables.txt 283, NotreDame_De_Paris.txt 89
took	Miserables.txt 402, NotreDame_De_Paris.txt 90
tool	Miserables.txt 9
tools	Miserables.txt 8, NotreDame_De_Paris.txt 4
tooth	Miserables.txt 4, NotreDame_De_Paris.txt 3
toothed	NotreDame_De_Paris.txt 2
toothless	Miserables.txt 3, NotreDame_De_Paris.txt 2
top	Miserables.txt 82, NotreDame_De_Paris.txt 25
topcoat	Miserables.txt 1
topman	Miserables.txt 4
topmast	NotreDame_De_Paris.txt 1
topmost	NotreDame_De_Paris.txt 2
topple	Miserables.txt 1
tops	Miserables.txt 4, NotreDame_De_Paris.txt 1
topsy	Miserables.txt 2
topsyturveydom	Miserables.txt 1
torch	Miserables.txt 24, NotreDame_De_Paris.txt 10
torches	NotreDame_De_Paris.txt 23, Miserables.txt 4
torchi	NotreDame_De_Paris.txt 4
torcy	NotreDame_De_Paris.txt 1
tore	Miserables.txt 26, NotreDame_De_Paris.txt 14
torment	Miserables.txt 4, NotreDame_De_Paris.txt 3
tormented	Miserables.txt 3, NotreDame_De_Paris.txt 2
tormenting	NotreDame_De_Paris.txt 2, Miserables.txt 1
tormentor	NotreDame_De_Paris.txt 5
tormentors	NotreDame_De_Paris.txt 1
torments	Miserables.txt 3
torn	Miserables.txt 44, NotreDame_De_Paris.txt 14
torpid	NotreDame_De_Paris.txt 1, Miserables.txt 1
torpor	Miserables.txt 1
torrent	Miserables.txt 4, NotreDame_De_Paris.txt 2
torrents	Miserables.txt 2, NotreDame_De_Paris.txt 1
torsades	Miserables.txt 2
torso	Miserables.txt 2
torsos	Miserables.txt 1
tort	NotreDame_De_Paris.txt 1
torterue	NotreDame_De_Paris.txt 9
tortiller	Miserables.txt 1
tortoise	NotreDame_De_Paris.txt 2
tortouse	Miserables.txt 1
tortuous	NotreDame_De_Paris.txt 6, Miserables.txt 4
tortuously	NotreDame_De_Paris.txt 1
torture	NotreDame_De_Paris.txt 25, Miserables.txt 19
tortured	NotreDame_De_Paris.txt 4, Miserables.txt 1
torturer	NotreDame_De_Paris.txt 7
torturers	NotreDame_De_Paris.txt 2
tortures	Miserables.txt 4, NotreDame_De_Paris.txt 1
torturing	Miserables.txt 1
toryne	Miserables.txt 1
toss	Miserables.txt 5, NotreDame_De_Paris.txt 1
tossed	Miserables.txt 13, NotreDame_De_Paris.txt 10
tosses	Miserables.txt 1
tossing	NotreDame_De_Paris.txt 2, Miserables.txt 1
tossings	Miserables.txt 1
tota	NotreDame_De_Paris.txt 1
total	Miserables.txt 22, NotreDame_De_Paris.txt 4
totalized	NotreDame_De_Paris.txt 1
totally	Miserables.txt 7, NotreDame_De_Paris.txt 1
totals	Miserables.txt 1
tottered	Miserables.txt 1
tottering	Miserables.txt 8, NotreDame_De_Paris.txt 1
tottlingen	Miserables.txt 1
tou	Miserables.txt 6
touch	Miserables.txt 39, NotreDame_De_Paris.txt 18
touched	Miserables.txt 75, NotreDame_De_Paris.txt 19
touches	Miserables.txt 7, NotreDame_De_Paris.txt 1
touching	Miserables.txt 29, NotreDame_De_Paris.txt 8
tough	Miserables.txt 2
toujours	Miserables.txt 3
toul	Miserables.txt 1
toulon	Miserables.txt 29
toulousan	Miserables.txt 1
toulouse	Miserables.txt 5
touquet	Miserables.txt 3
tour	NotreDame_De_Paris.txt 27, Miserables.txt 8
tourangeau	NotreDame_De_Paris.txt 20
touraugeau	NotreDame_De_Paris.txt 1
tournay	NotreDame_De_Paris.txt 4
tourne	NotreDame_De_Paris.txt 1
tournefort	Miserables.txt 1
tournelle	NotreDame_De_Paris.txt 11
tournelles	NotreDame_De_Paris.txt 11
tournois	NotreDame_De_Paris.txt 2, Miserables.txt 1
tournon	Miserables.txt 1
tournus	NotreDame_De_Paris.txt 1
tours	NotreDame_De_Paris.txt 6, Miserables.txt 2
tourteau	Miserables.txt 1
tourville	NotreDame_De_Paris.txt 1
tous	Miserables.txt 2, NotreDame_De_Paris.txt 1
toussaint	Miserables.txt 56, NotreDame_De_Paris.txt 1
tout	Miserables.txt 6, NotreDame_De_Paris.txt 1
toute	Miserables.txt 1
tow	Miserables.txt 4, NotreDame_De_Paris.txt 1
toward	Miserables.txt 16, NotreDame_De_Paris.txt 9
towards	Miserables.txt 318, NotreDame_De_Paris.txt 125
towed	NotreDame_De_Paris.txt 1, Miserables.txt 1
towels	NotreDame_De_Paris.txt 1
tower	NotreDame_De_Paris.txt 96, Miserables.txt 13
towered	Miserables.txt 3
towers	NotreDame_De_Paris.txt 89, Miserables.txt 8
towing	Miserables.txt 1
town	Miserables.txt 114, NotreDame_De_Paris.txt 46
townhall	Miserables.txt 2
towns	Miserables.txt 10, NotreDame_De_Paris.txt 3
townsman	Miserables.txt 1
townspeople	Miserables.txt 1
toy	Miserables.txt 3, NotreDame_De_Paris.txt 1
toyed	NotreDame_De_Paris.txt 1, Miserables.txt 1
toys	NotreDame_De_Paris.txt 1
tr	NotreDame_De_Paris.txt 1
trabuceros	Miserables.txt 1
trace	Miserables.txt 26, NotreDame_De_Paris.txt 1
traced	Miserables.txt 7, NotreDame_De_Paris.txt 5
traces	Miserables.txt 16, NotreDame_De_Paris.txt 4
tracing	Miserables.txt 1
track	Miserables.txt 15, NotreDame_De_Paris.txt 1
tracked	Miserables.txt 4
tracks	Miserables.txt 1
tractable	Miserables.txt 1
traction	Miserables.txt 1
tracts	Miserables.txt 1
trade	Miserables.txt 20, NotreDame_De_Paris.txt 11
trademark	NotreDame_De_Paris.txt 11, Miserables.txt 11
trader	Miserables.txt 1
trades	NotreDame_De_Paris.txt 3, Miserables.txt 3
tradesman	Miserables.txt 3
tradesmen	Miserables.txt 1
tradition	Miserables.txt 13, NotreDame_De_Paris.txt 8
traditional	NotreDame_De_Paris.txt 1
traditions	Miserables.txt 3, NotreDame_De_Paris.txt 2
tradunt	Miserables.txt 1
tragedies	NotreDame_De_Paris.txt 3, Miserables.txt 2
tragedy	Miserables.txt 8, NotreDame_De_Paris.txt 4
tragic	Miserables.txt 40, NotreDame_De_Paris.txt 5
trahoir	NotreDame_De_Paris.txt 2
trail	Miserables.txt 5
trailed	NotreDame_De_Paris.txt 3
trailing	Miserables.txt 1
trails	Miserables.txt 2, NotreDame_De_Paris.txt 1
train	Miserables.txt 12, NotreDame_De_Paris.txt 4
trained	NotreDame_De_Paris.txt 4, Miserables.txt 4
training	Miserables.txt 1
trains	Miserables.txt 2
trait	Miserables.txt 3, NotreDame_De_Paris.txt 2
traitor	Miserables.txt 5
traitorously	Miserables.txt 1
traitors	Miserables.txt 5
traits	Miserables.txt 1
trajectory	Miserables.txt 2
trammelled	Miserables.txt 2
tramp	Miserables.txt 3
tramping	Miserables.txt 1
trample	Miserables.txt 2, NotreDame_De_Paris.txt 1
trampled	Miserables.txt 4, NotreDame_De_Paris.txt 2
trampling	Miserables.txt 5, NotreDame_De_Paris.txt 3
tranchelevent	Miserables.txt 4
tranquil	Miserables.txt 42, NotreDame_De_Paris.txt 20
tranquillities	Miserables.txt 1
tranquillity	Miserables.txt 20, NotreDame_De_Paris.txt 5
tranquillizer	NotreDame_De_Paris.txt 1
tranquilly	Miserables.txt 15, NotreDame_De_Paris.txt 6
transcribe	Miserables.txt 4, NotreDame_De_Paris.txt 1
transcribed	NotreDame_De_Paris.txt 1
transcribing	Miserables.txt 1
transcription	NotreDame_De_Paris.txt 1, Miserables.txt 1
transfer	NotreDame_De_Paris.txt 1, Miserables.txt 1
transferred	Miserables.txt 9, NotreDame_De_Paris.txt 1
transfiguration	Miserables.txt 8
transfigurations	Miserables.txt 1
transfigure	Miserables.txt 2
transfigured	Miserables.txt 15
transfigures	Miserables.txt 1
transfiguring	Miserables.txt 1
transfixed	Miserables.txt 1
transform	Miserables.txt 7, NotreDame_De_Paris.txt 1
transformation	Miserables.txt 9, NotreDame_De_Paris.txt 4
transformations	NotreDame_De_Paris.txt 2, Miserables.txt 1
transformed	Miserables.txt 8, NotreDame_De_Paris.txt 6
transforms	Miserables.txt 1
transfused	NotreDame_De_Paris.txt 1
transgressed	NotreDame_De_Paris.txt 1, Miserables.txt 1
transgressing	Miserables.txt 1
transierunt	NotreDame_De_Paris.txt 1
transit	Miserables.txt 3, NotreDame_De_Paris.txt 2
transita	NotreDame_De_Paris.txt 1
transition	Miserables.txt 12, NotreDame_De_Paris.txt 4
transitions	Miserables.txt 1
transitory	Miserables.txt 1
translate	NotreDame_De_Paris.txt 3, Miserables.txt 1
translated	Miserables.txt 6, NotreDame_De_Paris.txt 2
translates	NotreDame_De_Paris.txt 1
translating	Miserables.txt 1
translation	Miserables.txt 6
translations	Miserables.txt 3
translator	NotreDame_De_Paris.txt 1, Miserables.txt 1
translators	Miserables.txt 1
transmitted	Miserables.txt 6, NotreDame_De_Paris.txt 3
transmutation	Miserables.txt 1
transnonain	Miserables.txt 3
transparencies	Miserables.txt 1
transparency	Miserables.txt 7, NotreDame_De_Paris.txt 2
transparent	Miserables.txt 7, NotreDame_De_Paris.txt 4
transport	Miserables.txt 9, NotreDame_De_Paris.txt 2
transported	NotreDame_De_Paris.txt 1, Miserables.txt 1
transports	Miserables.txt 5, NotreDame_De_Paris.txt 1
transteverin	Miserables.txt 1
transverse	Miserables.txt 6, NotreDame_De_Paris.txt 1
trap	Miserables.txt 43, NotreDame_De_Paris.txt 6
trapdoor	NotreDame_De_Paris.txt 2
trapeze	Miserables.txt 1
trapezium	Miserables.txt 5, NotreDame_De_Paris.txt 4
trapezoid	NotreDame_De_Paris.txt 1
trappe	Miserables.txt 1
trappings	NotreDame_De_Paris.txt 1
trappist	Miserables.txt 1
traps	Miserables.txt 9
travel	Miserables.txt 12
travelled	Miserables.txt 11, NotreDame_De_Paris.txt 1
traveller	Miserables.txt 51, NotreDame_De_Paris.txt 1
travellers	Miserables.txt 16
travelling	Miserables.txt 10
travells	Miserables.txt 2
travels	Miserables.txt 6
travers	Miserables.txt 2
traverse	Miserables.txt 23, NotreDame_De_Paris.txt 2
traversed	Miserables.txt 69, NotreDame_De_Paris.txt 11
traverses	Miserables.txt 1
traversiere	Miserables.txt 2
traversing	Miserables.txt 16, NotreDame_De_Paris.txt 5
tre	NotreDame_De_Paris.txt 6
treacheries	Miserables.txt 2
treacherous	Miserables.txt 11, NotreDame_De_Paris.txt 2
treacherously	Miserables.txt 1
treachery	Miserables.txt 3
tread	Miserables.txt 13, NotreDame_De_Paris.txt 2
treading	Miserables.txt 1
treads	Miserables.txt 1
treason	NotreDame_De_Paris.txt 3, Miserables.txt 2
treasons	Miserables.txt 1
treasure	Miserables.txt 18, NotreDame_De_Paris.txt 2
treasurer	NotreDame_De_Paris.txt 2, Miserables.txt 2
treasures	Miserables.txt 5, NotreDame_De_Paris.txt 2
treasury	NotreDame_De_Paris.txt 4, Miserables.txt 2
treat	Miserables.txt 16, NotreDame_De_Paris.txt 4
treated	Miserables.txt 22, NotreDame_De_Paris.txt 1
treaties	Miserables.txt 2
treating	Miserables.txt 5
treatise	Miserables.txt 1
treatment	Miserables.txt 4, NotreDame_De_Paris.txt 2
treats	Miserables.txt 3
treaty	Miserables.txt 1
trebizond	NotreDame_De_Paris.txt 1
trebizonde	NotreDame_De_Paris.txt 1
treble	NotreDame_De_Paris.txt 1
trebled	Miserables.txt 1
trebles	Miserables.txt 1
trebling	Miserables.txt 1
tree	Miserables.txt 78, NotreDame_De_Paris.txt 11
trees	Miserables.txt 135, NotreDame_De_Paris.txt 7
trefoil	NotreDame_De_Paris.txt 2, Miserables.txt 1
trefoils	NotreDame_De_Paris.txt 4, Miserables.txt 1
trellis	Miserables.txt 3, NotreDame_De_Paris.txt 2
trellised	NotreDame_De_Paris.txt 1
trellises	NotreDame_De_Paris.txt 1
tremble	Miserables.txt 20, NotreDame_De_Paris.txt 9
trembled	Miserables.txt 41, NotreDame_De_Paris.txt 26
trembles	Miserables.txt 3, NotreDame_De_Paris.txt 1
trembling	Miserables.txt 52, NotreDame_De_Paris.txt 16
tremblingly	NotreDame_De_Paris.txt 1, Miserables.txt 1
tremendous	Miserables.txt 17, NotreDame_De_Paris.txt 1
tremendously	Miserables.txt 1
tremolo	Miserables.txt 1
tremor	Miserables.txt 12
tremors	Miserables.txt 3, NotreDame_De_Paris.txt 1
tremulous	Miserables.txt 1
trench	Miserables.txt 13
trenches	Miserables.txt 3
trenton	Miserables.txt 1
trepidation	Miserables.txt 2
trerie	NotreDame_De_Paris.txt 1
tres	Miserables.txt 2, NotreDame_De_Paris.txt 1
tresor	Miserables.txt 1
trespassing	NotreDame_De_Paris.txt 1
tresses	NotreDame_De_Paris.txt 3, Miserables.txt 1
trestaillon	Miserables.txt 2
trestle	NotreDame_De_Paris.txt 2
trestles	NotreDame_De_Paris.txt 1, Miserables.txt 1
tri	NotreDame_De_Paris.txt 1
tria	Miserables.txt 1
trial	Miserables.txt 22, NotreDame_De_Paris.txt 11
trials	Miserables.txt 6, NotreDame_De_Paris.txt 1
triancourt	NotreDame_De_Paris.txt 1
triangle	NotreDame_De_Paris.txt 7, Miserables.txt 2
triangles	NotreDame_De_Paris.txt 2
triangular	Miserables.txt 5
tribe	NotreDame_De_Paris.txt 6, Miserables.txt 2
tribes	Miserables.txt 1
tribunal	Miserables.txt 6, NotreDame_De_Paris.txt 2
tribunals	Miserables.txt 5, NotreDame_De_Paris.txt 1
tribunaux	NotreDame_De_Paris.txt 1, Miserables.txt 1
tribune	Miserables.txt 4
tribunes	Miserables.txt 1
tributaries	Miserables.txt 1
tribute	Miserables.txt 3, NotreDame_De_Paris.txt 1
trick	Miserables.txt 5, NotreDame_De_Paris.txt 2
tricked	NotreDame_De_Paris.txt 1, Miserables.txt 1
trickery	Miserables.txt 2
trickle	Miserables.txt 2
trickled	Miserables.txt 12, NotreDame_De_Paris.txt 2
trickles	Miserables.txt 2, NotreDame_De_Paris.txt 1
trickling	NotreDame_De_Paris.txt 1, Miserables.txt 1
tricks	NotreDame_De_Paris.txt 5, Miserables.txt 3
tricolored	Miserables.txt 9
tricot	NotreDame_De_Paris.txt 1, Miserables.txt 1
trident	Miserables.txt 1
tried	Miserables.txt 63, NotreDame_De_Paris.txt 35
triel	NotreDame_De_Paris.txt 1, Miserables.txt 1
tries	Miserables.txt 10, NotreDame_De_Paris.txt 1
trifle	Miserables.txt 12, NotreDame_De_Paris.txt 3
trifles	Miserables.txt 3, NotreDame_De_Paris.txt 1
trifling	Miserables.txt 2
trigger	Miserables.txt 6
triggerless	Miserables.txt 3
trills	NotreDame_De_Paris.txt 2
trim	Miserables.txt 1
trimaient	Miserables.txt 1
trimalcion	Miserables.txt 1
trime	Miserables.txt 1
trimmed	Miserables.txt 2
trimming	NotreDame_De_Paris.txt 1, Miserables.txt 1
tringlet	NotreDame_De_Paris.txt 1
trinit	NotreDame_De_Paris.txt 1
trinity	Miserables.txt 2, NotreDame_De_Paris.txt 1
trinket	NotreDame_De_Paris.txt 1
trinkets	Miserables.txt 7
trinquelague	Miserables.txt 1
trios	Miserables.txt 1
trip	Miserables.txt 26, NotreDame_De_Paris.txt 1
tripe	NotreDame_De_Paris.txt 2
triple	Miserables.txt 8, NotreDame_De_Paris.txt 5
triplicity	Miserables.txt 1
tripod	NotreDame_De_Paris.txt 4
tripods	Miserables.txt 3
tripping	Miserables.txt 2
trips	Miserables.txt 9
tristan	NotreDame_De_Paris.txt 56, Miserables.txt 1
triste	Miserables.txt 1
trithemus	Miserables.txt 1
triton	Miserables.txt 2, NotreDame_De_Paris.txt 1
triumph	Miserables.txt 27, NotreDame_De_Paris.txt 9
triumphal	Miserables.txt 3
triumphant	Miserables.txt 13, NotreDame_De_Paris.txt 7
triumphantly	Miserables.txt 3, NotreDame_De_Paris.txt 1
triumphed	Miserables.txt 3, NotreDame_De_Paris.txt 1
triumphing	Miserables.txt 1
triumphs	Miserables.txt 5, NotreDame_De_Paris.txt 3
trivial	Miserables.txt 3, NotreDame_De_Paris.txt 1
triviality	Miserables.txt 1
trivio	NotreDame_De_Paris.txt 1
trocadero	Miserables.txt 1
trochylus	NotreDame_De_Paris.txt 1
trod	Miserables.txt 1
trodden	Miserables.txt 3
trogoff	Miserables.txt 1
trois	Miserables.txt 1
troisieme	Miserables.txt 1
tronche	Miserables.txt 1
trone	Miserables.txt 4
troop	Miserables.txt 9, NotreDame_De_Paris.txt 7
trooped	Miserables.txt 2
trooper	NotreDame_De_Paris.txt 1
troops	Miserables.txt 22, NotreDame_De_Paris.txt 9
trophonius	Miserables.txt 1
trophy	Miserables.txt 3
trot	Miserables.txt 9, NotreDame_De_Paris.txt 1
trots	NotreDame_De_Paris.txt 1
trottait	Miserables.txt 1
trotted	Miserables.txt 2, NotreDame_De_Paris.txt 1
trotting	NotreDame_De_Paris.txt 1, Miserables.txt 1
trouble	Miserables.txt 50, NotreDame_De_Paris.txt 18
troubled	Miserables.txt 47, NotreDame_De_Paris.txt 12
troubles	Miserables.txt 9, NotreDame_De_Paris.txt 1
troublesome	Miserables.txt 5, NotreDame_De_Paris.txt 1
troubling	Miserables.txt 6, NotreDame_De_Paris.txt 2
troublous	Miserables.txt 1
trouillefou	NotreDame_De_Paris.txt 27
trouillerfou	NotreDame_De_Paris.txt 1
troupe	Miserables.txt 4
trousers	Miserables.txt 57, NotreDame_De_Paris.txt 1
trousseau	Miserables.txt 2
trout	Miserables.txt 1
trouvaille	Miserables.txt 1
trouvain	NotreDame_De_Paris.txt 1
trouverez	Miserables.txt 1
trove	Miserables.txt 2
trowsers	Miserables.txt 1
troy	Miserables.txt 2
troyes	NotreDame_De_Paris.txt 2
truanderie	Miserables.txt 14, NotreDame_De_Paris.txt 1
truant	Miserables.txt 1
truce	Miserables.txt 4, NotreDame_De_Paris.txt 2
truck	Miserables.txt 2
trucks	Miserables.txt 1
true	Miserables.txt 170, NotreDame_De_Paris.txt 53
truer	Miserables.txt 1
truest	Miserables.txt 1
truffled	Miserables.txt 1
truffles	Miserables.txt 2
truly	Miserables.txt 23, NotreDame_De_Paris.txt 11
trump	Miserables.txt 3
trumpet	Miserables.txt 9, NotreDame_De_Paris.txt 4
trumpeter	NotreDame_De_Paris.txt 1
trumpeters	NotreDame_De_Paris.txt 1
trumpets	Miserables.txt 16, NotreDame_De_Paris.txt 1
trumps	Miserables.txt 1
truncated	Miserables.txt 2
truncus	NotreDame_De_Paris.txt 1
trundled	Miserables.txt 1
trunk	Miserables.txt 14, NotreDame_De_Paris.txt 4
trunks	Miserables.txt 5, NotreDame_De_Paris.txt 1
trunnions	Miserables.txt 1
truss	Miserables.txt 6, NotreDame_De_Paris.txt 4
trusses	Miserables.txt 2, NotreDame_De_Paris.txt 1
trust	Miserables.txt 10, NotreDame_De_Paris.txt 2
trusted	Miserables.txt 6
trusting	Miserables.txt 2, NotreDame_De_Paris.txt 1
trustworthy	Miserables.txt 2
trusty	Miserables.txt 2
truth	Miserables.txt 104, NotreDame_De_Paris.txt 36
truths	Miserables.txt 8
try	Miserables.txt 26, NotreDame_De_Paris.txt 10
trying	Miserables.txt 16, NotreDame_De_Paris.txt 5
tryphon	Miserables.txt 5
trysting	Miserables.txt 1
ts	Miserables.txt 1
tso	Miserables.txt 1
tu	Miserables.txt 21, NotreDame_De_Paris.txt 3
tua	Miserables.txt 1
tuas	Miserables.txt 1
tub	Miserables.txt 4
tube	Miserables.txt 1
tubercle	Miserables.txt 1
tubercles	Miserables.txt 1
tubular	Miserables.txt 2
tuck	Miserables.txt 2
tucked	Miserables.txt 2
tucker	NotreDame_De_Paris.txt 2
tucking	Miserables.txt 1
tuesday	Miserables.txt 21, NotreDame_De_Paris.txt 2
tuesdays	Miserables.txt 1
tuft	Miserables.txt 4, NotreDame_De_Paris.txt 1
tufted	Miserables.txt 3, NotreDame_De_Paris.txt 1
tufts	NotreDame_De_Paris.txt 7, Miserables.txt 1
tug	Miserables.txt 3
tugendbund	Miserables.txt 1
tugged	Miserables.txt 1
tui	NotreDame_De_Paris.txt 2
tuileries	Miserables.txt 21, NotreDame_De_Paris.txt 5
tuiles	Miserables.txt 1
tulip	Miserables.txt 1
tulipe	Miserables.txt 1
tulips	Miserables.txt 5
tumble	Miserables.txt 4
tumbled	Miserables.txt 7, NotreDame_De_Paris.txt 1
tumbling	Miserables.txt 3
tumbrel	NotreDame_De_Paris.txt 6, Miserables.txt 1
tumbril	Miserables.txt 2
tumbrils	Miserables.txt 2
tumors	Miserables.txt 1
tumult	Miserables.txt 33, NotreDame_De_Paris.txt 17
tumults	Miserables.txt 1
tumultuosa	NotreDame_De_Paris.txt 1
tumultuous	Miserables.txt 17, NotreDame_De_Paris.txt 6
tumultuously	Miserables.txt 6, NotreDame_De_Paris.txt 3
tumulus	NotreDame_De_Paris.txt 2
tun	Miserables.txt 3
tune	Miserables.txt 1
tunes	Miserables.txt 1
tunicam	NotreDame_De_Paris.txt 2
tunices	NotreDame_De_Paris.txt 1
tunics	NotreDame_De_Paris.txt 1
tunnel	Miserables.txt 2
tunnels	Miserables.txt 2, NotreDame_De_Paris.txt 1
turcaret	Miserables.txt 1
tureen	Miserables.txt 1
turenne	Miserables.txt 2
turf	Miserables.txt 8
turgot	Miserables.txt 3
turin	Miserables.txt 2, NotreDame_De_Paris.txt 1
turk	Miserables.txt 6, NotreDame_De_Paris.txt 1
turkey	Miserables.txt 7
turkheim	Miserables.txt 1
turkish	NotreDame_De_Paris.txt 3, Miserables.txt 1
turks	Miserables.txt 1
turn	Miserables.txt 147, NotreDame_De_Paris.txt 60
turned	Miserables.txt 332, NotreDame_De_Paris.txt 115
turning	Miserables.txt 67, NotreDame_De_Paris.txt 35
turnings	NotreDame_De_Paris.txt 1
turnip	Miserables.txt 1
turnkey	Miserables.txt 5, NotreDame_De_Paris.txt 2
turnkeys	Miserables.txt 1
turnover	Miserables.txt 2
turnovers	Miserables.txt 2
turns	Miserables.txt 31, NotreDame_De_Paris.txt 11
turnspit	NotreDame_De_Paris.txt 2
turpentine	Miserables.txt 1
turpitude	Miserables.txt 2, NotreDame_De_Paris.txt 1
turpitudes	Miserables.txt 1
turquant	NotreDame_De_Paris.txt 1
turquoises	Miserables.txt 1
turret	NotreDame_De_Paris.txt 4
turreted	NotreDame_De_Paris.txt 1
turrets	NotreDame_De_Paris.txt 5
turris	Miserables.txt 1
turtle	Miserables.txt 2
turtledoves	Miserables.txt 1
turvy	Miserables.txt 2
tusk	NotreDame_De_Paris.txt 1
tusked	NotreDame_De_Paris.txt 1
tusks	NotreDame_De_Paris.txt 1, Miserables.txt 1
tussle	Miserables.txt 1
tutor	Miserables.txt 1
tutu	Miserables.txt 2
tuum	NotreDame_De_Paris.txt 1
tuy	Miserables.txt 1
tuyaux	Miserables.txt 1
twaddle	Miserables.txt 3
twain	Miserables.txt 3, NotreDame_De_Paris.txt 2
twang	Miserables.txt 1
twas	NotreDame_De_Paris.txt 15, Miserables.txt 1
twelfth	Miserables.txt 5, NotreDame_De_Paris.txt 4
twelve	Miserables.txt 49, NotreDame_De_Paris.txt 15
twentieth	Miserables.txt 4, NotreDame_De_Paris.txt 1
twenty	Miserables.txt 194, NotreDame_De_Paris.txt 54
twice	Miserables.txt 22, NotreDame_De_Paris.txt 5
twig	Miserables.txt 1
twigs	Miserables.txt 2
twilight	Miserables.txt 57, NotreDame_De_Paris.txt 4
twill	NotreDame_De_Paris.txt 2
twin	Miserables.txt 1
twine	Miserables.txt 2
twined	NotreDame_De_Paris.txt 2, Miserables.txt 1
twinge	Miserables.txt 1
twining	NotreDame_De_Paris.txt 2
twinkle	Miserables.txt 1
twinkling	Miserables.txt 14, NotreDame_De_Paris.txt 7
twins	NotreDame_De_Paris.txt 1
twirling	NotreDame_De_Paris.txt 4, Miserables.txt 1
twist	Miserables.txt 4, NotreDame_De_Paris.txt 2
twisted	Miserables.txt 7, NotreDame_De_Paris.txt 4
twisting	Miserables.txt 4, NotreDame_De_Paris.txt 1
twists	Miserables.txt 2
twitching	Miserables.txt 1
twitchings	Miserables.txt 2
twits	Miserables.txt 1
twitter	Miserables.txt 1
twittering	Miserables.txt 1
twitters	Miserables.txt 1
two	Miserables.txt 1214, NotreDame_De_Paris.txt 349
twos	Miserables.txt 2
txt	NotreDame_De_Paris.txt 1, Miserables.txt 1
tybalde	NotreDame_De_Paris.txt 2
tying	Miserables.txt 2
tymbraeus	Miserables.txt 1
type	Miserables.txt 8, NotreDame_De_Paris.txt 2
types	NotreDame_De_Paris.txt 3, Miserables.txt 2
typhus	Miserables.txt 3
tyrannica	Miserables.txt 1
tyrannical	Miserables.txt 1
tyrannies	Miserables.txt 4
tyrannize	Miserables.txt 1
tyranny	Miserables.txt 5
tyrant	Miserables.txt 19, NotreDame_De_Paris.txt 1
tyrants	Miserables.txt 6
tyre	Miserables.txt 1
tzar	Miserables.txt 2
