y	Miserables.txt 6, NotreDame_De_Paris.txt 3
yard	Miserables.txt 33, NotreDame_De_Paris.txt 1
yards	Miserables.txt 9, NotreDame_De_Paris.txt 2
yarrow	Miserables.txt 2
yataghans	Miserables.txt 1
yawn	Miserables.txt 2, NotreDame_De_Paris.txt 1
yawned	Miserables.txt 11, NotreDame_De_Paris.txt 1
yawning	Miserables.txt 14, NotreDame_De_Paris.txt 1
yawns	Miserables.txt 2
ye	NotreDame_De_Paris.txt 3, Miserables.txt 3
year	Miserables.txt 117, NotreDame_De_Paris.txt 47
yearly	Miserables.txt 2
years	Miserables.txt 363, NotreDame_De_Paris.txt 81
yell	Miserables.txt 1
yelled	Miserables.txt 2
yelling	Miserables.txt 2
yellow	Miserables.txt 58, NotreDame_De_Paris.txt 23
yellowed	Miserables.txt 1
yellowish	Miserables.txt 2
yells	NotreDame_De_Paris.txt 1
yelped	NotreDame_De_Paris.txt 3, Miserables.txt 1
yelping	NotreDame_De_Paris.txt 4
yes	Miserables.txt 253, NotreDame_De_Paris.txt 95
yesses	Miserables.txt 1
yesterday	Miserables.txt 43, NotreDame_De_Paris.txt 10
yestere	Miserables.txt 1
yet	Miserables.txt 163, NotreDame_De_Paris.txt 56
yeux	NotreDame_De_Paris.txt 1
yew	Miserables.txt 1
yield	Miserables.txt 10, NotreDame_De_Paris.txt 1
yielded	Miserables.txt 18, NotreDame_De_Paris.txt 5
yielding	Miserables.txt 6, NotreDame_De_Paris.txt 3
yields	Miserables.txt 8, NotreDame_De_Paris.txt 1
yoke	Miserables.txt 3, NotreDame_De_Paris.txt 1
yolk	NotreDame_De_Paris.txt 1
yon	NotreDame_De_Paris.txt 1
yonder	NotreDame_De_Paris.txt 37, Miserables.txt 33
yonne	Miserables.txt 1
yore	Miserables.txt 3
york	Miserables.txt 2
you	Miserables.txt 3725, NotreDame_De_Paris.txt 1458
young	Miserables.txt 420, NotreDame_De_Paris.txt 213
younger	Miserables.txt 19, NotreDame_De_Paris.txt 3
youngest	Miserables.txt 5, NotreDame_De_Paris.txt 2
your	Miserables.txt 760, NotreDame_De_Paris.txt 356
yours	Miserables.txt 20, NotreDame_De_Paris.txt 12
yourself	Miserables.txt 97, NotreDame_De_Paris.txt 31
yourselves	Miserables.txt 19, NotreDame_De_Paris.txt 3
youth	Miserables.txt 68, NotreDame_De_Paris.txt 8
youthful	Miserables.txt 10, NotreDame_De_Paris.txt 1
youthfulness	NotreDame_De_Paris.txt 1
youths	Miserables.txt 1
yoways	Miserables.txt 1
yuste	Miserables.txt 1
yvela	NotreDame_De_Paris.txt 1
yves	NotreDame_De_Paris.txt 1
yvetot	Miserables.txt 1
yvon	Miserables.txt 1
