g	Miserables.txt 13
gabbling	Miserables.txt 1
gable	NotreDame_De_Paris.txt 2, Miserables.txt 8
gables	NotreDame_De_Paris.txt 11
gabon	Miserables.txt 1
gabriel	Miserables.txt 1
gabrielle	NotreDame_De_Paris.txt 2
gadfly	NotreDame_De_Paris.txt 1
gadine	NotreDame_De_Paris.txt 1
gag	Miserables.txt 1
gagged	Miserables.txt 1
gagny	Miserables.txt 6
gahisto	Miserables.txt 2
gail	Miserables.txt 1
gaillard	NotreDame_De_Paris.txt 1
gaillefontaine	NotreDame_De_Paris.txt 7
gaillon	Miserables.txt 2
gails	Miserables.txt 1
gaiment	Miserables.txt 1
gain	NotreDame_De_Paris.txt 2, Miserables.txt 14
gained	NotreDame_De_Paris.txt 5, Miserables.txt 14
gaining	Miserables.txt 6
gains	NotreDame_De_Paris.txt 1, Miserables.txt 4
gait	Miserables.txt 4
gaite	Miserables.txt 1
gaiters	Miserables.txt 3
gaiztoa	Miserables.txt 1
gala	NotreDame_De_Paris.txt 1, Miserables.txt 1
galatea	Miserables.txt 1
gale	Miserables.txt 6
gales	Miserables.txt 3
galgal	NotreDame_De_Paris.txt 1
galiache	NotreDame_De_Paris.txt 2
galilee	NotreDame_De_Paris.txt 9
galileo	Miserables.txt 1
galiot	NotreDame_De_Paris.txt 1
galiote	Miserables.txt 2
gall	NotreDame_De_Paris.txt 1
gallais	Miserables.txt 1
galland	Miserables.txt 1
gallant	NotreDame_De_Paris.txt 12, Miserables.txt 8
gallantly	NotreDame_De_Paris.txt 1
gallantries	NotreDame_De_Paris.txt 1
gallantry	NotreDame_De_Paris.txt 3, Miserables.txt 4
gallega	Miserables.txt 1
galleries	NotreDame_De_Paris.txt 8, Miserables.txt 10
gallery	NotreDame_De_Paris.txt 37, Miserables.txt 19
galley	Miserables.txt 26
galleys	NotreDame_De_Paris.txt 1, Miserables.txt 114
gallic	NotreDame_De_Paris.txt 3, Miserables.txt 5
gallican	Miserables.txt 1
gallicane	NotreDame_De_Paris.txt 1
gallicized	Miserables.txt 1
galloons	Miserables.txt 2
gallop	NotreDame_De_Paris.txt 5, Miserables.txt 16
galloped	Miserables.txt 3
galloping	NotreDame_De_Paris.txt 2, Miserables.txt 2
gallops	Miserables.txt 2
gallows	NotreDame_De_Paris.txt 31, Miserables.txt 3
galvanic	Miserables.txt 2
galvanized	NotreDame_De_Paris.txt 1
gamacho	Miserables.txt 1
gamble	Miserables.txt 1
gambled	Miserables.txt 2
gambler	NotreDame_De_Paris.txt 2, Miserables.txt 4
gamblers	NotreDame_De_Paris.txt 1, Miserables.txt 1
gambling	NotreDame_De_Paris.txt 1
gambolling	NotreDame_De_Paris.txt 1
gambols	NotreDame_De_Paris.txt 1
game	NotreDame_De_Paris.txt 8, Miserables.txt 20
games	NotreDame_De_Paris.txt 1, Miserables.txt 5
gamester	NotreDame_De_Paris.txt 1
gamin	Miserables.txt 64
gaminerie	Miserables.txt 1
gaming	NotreDame_De_Paris.txt 5, Miserables.txt 2
gamins	NotreDame_De_Paris.txt 1, Miserables.txt 5
gamut	NotreDame_De_Paris.txt 1
gand	Miserables.txt 1
gang	NotreDame_De_Paris.txt 1, Miserables.txt 9
gangrene	Miserables.txt 1
gans	Miserables.txt 3
gant	NotreDame_De_Paris.txt 1
gap	NotreDame_De_Paris.txt 3, Miserables.txt 5
gaped	NotreDame_De_Paris.txt 1, Miserables.txt 1
gapers	NotreDame_De_Paris.txt 1
gaping	NotreDame_De_Paris.txt 4, Miserables.txt 6
gaps	NotreDame_De_Paris.txt 1, Miserables.txt 3
garat	Miserables.txt 1
garb	NotreDame_De_Paris.txt 3, Miserables.txt 1
garde	NotreDame_De_Paris.txt 1
garden	NotreDame_De_Paris.txt 10, Miserables.txt 238
gardener	NotreDame_De_Paris.txt 3, Miserables.txt 34
gardeners	Miserables.txt 7
gardening	Miserables.txt 4
gardens	NotreDame_De_Paris.txt 9, Miserables.txt 26
gare	Miserables.txt 1
gargantua	NotreDame_De_Paris.txt 1
gargle	NotreDame_De_Paris.txt 1
gargoyles	NotreDame_De_Paris.txt 2, Miserables.txt 1
garibaldi	Miserables.txt 3
garland	NotreDame_De_Paris.txt 1
garlande	NotreDame_De_Paris.txt 1
garlanded	Miserables.txt 3
garlands	NotreDame_De_Paris.txt 2, Miserables.txt 2
garlic	Miserables.txt 1
garlin	NotreDame_De_Paris.txt 1
garment	NotreDame_De_Paris.txt 7, Miserables.txt 10
garments	NotreDame_De_Paris.txt 15, Miserables.txt 24
garmoise	NotreDame_De_Paris.txt 1
garnier	Miserables.txt 1
garnish	Miserables.txt 1
garnished	NotreDame_De_Paris.txt 4, Miserables.txt 4
garniture	Miserables.txt 1
garofolo	NotreDame_De_Paris.txt 1
garraud	Miserables.txt 1
garret	NotreDame_De_Paris.txt 2, Miserables.txt 35
garrets	Miserables.txt 2
garrison	NotreDame_De_Paris.txt 4, Miserables.txt 10
garrisons	NotreDame_De_Paris.txt 1
garroted	NotreDame_De_Paris.txt 1
garroter	Miserables.txt 1
garrulous	NotreDame_De_Paris.txt 2
garter	Miserables.txt 9
gas	NotreDame_De_Paris.txt 1, Miserables.txt 7
gascon	Miserables.txt 1
gashes	Miserables.txt 1
gaspard	Miserables.txt 2
gassendi	Miserables.txt 2
gaster	Miserables.txt 2
gastronomical	Miserables.txt 1
gat	Miserables.txt 1
gatch	Miserables.txt 1
gate	NotreDame_De_Paris.txt 20, Miserables.txt 72
gates	NotreDame_De_Paris.txt 11, Miserables.txt 19
gateway	NotreDame_De_Paris.txt 1
gather	Miserables.txt 5
gathered	NotreDame_De_Paris.txt 4, Miserables.txt 14
gathering	NotreDame_De_Paris.txt 1, Miserables.txt 1
gathers	Miserables.txt 2
gato	Miserables.txt 1
gauch	NotreDame_De_Paris.txt 5
gaucher	Miserables.txt 1
gaul	Miserables.txt 3
gauls	NotreDame_De_Paris.txt 2, Miserables.txt 2
gaulti	NotreDame_De_Paris.txt 5
gaunt	NotreDame_De_Paris.txt 3, Miserables.txt 3
gauntness	Miserables.txt 2
gauthier	Miserables.txt 1
gauvain	Miserables.txt 1
gauze	NotreDame_De_Paris.txt 4, Miserables.txt 1
gave	NotreDame_De_Paris.txt 50, Miserables.txt 136
gavest	Miserables.txt 1
gavotte	Miserables.txt 1
gavroche	Miserables.txt 321
gay	NotreDame_De_Paris.txt 9, Miserables.txt 39
gaye	Miserables.txt 1
gayer	NotreDame_De_Paris.txt 1
gayest	Miserables.txt 1
gayeties	NotreDame_De_Paris.txt 1, Miserables.txt 5
gayety	NotreDame_De_Paris.txt 7, Miserables.txt 31
gayly	NotreDame_De_Paris.txt 7, Miserables.txt 12
gaze	NotreDame_De_Paris.txt 26, Miserables.txt 87
gazed	NotreDame_De_Paris.txt 42, Miserables.txt 120
gazelle	NotreDame_De_Paris.txt 1
gazers	NotreDame_De_Paris.txt 1
gazes	NotreDame_De_Paris.txt 3, Miserables.txt 12
gazette	NotreDame_De_Paris.txt 1, Miserables.txt 1
gazettes	Miserables.txt 1
gazing	NotreDame_De_Paris.txt 29, Miserables.txt 52
gbnewby	NotreDame_De_Paris.txt 1, Miserables.txt 1
gear	Miserables.txt 1
gearing	Miserables.txt 6
geborand	Miserables.txt 3
ged	Miserables.txt 1
gedeon	Miserables.txt 1
geese	NotreDame_De_Paris.txt 1, Miserables.txt 2
gehenna	NotreDame_De_Paris.txt 1, Miserables.txt 1
gele	NotreDame_De_Paris.txt 1
gelenhausen	Miserables.txt 1
gellius	Miserables.txt 1
gemoniae	Miserables.txt 2
genaille	NotreDame_De_Paris.txt 1
genappe	Miserables.txt 19
gencienne	NotreDame_De_Paris.txt 2
gendarme	NotreDame_De_Paris.txt 10, Miserables.txt 18
gendarmeri	NotreDame_De_Paris.txt 1
gendarmerie	Miserables.txt 2
gendarmes	NotreDame_De_Paris.txt 2, Miserables.txt 26
general	NotreDame_De_Paris.txt 31, Miserables.txt 107
generale	Miserables.txt 1
generalissimo	Miserables.txt 3
generalizing	NotreDame_De_Paris.txt 1
generally	NotreDame_De_Paris.txt 8, Miserables.txt 24
generals	NotreDame_De_Paris.txt 1, Miserables.txt 15
generalship	Miserables.txt 1
generating	NotreDame_De_Paris.txt 2
generation	NotreDame_De_Paris.txt 2, Miserables.txt 3
generations	NotreDame_De_Paris.txt 4, Miserables.txt 6
generic	Miserables.txt 1
generis	NotreDame_De_Paris.txt 1
generosities	Miserables.txt 1
generosity	Miserables.txt 6
generous	NotreDame_De_Paris.txt 2, Miserables.txt 25
geneses	Miserables.txt 1
genesis	NotreDame_De_Paris.txt 1, Miserables.txt 3
genest	NotreDame_De_Paris.txt 1
genevi	NotreDame_De_Paris.txt 17
genevieve	Miserables.txt 9
genflot	Miserables.txt 5
genga	Miserables.txt 1
genial	Miserables.txt 1
genii	Miserables.txt 1
genio	NotreDame_De_Paris.txt 1
genius	NotreDame_De_Paris.txt 16, Miserables.txt 32
geniuses	Miserables.txt 10
genlis	Miserables.txt 5
gennevilliers	Miserables.txt 1
genoa	Miserables.txt 5
genoese	Miserables.txt 1
genoilhac	NotreDame_De_Paris.txt 1
genrot	Miserables.txt 9
genteel	Miserables.txt 1
gentilles	Miserables.txt 1
gentilly	NotreDame_De_Paris.txt 2, Miserables.txt 2
gentle	NotreDame_De_Paris.txt 15, Miserables.txt 69
gentleman	NotreDame_De_Paris.txt 13, Miserables.txt 73
gentlemen	NotreDame_De_Paris.txt 25, Miserables.txt 33
gentleness	NotreDame_De_Paris.txt 6, Miserables.txt 14
gentler	NotreDame_De_Paris.txt 1
gentlest	Miserables.txt 1
gentlewomen	Miserables.txt 1
gently	NotreDame_De_Paris.txt 20, Miserables.txt 53
gentry	NotreDame_De_Paris.txt 1
genuflection	Miserables.txt 1
genuflections	NotreDame_De_Paris.txt 1
genuine	NotreDame_De_Paris.txt 1, Miserables.txt 14
geoffrey	Miserables.txt 1
geoffroy	Miserables.txt 1
geographical	NotreDame_De_Paris.txt 1, Miserables.txt 1
geography	Miserables.txt 1
geological	Miserables.txt 1
geologists	Miserables.txt 2
geology	Miserables.txt 1
geometriam	NotreDame_De_Paris.txt 1
geometrical	NotreDame_De_Paris.txt 9, Miserables.txt 8
geometrician	Miserables.txt 1
geometry	NotreDame_De_Paris.txt 3, Miserables.txt 4
george	NotreDame_De_Paris.txt 2, Miserables.txt 1
georges	Miserables.txt 8
georgics	Miserables.txt 2
gerard	Miserables.txt 3
geraud	Miserables.txt 1
gerbaud	Miserables.txt 3
gerbe	Miserables.txt 1
gergeole	NotreDame_De_Paris.txt 1
gericault	Miserables.txt 1
germ	NotreDame_De_Paris.txt 3, Miserables.txt 3
germain	NotreDame_De_Paris.txt 22, Miserables.txt 15
germaine	NotreDame_De_Paris.txt 1
germainen	NotreDame_De_Paris.txt 1
germaini	NotreDame_De_Paris.txt 1
german	NotreDame_De_Paris.txt 3, Miserables.txt 20
germanic	Miserables.txt 2
germans	NotreDame_De_Paris.txt 2, Miserables.txt 3
germany	NotreDame_De_Paris.txt 1, Miserables.txt 16
germinate	Miserables.txt 3
germinating	Miserables.txt 1
germination	Miserables.txt 2
germoniae	Miserables.txt 1
germs	Miserables.txt 2
geronte	Miserables.txt 2
gertrude	Miserables.txt 1
gervais	NotreDame_De_Paris.txt 5, Miserables.txt 29
gervaise	NotreDame_De_Paris.txt 29
ges	NotreDame_De_Paris.txt 1
gesmas	Miserables.txt 5
gestas	Miserables.txt 2
gestation	Miserables.txt 1
gesticulated	Miserables.txt 2
gesticulating	NotreDame_De_Paris.txt 1
gesture	NotreDame_De_Paris.txt 21, Miserables.txt 38
gestures	NotreDame_De_Paris.txt 14, Miserables.txt 8
get	NotreDame_De_Paris.txt 34, Miserables.txt 223
gets	Miserables.txt 12
getting	NotreDame_De_Paris.txt 11, Miserables.txt 47
gewgaw	Miserables.txt 1
gewgaws	NotreDame_De_Paris.txt 1, Miserables.txt 1
gex	Miserables.txt 1
ghastly	Miserables.txt 1
gheldolf	NotreDame_De_Paris.txt 1
ghent	NotreDame_De_Paris.txt 15, Miserables.txt 3
ghetto	Miserables.txt 1
ghi	Miserables.txt 3
ghost	NotreDame_De_Paris.txt 2, Miserables.txt 2
ghosts	NotreDame_De_Paris.txt 1, Miserables.txt 3
ghoul	Miserables.txt 2
ghouls	Miserables.txt 1
gi	NotreDame_De_Paris.txt 1
gialluta	Miserables.txt 1
giant	NotreDame_De_Paris.txt 10, Miserables.txt 13
giantess	Miserables.txt 3
giants	Miserables.txt 9
gib	Miserables.txt 1
gibard	NotreDame_De_Paris.txt 3
gibbet	NotreDame_De_Paris.txt 32, Miserables.txt 8
gibbets	NotreDame_De_Paris.txt 7, Miserables.txt 2
gibbosities	Miserables.txt 1
gibelotte	Miserables.txt 12
gibet	NotreDame_De_Paris.txt 1
giborne	NotreDame_De_Paris.txt 4
gibou	Miserables.txt 1
giddiness	Miserables.txt 7
giddy	NotreDame_De_Paris.txt 3, Miserables.txt 3
gieffroy	NotreDame_De_Paris.txt 3
gif	NotreDame_De_Paris.txt 1
giffarde	NotreDame_De_Paris.txt 1
gift	NotreDame_De_Paris.txt 4, Miserables.txt 6
gifted	Miserables.txt 1
gifts	NotreDame_De_Paris.txt 1, Miserables.txt 3
gigantic	NotreDame_De_Paris.txt 18, Miserables.txt 20
gigotmuche	Miserables.txt 1
gil	Miserables.txt 1
gilbert	NotreDame_De_Paris.txt 2, Miserables.txt 1
gilbertus	NotreDame_De_Paris.txt 1
gild	NotreDame_De_Paris.txt 1
gilded	NotreDame_De_Paris.txt 19, Miserables.txt 19
gilding	NotreDame_De_Paris.txt 1, Miserables.txt 5
gillaume	NotreDame_De_Paris.txt 1
gillenorman	Miserables.txt 1
gillenormand	Miserables.txt 236
gillenormands	Miserables.txt 2
gilles	NotreDame_De_Paris.txt 7, Miserables.txt 1
gillet	NotreDame_De_Paris.txt 1
gilliflowers	Miserables.txt 1
gills	Miserables.txt 2
gillyflowers	Miserables.txt 1
gilt	NotreDame_De_Paris.txt 8, Miserables.txt 7
gimlet	NotreDame_De_Paris.txt 1, Miserables.txt 2
gimlets	NotreDame_De_Paris.txt 1
gin	Miserables.txt 1
gindre	Miserables.txt 1
gingerbread	Miserables.txt 1
giraffe	Miserables.txt 1
girandoles	Miserables.txt 1
girded	NotreDame_De_Paris.txt 1
girdle	NotreDame_De_Paris.txt 11, Miserables.txt 6
girdles	NotreDame_De_Paris.txt 1, Miserables.txt 1
girin	Miserables.txt 1
girl	NotreDame_De_Paris.txt 203, Miserables.txt 225
girlhood	Miserables.txt 1
girls	NotreDame_De_Paris.txt 21, Miserables.txt 100
girondists	Miserables.txt 1
gironin	NotreDame_De_Paris.txt 1
girorou	NotreDame_De_Paris.txt 1
gisors	Miserables.txt 1
gisquet	Miserables.txt 5
gisquette	NotreDame_De_Paris.txt 20
gist	NotreDame_De_Paris.txt 1
give	NotreDame_De_Paris.txt 65, Miserables.txt 196
given	NotreDame_De_Paris.txt 43, Miserables.txt 127
giver	Miserables.txt 1
gives	NotreDame_De_Paris.txt 7, Miserables.txt 36
giveth	NotreDame_De_Paris.txt 1
giving	NotreDame_De_Paris.txt 17, Miserables.txt 45
glaber	NotreDame_De_Paris.txt 1
glace	NotreDame_De_Paris.txt 1
glaces	Miserables.txt 2
glacial	NotreDame_De_Paris.txt 6, Miserables.txt 10
glacier	Miserables.txt 2
glaciere	Miserables.txt 6
glacis	Miserables.txt 1
glad	NotreDame_De_Paris.txt 4, Miserables.txt 8
glade	Miserables.txt 4
gladiator	Miserables.txt 3
gladly	NotreDame_De_Paris.txt 9, Miserables.txt 8
glance	NotreDame_De_Paris.txt 73, Miserables.txt 161
glanced	NotreDame_De_Paris.txt 7, Miserables.txt 26
glances	NotreDame_De_Paris.txt 16, Miserables.txt 22
glancing	NotreDame_De_Paris.txt 4, Miserables.txt 4
glandeve	Miserables.txt 1
glare	NotreDame_De_Paris.txt 1, Miserables.txt 5
glared	NotreDame_De_Paris.txt 2, Miserables.txt 2
glares	Miserables.txt 1
glaring	NotreDame_De_Paris.txt 2
glaris	Miserables.txt 1
glass	NotreDame_De_Paris.txt 32, Miserables.txt 87
glasses	NotreDame_De_Paris.txt 4, Miserables.txt 18
glassware	Miserables.txt 1
glassy	NotreDame_De_Paris.txt 1, Miserables.txt 5
glatigny	NotreDame_De_Paris.txt 3
glaueini	NotreDame_De_Paris.txt 1
glazed	NotreDame_De_Paris.txt 1, Miserables.txt 5
glazier	NotreDame_De_Paris.txt 1
glazing	Miserables.txt 1
gleam	NotreDame_De_Paris.txt 7, Miserables.txt 32
gleamed	NotreDame_De_Paris.txt 8, Miserables.txt 7
gleamest	Miserables.txt 1
gleaming	NotreDame_De_Paris.txt 3, Miserables.txt 2
gleams	NotreDame_De_Paris.txt 4, Miserables.txt 18
gleaned	Miserables.txt 1
glide	NotreDame_De_Paris.txt 3, Miserables.txt 2
glided	NotreDame_De_Paris.txt 2, Miserables.txt 8
glides	Miserables.txt 1
gliding	NotreDame_De_Paris.txt 1, Miserables.txt 6
glimmer	Miserables.txt 2
glimpse	NotreDame_De_Paris.txt 8, Miserables.txt 48
glimpses	Miserables.txt 12
glistened	NotreDame_De_Paris.txt 1, Miserables.txt 1
glistening	Miserables.txt 1
glitter	Miserables.txt 1
glittered	NotreDame_De_Paris.txt 6, Miserables.txt 4
glittering	NotreDame_De_Paris.txt 6, Miserables.txt 7
gloaming	Miserables.txt 1
gloating	Miserables.txt 1
globe	NotreDame_De_Paris.txt 1, Miserables.txt 11
globes	NotreDame_De_Paris.txt 1, Miserables.txt 1
gloire	Miserables.txt 2
gloom	NotreDame_De_Paris.txt 24, Miserables.txt 63
gloomiest	NotreDame_De_Paris.txt 1
gloomily	Miserables.txt 2
gloomy	NotreDame_De_Paris.txt 44, Miserables.txt 104
glories	Miserables.txt 1
gloriette	NotreDame_De_Paris.txt 1
glorieux	Miserables.txt 2
glorification	NotreDame_De_Paris.txt 1, Miserables.txt 2
glorified	Miserables.txt 1
glorify	Miserables.txt 1
glorifying	Miserables.txt 3
glorious	NotreDame_De_Paris.txt 1, Miserables.txt 4
gloriously	Miserables.txt 1
glory	NotreDame_De_Paris.txt 6, Miserables.txt 46
gloss	Miserables.txt 1
glossa	NotreDame_De_Paris.txt 1
glossy	NotreDame_De_Paris.txt 2
glove	NotreDame_De_Paris.txt 1, Miserables.txt 1
gloved	Miserables.txt 1
gloves	Miserables.txt 9
glow	Miserables.txt 18
glowed	NotreDame_De_Paris.txt 1
gloweth	NotreDame_De_Paris.txt 1
glowing	NotreDame_De_Paris.txt 3, Miserables.txt 11
glows	NotreDame_De_Paris.txt 1, Miserables.txt 1
glowworm	Miserables.txt 1
glued	NotreDame_De_Paris.txt 2, Miserables.txt 4
glum	Miserables.txt 1
glut	Miserables.txt 1
glutton	Miserables.txt 1
gluttony	Miserables.txt 3
gnarled	Miserables.txt 1
gnash	NotreDame_De_Paris.txt 2, Miserables.txt 1
gnashed	NotreDame_De_Paris.txt 5
gnashes	Miserables.txt 1
gnashing	NotreDame_De_Paris.txt 4, Miserables.txt 2
gnat	NotreDame_De_Paris.txt 3, Miserables.txt 2
gnats	Miserables.txt 1
gnaw	Miserables.txt 4
gnawed	NotreDame_De_Paris.txt 3, Miserables.txt 3
gnawing	NotreDame_De_Paris.txt 1, Miserables.txt 5
gnaws	Miserables.txt 2
gnier	NotreDame_De_Paris.txt 2
gnome	NotreDame_De_Paris.txt 4
gnomes	NotreDame_De_Paris.txt 1
gnon	Miserables.txt 1
go	NotreDame_De_Paris.txt 93, Miserables.txt 455
goad	NotreDame_De_Paris.txt 1
goal	Miserables.txt 15
goals	NotreDame_De_Paris.txt 1, Miserables.txt 1
goat	NotreDame_De_Paris.txt 110, Miserables.txt 7
goats	NotreDame_De_Paris.txt 2, Miserables.txt 1
gobble	Miserables.txt 1
gobbled	Miserables.txt 1
gobelins	NotreDame_De_Paris.txt 1, Miserables.txt 8
goblet	NotreDame_De_Paris.txt 5, Miserables.txt 4
goblin	Miserables.txt 2
goblins	Miserables.txt 2
god	NotreDame_De_Paris.txt 115, Miserables.txt 359
goddess	NotreDame_De_Paris.txt 1, Miserables.txt 6
goddesses	Miserables.txt 1
godfather	NotreDame_De_Paris.txt 1
godin	NotreDame_De_Paris.txt 1
godmother	NotreDame_De_Paris.txt 5
gods	NotreDame_De_Paris.txt 2, Miserables.txt 11
godsend	Miserables.txt 3
goes	NotreDame_De_Paris.txt 8, Miserables.txt 56
goeth	Miserables.txt 1
goethe	Miserables.txt 1
goff	Miserables.txt 1
goffeur	Miserables.txt 1
goguelu	NotreDame_De_Paris.txt 1
goguettes	Miserables.txt 1
going	NotreDame_De_Paris.txt 61, Miserables.txt 296
goings	Miserables.txt 3
golconda	NotreDame_De_Paris.txt 1
gold	NotreDame_De_Paris.txt 50, Miserables.txt 60
golden	NotreDame_De_Paris.txt 28, Miserables.txt 18
goldfinch	Miserables.txt 1
goldsmith	NotreDame_De_Paris.txt 3, Miserables.txt 1
goldsmiths	NotreDame_De_Paris.txt 1
goliath	Miserables.txt 2
gomicourt	Miserables.txt 1
gonaguet	Miserables.txt 1
gond	NotreDame_De_Paris.txt 1
gondelaurier	NotreDame_De_Paris.txt 22
gondolas	Miserables.txt 1
gondren	Miserables.txt 2
gone	NotreDame_De_Paris.txt 12, Miserables.txt 102
gonesse	NotreDame_De_Paris.txt 1, Miserables.txt 1
goo	Miserables.txt 1
good	NotreDame_De_Paris.txt 252, Miserables.txt 801
goodly	NotreDame_De_Paris.txt 9
goodman	Miserables.txt 24
goodmen	Miserables.txt 1
goodness	Miserables.txt 27
goods	NotreDame_De_Paris.txt 2, Miserables.txt 7
goodwives	NotreDame_De_Paris.txt 2, Miserables.txt 2
goody	NotreDame_De_Paris.txt 2, Miserables.txt 2
goose	Miserables.txt 5
gooseberry	Miserables.txt 1
gorbeau	Miserables.txt 30
gordon	Miserables.txt 2
gored	Miserables.txt 1
gorge	NotreDame_De_Paris.txt 2, Miserables.txt 5
gorged	NotreDame_De_Paris.txt 1
gorgerette	NotreDame_De_Paris.txt 2
gorges	Miserables.txt 3
gorget	NotreDame_De_Paris.txt 3, Miserables.txt 1
gorgon	NotreDame_De_Paris.txt 1, Miserables.txt 1
gorgons	NotreDame_De_Paris.txt 1
gormandize	Miserables.txt 1
gormandizer	Miserables.txt 1
gosling	NotreDame_De_Paris.txt 1
gospel	Miserables.txt 4
gosselies	Miserables.txt 1
gossip	NotreDame_De_Paris.txt 42, Miserables.txt 8
gossiped	Miserables.txt 2
gossiping	NotreDame_De_Paris.txt 1, Miserables.txt 1
gossips	NotreDame_De_Paris.txt 3, Miserables.txt 6
got	NotreDame_De_Paris.txt 10, Miserables.txt 71
gothic	NotreDame_De_Paris.txt 42, Miserables.txt 5
goton	NotreDame_De_Paris.txt 1
goujon	NotreDame_De_Paris.txt 1, Miserables.txt 1
gourd	NotreDame_De_Paris.txt 1, Miserables.txt 1
gourdes	Miserables.txt 1
gourgaud	Miserables.txt 1
gournay	Miserables.txt 2
gourney	Miserables.txt 1
gousset	Miserables.txt 1
gout	NotreDame_De_Paris.txt 1
gouty	Miserables.txt 5
gouvion	Miserables.txt 1
govern	NotreDame_De_Paris.txt 1, Miserables.txt 2
governed	Miserables.txt 4
governing	Miserables.txt 4
government	Miserables.txt 56
governmentalism	Miserables.txt 1
governmentalist	Miserables.txt 1
governments	Miserables.txt 2
governor	NotreDame_De_Paris.txt 5
governors	Miserables.txt 1
governs	Miserables.txt 3
gown	NotreDame_De_Paris.txt 7, Miserables.txt 40
gowns	NotreDame_De_Paris.txt 1, Miserables.txt 4
goy	NotreDame_De_Paris.txt 1
goya	NotreDame_De_Paris.txt 1
gozzi	Miserables.txt 1
gr	NotreDame_De_Paris.txt 62
gracchi	Miserables.txt 1
gracchos	Miserables.txt 1
gracchus	Miserables.txt 2
grace	NotreDame_De_Paris.txt 18, Miserables.txt 42
graceful	NotreDame_De_Paris.txt 17, Miserables.txt 18
gracefully	NotreDame_De_Paris.txt 12, Miserables.txt 1
graces	Miserables.txt 6
gracieuse	Miserables.txt 1
gracious	NotreDame_De_Paris.txt 5, Miserables.txt 8
graciously	NotreDame_De_Paris.txt 1, Miserables.txt 2
gradation	NotreDame_De_Paris.txt 1
grade	Miserables.txt 2
graded	NotreDame_De_Paris.txt 1
grades	NotreDame_De_Paris.txt 1
gradual	NotreDame_De_Paris.txt 1
gradually	NotreDame_De_Paris.txt 15, Miserables.txt 43
graduate	Miserables.txt 1
graduated	NotreDame_De_Paris.txt 1, Miserables.txt 1
graeculus	Miserables.txt 1
graft	NotreDame_De_Paris.txt 2, Miserables.txt 2
grafted	Miserables.txt 2
grafting	NotreDame_De_Paris.txt 1, Miserables.txt 2
grafts	Miserables.txt 1
grain	NotreDame_De_Paris.txt 4, Miserables.txt 12
grains	NotreDame_De_Paris.txt 1, Miserables.txt 4
grammar	Miserables.txt 4
grammarian	NotreDame_De_Paris.txt 1, Miserables.txt 1
grammars	Miserables.txt 1
gramont	Miserables.txt 2
gran	NotreDame_De_Paris.txt 1
granary	NotreDame_De_Paris.txt 1, Miserables.txt 3
grand	NotreDame_De_Paris.txt 83, Miserables.txt 147
grandchild	Miserables.txt 1
grandchildren	Miserables.txt 1
grande	NotreDame_De_Paris.txt 1, Miserables.txt 3
grander	Miserables.txt 6
grandest	Miserables.txt 2
grandeur	NotreDame_De_Paris.txt 8, Miserables.txt 26
grandeurs	Miserables.txt 5
grandfather	NotreDame_De_Paris.txt 2, Miserables.txt 135
grandfathers	Miserables.txt 1
grandiose	NotreDame_De_Paris.txt 1, Miserables.txt 6
grandioseness	Miserables.txt 1
grandly	Miserables.txt 1
grandmother	NotreDame_De_Paris.txt 2, Miserables.txt 3
grandmothers	NotreDame_De_Paris.txt 1, Miserables.txt 3
grandnephew	Miserables.txt 6
grandpapa	Miserables.txt 1
grands	Miserables.txt 1
grandsire	Miserables.txt 1
grandsires	Miserables.txt 1
grandson	NotreDame_De_Paris.txt 1, Miserables.txt 20
granduncle	Miserables.txt 1
grange	NotreDame_De_Paris.txt 1, Miserables.txt 2
granite	NotreDame_De_Paris.txt 8, Miserables.txt 16
granmont	Miserables.txt 1
grant	NotreDame_De_Paris.txt 2, Miserables.txt 14
grantaire	Miserables.txt 85
granted	NotreDame_De_Paris.txt 10, Miserables.txt 15
granting	Miserables.txt 2
grants	Miserables.txt 3
grape	Miserables.txt 47
grapes	NotreDame_De_Paris.txt 2, Miserables.txt 6
grappling	Miserables.txt 1
gras	NotreDame_De_Paris.txt 1, Miserables.txt 5
grase	Miserables.txt 1
grasp	NotreDame_De_Paris.txt 2, Miserables.txt 25
grasped	NotreDame_De_Paris.txt 8, Miserables.txt 37
grasping	NotreDame_De_Paris.txt 6, Miserables.txt 6
grasps	NotreDame_De_Paris.txt 1, Miserables.txt 1
grass	NotreDame_De_Paris.txt 4, Miserables.txt 53
grasse	Miserables.txt 4
grasses	Miserables.txt 3
grasshopper	NotreDame_De_Paris.txt 2
grasshoppers	Miserables.txt 1
grassy	Miserables.txt 1
grate	NotreDame_De_Paris.txt 1
grated	NotreDame_De_Paris.txt 2, Miserables.txt 21
grateful	NotreDame_De_Paris.txt 1, Miserables.txt 7
gratefully	NotreDame_De_Paris.txt 1, Miserables.txt 1
gratia	Miserables.txt 1
gratian	NotreDame_De_Paris.txt 3
gratified	NotreDame_De_Paris.txt 3, Miserables.txt 1
gratifying	NotreDame_De_Paris.txt 1
grating	NotreDame_De_Paris.txt 11, Miserables.txt 54
gratings	NotreDame_De_Paris.txt 3, Miserables.txt 11
gratis	Miserables.txt 5
gratitude	NotreDame_De_Paris.txt 6, Miserables.txt 19
gratuitous	Miserables.txt 4
gratuitously	Miserables.txt 4
gratuity	Miserables.txt 1
grave	NotreDame_De_Paris.txt 28, Miserables.txt 173
graved	NotreDame_De_Paris.txt 1
gravely	NotreDame_De_Paris.txt 12, Miserables.txt 14
graven	NotreDame_De_Paris.txt 1, Miserables.txt 1
graves	Miserables.txt 6
gravest	Miserables.txt 3
graville	NotreDame_De_Paris.txt 1
gravilliers	Miserables.txt 1
graving	Miserables.txt 1
gravitate	Miserables.txt 1
gravitated	Miserables.txt 1
gravitates	Miserables.txt 1
gravitation	Miserables.txt 1
gravitations	Miserables.txt 1
gravity	NotreDame_De_Paris.txt 6, Miserables.txt 20
gray	NotreDame_De_Paris.txt 23, Miserables.txt 50
grayhounds	NotreDame_De_Paris.txt 1
grayish	Miserables.txt 2
grays	Miserables.txt 3
graze	Miserables.txt 1
grazed	NotreDame_De_Paris.txt 1, Miserables.txt 2
grease	NotreDame_De_Paris.txt 6, Miserables.txt 1
greased	Miserables.txt 1
greasing	Miserables.txt 1
greasy	NotreDame_De_Paris.txt 1, Miserables.txt 1
great	NotreDame_De_Paris.txt 259, Miserables.txt 512
greatcoats	Miserables.txt 1
greater	NotreDame_De_Paris.txt 12, Miserables.txt 29
greatest	NotreDame_De_Paris.txt 5, Miserables.txt 17
greatly	NotreDame_De_Paris.txt 24, Miserables.txt 50
greatness	NotreDame_De_Paris.txt 1, Miserables.txt 7
greatnesses	Miserables.txt 1
grecian	Miserables.txt 1
greco	NotreDame_De_Paris.txt 2
greece	NotreDame_De_Paris.txt 5, Miserables.txt 13
greedy	NotreDame_De_Paris.txt 3, Miserables.txt 5
greek	NotreDame_De_Paris.txt 30, Miserables.txt 14
greeks	Miserables.txt 2
green	NotreDame_De_Paris.txt 16, Miserables.txt 66
greener	NotreDame_De_Paris.txt 1
greenhorn	Miserables.txt 4
greenhorns	Miserables.txt 1
greenhouse	Miserables.txt 1
greenies	Miserables.txt 1
greenish	NotreDame_De_Paris.txt 2, Miserables.txt 1
greenly	NotreDame_De_Paris.txt 1
greens	Miserables.txt 1
greensward	NotreDame_De_Paris.txt 1
greeted	NotreDame_De_Paris.txt 3, Miserables.txt 2
greeting	NotreDame_De_Paris.txt 2, Miserables.txt 1
gregoire	Miserables.txt 2
gregorian	Miserables.txt 1
gregory	NotreDame_De_Paris.txt 5, Miserables.txt 3
grelotte	Miserables.txt 1
grenades	Miserables.txt 1
grenadier	Miserables.txt 6
grenadiers	NotreDame_De_Paris.txt 1, Miserables.txt 9
grenelle	Miserables.txt 5
grenetat	Miserables.txt 2
grenier	NotreDame_De_Paris.txt 2, Miserables.txt 3
grenoble	Miserables.txt 4
gres	Miserables.txt 3
greuze	Miserables.txt 2
greve	NotreDame_De_Paris.txt 1, Miserables.txt 10
grew	NotreDame_De_Paris.txt 17, Miserables.txt 53
gribeauval	Miserables.txt 2
gribier	Miserables.txt 10
gridiron	NotreDame_De_Paris.txt 1
grief	NotreDame_De_Paris.txt 16, Miserables.txt 24
griefs	Miserables.txt 5
grievance	Miserables.txt 1
grievances	Miserables.txt 2
grieve	Miserables.txt 1
grieved	NotreDame_De_Paris.txt 1, Miserables.txt 4
grieves	NotreDame_De_Paris.txt 1
grievous	NotreDame_De_Paris.txt 1
griffin	Miserables.txt 3
griffins	NotreDame_De_Paris.txt 1
griffs	Miserables.txt 1
grilles	Miserables.txt 1
grim	Miserables.txt 1
grimace	NotreDame_De_Paris.txt 23, Miserables.txt 12
grimaced	Miserables.txt 1
grimacer	Miserables.txt 2
grimaces	NotreDame_De_Paris.txt 6, Miserables.txt 5
grimacing	NotreDame_De_Paris.txt 2
grimod	Miserables.txt 2
grimy	NotreDame_De_Paris.txt 1
grin	NotreDame_De_Paris.txt 3, Miserables.txt 3
grind	NotreDame_De_Paris.txt 1, Miserables.txt 1
grinder	Miserables.txt 3
grinders	Miserables.txt 1
grinding	Miserables.txt 4
gringoire	NotreDame_De_Paris.txt 336
grinned	Miserables.txt 2
grinning	NotreDame_De_Paris.txt 3, Miserables.txt 1
grins	Miserables.txt 3
grip	NotreDame_De_Paris.txt 2, Miserables.txt 3
grips	Miserables.txt 1
gris	Miserables.txt 1
griserait	Miserables.txt 1
grisette	Miserables.txt 8
grisettes	Miserables.txt 4
grisis	NotreDame_De_Paris.txt 2
gristles	NotreDame_De_Paris.txt 1
grives	Miserables.txt 1
grkztntgzyal	Miserables.txt 1
groan	NotreDame_De_Paris.txt 2, Miserables.txt 3
groaned	NotreDame_De_Paris.txt 1
groaning	NotreDame_De_Paris.txt 2, Miserables.txt 3
groanings	Miserables.txt 1
groans	NotreDame_De_Paris.txt 4, Miserables.txt 6
grocer	NotreDame_De_Paris.txt 1, Miserables.txt 3
groecum	NotreDame_De_Paris.txt 1
groenendael	Miserables.txt 1
groentendael	Miserables.txt 1
groom	NotreDame_De_Paris.txt 4, Miserables.txt 1
grooms	Miserables.txt 1
groove	Miserables.txt 2
grooved	NotreDame_De_Paris.txt 2
grooves	Miserables.txt 1
groped	NotreDame_De_Paris.txt 3, Miserables.txt 6
gropes	Miserables.txt 1
groping	NotreDame_De_Paris.txt 2, Miserables.txt 6
gropingly	Miserables.txt 2
gropings	Miserables.txt 3
gros	NotreDame_De_Paris.txt 1, Miserables.txt 4
gross	NotreDame_De_Paris.txt 3, Miserables.txt 7
grosse	Miserables.txt 1
grossi	NotreDame_De_Paris.txt 1
grossness	Miserables.txt 2
grotesque	NotreDame_De_Paris.txt 9, Miserables.txt 3
grotesquely	NotreDame_De_Paris.txt 1
grotesquenesses	Miserables.txt 1
grotte	Miserables.txt 1
grotto	NotreDame_De_Paris.txt 2, Miserables.txt 5
grottos	Miserables.txt 1
grouchy	Miserables.txt 6
grouille	NotreDame_De_Paris.txt 4
ground	NotreDame_De_Paris.txt 43, Miserables.txt 140
grounded	Miserables.txt 2
groundfloor	Miserables.txt 1
grounds	NotreDame_De_Paris.txt 3, Miserables.txt 1
groundswell	Miserables.txt 1
groundwork	NotreDame_De_Paris.txt 1
group	NotreDame_De_Paris.txt 26, Miserables.txt 51
grouped	NotreDame_De_Paris.txt 5, Miserables.txt 9
grouping	NotreDame_De_Paris.txt 2
groups	NotreDame_De_Paris.txt 12, Miserables.txt 25
grove	Miserables.txt 4
grow	NotreDame_De_Paris.txt 9, Miserables.txt 46
growing	NotreDame_De_Paris.txt 14, Miserables.txt 34
growl	NotreDame_De_Paris.txt 2, Miserables.txt 4
growled	NotreDame_De_Paris.txt 4, Miserables.txt 6
growler	Miserables.txt 1
growling	NotreDame_De_Paris.txt 1, Miserables.txt 2
grown	NotreDame_De_Paris.txt 18, Miserables.txt 39
grows	NotreDame_De_Paris.txt 7, Miserables.txt 17
growth	NotreDame_De_Paris.txt 1, Miserables.txt 15
growths	Miserables.txt 2
grub	Miserables.txt 3
grucheray	Miserables.txt 1
grudge	NotreDame_De_Paris.txt 5, Miserables.txt 1
gruff	NotreDame_De_Paris.txt 1, Miserables.txt 2
gruffly	Miserables.txt 1
grumble	NotreDame_De_Paris.txt 4, Miserables.txt 3
grumbled	NotreDame_De_Paris.txt 6, Miserables.txt 17
grumblers	Miserables.txt 1
grumbling	NotreDame_De_Paris.txt 2, Miserables.txt 4
grumblingly	Miserables.txt 1
grurin	Miserables.txt 3
gruyer	NotreDame_De_Paris.txt 2
guano	Miserables.txt 2
guarantee	Miserables.txt 4
guarantees	Miserables.txt 4
guard	NotreDame_De_Paris.txt 20, Miserables.txt 120
guarded	NotreDame_De_Paris.txt 5, Miserables.txt 20
guardian	NotreDame_De_Paris.txt 8, Miserables.txt 8
guardians	NotreDame_De_Paris.txt 1
guardianship	NotreDame_De_Paris.txt 1
guarding	Miserables.txt 7
guards	NotreDame_De_Paris.txt 1, Miserables.txt 38
guardsman	Miserables.txt 8
guardsmen	Miserables.txt 11
gudule	NotreDame_De_Paris.txt 22
gue	Miserables.txt 1
guebrs	NotreDame_De_Paris.txt 1
guedouze	Miserables.txt 1
guelemer	Miserables.txt 22
guemenee	Miserables.txt 1
guenn	Miserables.txt 1
guerilleros	Miserables.txt 1
guerin	Miserables.txt 1
guerre	Miserables.txt 2
guery	NotreDame_De_Paris.txt 1
guess	Miserables.txt 6
guessed	Miserables.txt 6
guest	Miserables.txt 5
guests	NotreDame_De_Paris.txt 3, Miserables.txt 6
gueule	NotreDame_De_Paris.txt 4
gueulemer	Miserables.txt 9
gueux	NotreDame_De_Paris.txt 1, Miserables.txt 2
guibourg	Miserables.txt 1
guichard	NotreDame_De_Paris.txt 1
guicherat	Miserables.txt 1
guidance	NotreDame_De_Paris.txt 1
guide	Miserables.txt 26
guided	Miserables.txt 5
guides	Miserables.txt 2
guiding	Miserables.txt 1
guidonis	Miserables.txt 2
guignon	Miserables.txt 1
guillaume	NotreDame_De_Paris.txt 44, Miserables.txt 7
guillemette	NotreDame_De_Paris.txt 4
guilleminot	Miserables.txt 2
guillery	Miserables.txt 1
guillons	Miserables.txt 1
guillot	Miserables.txt 1
guillotine	NotreDame_De_Paris.txt 2, Miserables.txt 15
guillotined	Miserables.txt 1
guilt	Miserables.txt 2
guilty	NotreDame_De_Paris.txt 2, Miserables.txt 19
guimard	Miserables.txt 2
guimardinette	Miserables.txt 1
guimardini	Miserables.txt 1
guimpe	NotreDame_De_Paris.txt 1, Miserables.txt 8
guinea	Miserables.txt 1
guipure	Miserables.txt 2
guise	NotreDame_De_Paris.txt 1, Miserables.txt 8
guitar	Miserables.txt 1
gula	Miserables.txt 1
gulax	Miserables.txt 1
gules	NotreDame_De_Paris.txt 1
gulf	NotreDame_De_Paris.txt 2, Miserables.txt 34
gulfs	Miserables.txt 9
gull	Miserables.txt 1
gullet	Miserables.txt 1
gullets	Miserables.txt 1
gullies	Miserables.txt 2
gulnare	Miserables.txt 1
gulped	Miserables.txt 1
gum	Miserables.txt 2
gums	NotreDame_De_Paris.txt 2, Miserables.txt 3
gun	Miserables.txt 78
gunners	Miserables.txt 1
gunpowder	Miserables.txt 1
guns	Miserables.txt 44
gunshot	Miserables.txt 1
gunsmith	Miserables.txt 1
gunzberg	Miserables.txt 1
gurdy	NotreDame_De_Paris.txt 1, Miserables.txt 2
gurgites	NotreDame_De_Paris.txt 1
gush	NotreDame_De_Paris.txt 2, Miserables.txt 2
gushed	NotreDame_De_Paris.txt 1
gushing	NotreDame_De_Paris.txt 1, Miserables.txt 1
gust	NotreDame_De_Paris.txt 2, Miserables.txt 7
gustave	Miserables.txt 1
gustavus	NotreDame_De_Paris.txt 1
gusts	NotreDame_De_Paris.txt 3, Miserables.txt 8
gut	Miserables.txt 5
gutenberg	NotreDame_De_Paris.txt 97, Miserables.txt 93
gutenburg	NotreDame_De_Paris.txt 1
guts	NotreDame_De_Paris.txt 3
gutter	NotreDame_De_Paris.txt 8, Miserables.txt 17
gutters	NotreDame_De_Paris.txt 8, Miserables.txt 4
guttural	NotreDame_De_Paris.txt 2, Miserables.txt 2
guy	NotreDame_De_Paris.txt 1, Miserables.txt 3
guybertant	NotreDame_De_Paris.txt 3
guyenne	NotreDame_De_Paris.txt 1
guyon	NotreDame_De_Paris.txt 2, Miserables.txt 2
guyot	Miserables.txt 1
gymnast	Miserables.txt 1
gymnastics	Miserables.txt 1
gymnastoras	Miserables.txt 1
gypsies	NotreDame_De_Paris.txt 23
gypsy	NotreDame_De_Paris.txt 200
gyrations	NotreDame_De_Paris.txt 1, Miserables.txt 1
