e	NotreDame_De_Paris.txt 30, Miserables.txt 27
each	Miserables.txt 456, NotreDame_De_Paris.txt 147
eager	NotreDame_De_Paris.txt 4, Miserables.txt 3
eagerly	Miserables.txt 9, NotreDame_De_Paris.txt 8
eagerness	NotreDame_De_Paris.txt 1
eagle	Miserables.txt 23, NotreDame_De_Paris.txt 5
eagles	Miserables.txt 7, NotreDame_De_Paris.txt 1
eam	Miserables.txt 1
ear	Miserables.txt 58, NotreDame_De_Paris.txt 40
eared	NotreDame_De_Paris.txt 1
earlier	Miserables.txt 8, NotreDame_De_Paris.txt 1
earliest	NotreDame_De_Paris.txt 2
earls	NotreDame_De_Paris.txt 1
early	Miserables.txt 45, NotreDame_De_Paris.txt 7
earn	Miserables.txt 18, NotreDame_De_Paris.txt 4
earned	Miserables.txt 18, NotreDame_De_Paris.txt 4
earnest	NotreDame_De_Paris.txt 1
earnestly	NotreDame_De_Paris.txt 1
earning	Miserables.txt 5
earnings	Miserables.txt 3
earns	Miserables.txt 1
ears	Miserables.txt 38, NotreDame_De_Paris.txt 27
earth	Miserables.txt 178, NotreDame_De_Paris.txt 44
earthen	Miserables.txt 1
earthenware	Miserables.txt 7, NotreDame_De_Paris.txt 6
earthquake	Miserables.txt 5, NotreDame_De_Paris.txt 1
earthquakes	Miserables.txt 3
earthworm	Miserables.txt 2, NotreDame_De_Paris.txt 1
earthy	NotreDame_De_Paris.txt 1, Miserables.txt 1
ease	Miserables.txt 27, NotreDame_De_Paris.txt 20
easier	NotreDame_De_Paris.txt 4, Miserables.txt 4
easily	Miserables.txt 40, NotreDame_De_Paris.txt 12
east	NotreDame_De_Paris.txt 14, Miserables.txt 8
easter	NotreDame_De_Paris.txt 5, Miserables.txt 1
eastern	NotreDame_De_Paris.txt 1, Miserables.txt 1
easters	NotreDame_De_Paris.txt 1
eastward	NotreDame_De_Paris.txt 1
easy	Miserables.txt 56, NotreDame_De_Paris.txt 16
eat	Miserables.txt 79, NotreDame_De_Paris.txt 17
eatable	Miserables.txt 2
eaten	Miserables.txt 32, NotreDame_De_Paris.txt 4
eater	Miserables.txt 2
eating	Miserables.txt 20, NotreDame_De_Paris.txt 4
eats	Miserables.txt 13, NotreDame_De_Paris.txt 3
eau	Miserables.txt 5, NotreDame_De_Paris.txt 4
eaves	NotreDame_De_Paris.txt 2
ebb	Miserables.txt 7, NotreDame_De_Paris.txt 1
ebbing	NotreDame_De_Paris.txt 1
ebbs	NotreDame_De_Paris.txt 1, Miserables.txt 1
ebony	Miserables.txt 2, NotreDame_De_Paris.txt 1
ebook	Miserables.txt 11, NotreDame_De_Paris.txt 10
ebooks	NotreDame_De_Paris.txt 7, Miserables.txt 7
ebouriffe	Miserables.txt 1
ebranle	Miserables.txt 1
ebrietas	NotreDame_De_Paris.txt 1
ebullition	Miserables.txt 2, NotreDame_De_Paris.txt 1
ebullitions	Miserables.txt 4
eburnea	Miserables.txt 1
ecce	Miserables.txt 6, NotreDame_De_Paris.txt 1
eccellence	Miserables.txt 1
eccentric	Miserables.txt 12, NotreDame_De_Paris.txt 7
eccentrically	NotreDame_De_Paris.txt 1
eccentricities	Miserables.txt 1
eccentricity	Miserables.txt 1
ecclesiarum	NotreDame_De_Paris.txt 1
ecclesiastes	Miserables.txt 3
ecclesiastic	Miserables.txt 1
ecclesiastical	NotreDame_De_Paris.txt 14, Miserables.txt 2
ecclesiastics	Miserables.txt 2
ecclesioe	NotreDame_De_Paris.txt 2
echabeau	Miserables.txt 1
echar	NotreDame_De_Paris.txt 1
echarpe	Miserables.txt 2
echasses	Miserables.txt 1
echaude	Miserables.txt 1
echelonned	Miserables.txt 2
echelonning	Miserables.txt 1
echelons	Miserables.txt 2
echo	Miserables.txt 6, NotreDame_De_Paris.txt 5
echoed	Miserables.txt 2
echoes	Miserables.txt 1
echoing	NotreDame_De_Paris.txt 1
eckberg	Miserables.txt 1
eclaireurs	Miserables.txt 1
eclectic	NotreDame_De_Paris.txt 1
eclipse	Miserables.txt 15, NotreDame_De_Paris.txt 1
eclipsed	Miserables.txt 5
eclipses	Miserables.txt 3
eclogue	Miserables.txt 1
eclos	Miserables.txt 1
ecnomus	NotreDame_De_Paris.txt 1
economic	Miserables.txt 2
economical	Miserables.txt 3
economically	Miserables.txt 1
economists	Miserables.txt 3
economize	Miserables.txt 3
economy	Miserables.txt 7, NotreDame_De_Paris.txt 1
ecossais	Miserables.txt 1
ecouen	Miserables.txt 2
ecouys	NotreDame_De_Paris.txt 1
ecrase	Miserables.txt 1
ecrit	Miserables.txt 1
ecrivans	NotreDame_De_Paris.txt 1
ecroula	Miserables.txt 1
ecstacies	NotreDame_De_Paris.txt 1
ecstacy	NotreDame_De_Paris.txt 1
ecstasies	Miserables.txt 14
ecstasy	Miserables.txt 33, NotreDame_De_Paris.txt 5
ecstatic	Miserables.txt 6, NotreDame_De_Paris.txt 1
ecstatically	Miserables.txt 1
edacior	NotreDame_De_Paris.txt 1
edapteon	Miserables.txt 1
edax	NotreDame_De_Paris.txt 1
eddies	NotreDame_De_Paris.txt 1, Miserables.txt 1
eddy	Miserables.txt 2
eden	Miserables.txt 7
edenizing	Miserables.txt 1
edge	Miserables.txt 24, NotreDame_De_Paris.txt 20
edged	NotreDame_De_Paris.txt 2, Miserables.txt 2
edges	Miserables.txt 6, NotreDame_De_Paris.txt 4
edict	NotreDame_De_Paris.txt 2, Miserables.txt 1
edification	NotreDame_De_Paris.txt 1
edifice	NotreDame_De_Paris.txt 67, Miserables.txt 17
edifices	NotreDame_De_Paris.txt 34, Miserables.txt 3
edified	NotreDame_De_Paris.txt 1, Miserables.txt 1
editing	Miserables.txt 1
edition	NotreDame_De_Paris.txt 8, Miserables.txt 6
editions	NotreDame_De_Paris.txt 6, Miserables.txt 5
editor	Miserables.txt 3
edmond	Miserables.txt 1
edon	Miserables.txt 3
educate	Miserables.txt 1
educated	Miserables.txt 7
educating	Miserables.txt 1
education	Miserables.txt 37, NotreDame_De_Paris.txt 2
educational	Miserables.txt 2, NotreDame_De_Paris.txt 1
educed	Miserables.txt 1
eduensis	NotreDame_De_Paris.txt 1
edward	NotreDame_De_Paris.txt 3
eel	NotreDame_De_Paris.txt 1, Miserables.txt 1
eels	Miserables.txt 2
efface	Miserables.txt 5, NotreDame_De_Paris.txt 1
effaced	Miserables.txt 15, NotreDame_De_Paris.txt 14
effacement	Miserables.txt 1
effaces	NotreDame_De_Paris.txt 2, Miserables.txt 2
effacing	Miserables.txt 3, NotreDame_De_Paris.txt 1
effect	Miserables.txt 99, NotreDame_De_Paris.txt 42
effected	Miserables.txt 26, NotreDame_De_Paris.txt 2
effecting	NotreDame_De_Paris.txt 1, Miserables.txt 1
effects	Miserables.txt 14, NotreDame_De_Paris.txt 1
effectual	NotreDame_De_Paris.txt 1
effectually	NotreDame_De_Paris.txt 1, Miserables.txt 1
effeminate	Miserables.txt 2
effervescing	NotreDame_De_Paris.txt 1
effet	Miserables.txt 1
efficacious	Miserables.txt 4
efficacy	Miserables.txt 1
effigy	Miserables.txt 3, NotreDame_De_Paris.txt 1
efflorescent	NotreDame_De_Paris.txt 1
effluvia	Miserables.txt 2
effort	Miserables.txt 62, NotreDame_De_Paris.txt 31
efforts	Miserables.txt 22, NotreDame_De_Paris.txt 9
effrontery	Miserables.txt 6, NotreDame_De_Paris.txt 1
effrontry	NotreDame_De_Paris.txt 1
effusion	Miserables.txt 7
effusively	Miserables.txt 1
egad	Miserables.txt 2
egg	NotreDame_De_Paris.txt 6, Miserables.txt 6
eggs	Miserables.txt 6, NotreDame_De_Paris.txt 1
eggshells	NotreDame_De_Paris.txt 1
eglantiers	Miserables.txt 1
eglantines	Miserables.txt 1
egoism	Miserables.txt 1
egoist	Miserables.txt 2
egoists	Miserables.txt 2
egotism	Miserables.txt 12
egotistical	Miserables.txt 3, NotreDame_De_Paris.txt 1
egress	NotreDame_De_Paris.txt 1
egrugeoir	Miserables.txt 1
egypt	NotreDame_De_Paris.txt 39, Miserables.txt 6
egyptian	NotreDame_De_Paris.txt 18, Miserables.txt 1
egyptians	NotreDame_De_Paris.txt 8
egyptienne	Miserables.txt 1
eh	NotreDame_De_Paris.txt 12, Miserables.txt 8
eheu	NotreDame_De_Paris.txt 1
ei	Miserables.txt 2, NotreDame_De_Paris.txt 1
eia	NotreDame_De_Paris.txt 2
eiderdown	NotreDame_De_Paris.txt 1
eight	Miserables.txt 105, NotreDame_De_Paris.txt 23
eighteen	Miserables.txt 15, NotreDame_De_Paris.txt 6
eighteenth	Miserables.txt 20, NotreDame_De_Paris.txt 5
eighth	Miserables.txt 15, NotreDame_De_Paris.txt 3
eighthly	Miserables.txt 1
eighty	Miserables.txt 46, NotreDame_De_Paris.txt 5
ein	NotreDame_De_Paris.txt 1, Miserables.txt 1
either	Miserables.txt 82, NotreDame_De_Paris.txt 23
ejaculated	Miserables.txt 31, NotreDame_De_Paris.txt 1
ejaculation	Miserables.txt 1
ejects	Miserables.txt 1
eke	Miserables.txt 1
eked	Miserables.txt 1
eklinga	NotreDame_De_Paris.txt 2
el	Miserables.txt 1
elaborate	NotreDame_De_Paris.txt 1, Miserables.txt 1
elaborated	NotreDame_De_Paris.txt 1
elapse	Miserables.txt 3
elapsed	Miserables.txt 25, NotreDame_De_Paris.txt 3
elasped	Miserables.txt 1
elasticity	NotreDame_De_Paris.txt 1
elatos	Miserables.txt 1
elba	Miserables.txt 5
elbow	Miserables.txt 29, NotreDame_De_Paris.txt 6
elbowed	Miserables.txt 5, NotreDame_De_Paris.txt 4
elbowing	NotreDame_De_Paris.txt 2, Miserables.txt 1
elbows	Miserables.txt 38, NotreDame_De_Paris.txt 9
elder	Miserables.txt 54, NotreDame_De_Paris.txt 5
elderly	Miserables.txt 13
elders	Miserables.txt 1
eldest	Miserables.txt 17, NotreDame_De_Paris.txt 3
elect	Miserables.txt 4, NotreDame_De_Paris.txt 2
elected	Miserables.txt 7, NotreDame_De_Paris.txt 2
election	NotreDame_De_Paris.txt 2
elections	Miserables.txt 2
elector	Miserables.txt 5, NotreDame_De_Paris.txt 2
electors	NotreDame_De_Paris.txt 4
electress	NotreDame_De_Paris.txt 1
electric	Miserables.txt 10, NotreDame_De_Paris.txt 2
electricity	Miserables.txt 2, NotreDame_De_Paris.txt 1
electrifies	Miserables.txt 2
electronic	NotreDame_De_Paris.txt 27, Miserables.txt 27
electronically	NotreDame_De_Paris.txt 2, Miserables.txt 2
elegance	Miserables.txt 8, NotreDame_De_Paris.txt 3
elegances	Miserables.txt 2
elegant	Miserables.txt 17, NotreDame_De_Paris.txt 3
elegy	Miserables.txt 2
eleison	NotreDame_De_Paris.txt 2
element	Miserables.txt 20, NotreDame_De_Paris.txt 2
elementary	Miserables.txt 2, NotreDame_De_Paris.txt 1
elements	Miserables.txt 13, NotreDame_De_Paris.txt 1
eleonore	Miserables.txt 1
elephant	Miserables.txt 38, NotreDame_De_Paris.txt 4
elephanta	Miserables.txt 1
elephants	NotreDame_De_Paris.txt 2
eleusiac	Miserables.txt 1
elevate	Miserables.txt 2
elevated	Miserables.txt 14, NotreDame_De_Paris.txt 7
elevates	Miserables.txt 1
elevating	Miserables.txt 4, NotreDame_De_Paris.txt 1
elevation	Miserables.txt 13, NotreDame_De_Paris.txt 1
elevations	Miserables.txt 1
eleven	Miserables.txt 21, NotreDame_De_Paris.txt 10
eleventh	NotreDame_De_Paris.txt 5, Miserables.txt 4
elf	NotreDame_De_Paris.txt 1
eli	NotreDame_De_Paris.txt 1
elicited	Miserables.txt 3
eliding	Miserables.txt 1
elijah	Miserables.txt 1
eliminated	Miserables.txt 1
elisabeth	NotreDame_De_Paris.txt 1
elixir	Miserables.txt 4
elixirs	Miserables.txt 1
ell	NotreDame_De_Paris.txt 1
elle	Miserables.txt 10, NotreDame_De_Paris.txt 1
elleviou	Miserables.txt 1
ellipse	Miserables.txt 1
ellipses	Miserables.txt 1
ellipsis	Miserables.txt 1
elliptical	NotreDame_De_Paris.txt 1
elm	Miserables.txt 5
elmire	Miserables.txt 1
elms	Miserables.txt 9
elongated	Miserables.txt 1
eloquence	Miserables.txt 9, NotreDame_De_Paris.txt 3
eloquent	Miserables.txt 8
elot	Miserables.txt 1
eloy	Miserables.txt 2, NotreDame_De_Paris.txt 1
elrey	Miserables.txt 1
else	Miserables.txt 71, NotreDame_De_Paris.txt 21
elsewhere	Miserables.txt 33, NotreDame_De_Paris.txt 7
elucidate	Miserables.txt 3, NotreDame_De_Paris.txt 1
elucidated	Miserables.txt 2
eluded	Miserables.txt 1
elysee	Miserables.txt 1
elysees	Miserables.txt 19
elzevir	Miserables.txt 2
em	Miserables.txt 3
emaciated	NotreDame_De_Paris.txt 3, Miserables.txt 2
emaciation	NotreDame_De_Paris.txt 1, Miserables.txt 1
email	NotreDame_De_Paris.txt 3, Miserables.txt 3
emanate	Miserables.txt 2
emanated	Miserables.txt 4, NotreDame_De_Paris.txt 2
emanates	Miserables.txt 2
emanation	Miserables.txt 2, NotreDame_De_Paris.txt 1
emancipate	NotreDame_De_Paris.txt 1
emancipated	NotreDame_De_Paris.txt 1, Miserables.txt 1
emancipates	NotreDame_De_Paris.txt 1
embalm	Miserables.txt 1
embalmed	Miserables.txt 2
embalming	Miserables.txt 2
embankment	Miserables.txt 1
embark	Miserables.txt 1
embarked	Miserables.txt 2
embarrass	NotreDame_De_Paris.txt 2, Miserables.txt 2
embarrassed	Miserables.txt 20, NotreDame_De_Paris.txt 7
embarrasses	Miserables.txt 2
embarrassing	Miserables.txt 7, NotreDame_De_Paris.txt 1
embarrassment	Miserables.txt 14, NotreDame_De_Paris.txt 6
embarrassments	NotreDame_De_Paris.txt 1
embas	NotreDame_De_Paris.txt 2
embassy	NotreDame_De_Paris.txt 9
embattle	Miserables.txt 1
embattled	Miserables.txt 2, NotreDame_De_Paris.txt 1
embe	Miserables.txt 1
embedded	Miserables.txt 1
embedding	Miserables.txt 1
embellish	NotreDame_De_Paris.txt 1
embellished	NotreDame_De_Paris.txt 2, Miserables.txt 1
embellishments	NotreDame_De_Paris.txt 1
ember	NotreDame_De_Paris.txt 1
embers	Miserables.txt 2
embittered	Miserables.txt 1
emblazoned	Miserables.txt 2
emblem	NotreDame_De_Paris.txt 2
embodied	Miserables.txt 1
emboldened	NotreDame_De_Paris.txt 6, Miserables.txt 2
emboldens	Miserables.txt 1
embossed	NotreDame_De_Paris.txt 1
embouchure	Miserables.txt 1
embrace	Miserables.txt 25, NotreDame_De_Paris.txt 4
embraced	Miserables.txt 13
embraces	Miserables.txt 1
embracing	NotreDame_De_Paris.txt 3
embrasure	Miserables.txt 4, NotreDame_De_Paris.txt 1
embrasures	Miserables.txt 2
embroider	NotreDame_De_Paris.txt 1, Miserables.txt 1
embroidered	NotreDame_De_Paris.txt 12, Miserables.txt 7
embroideress	NotreDame_De_Paris.txt 1
embroideries	NotreDame_De_Paris.txt 2, Miserables.txt 1
embroidering	NotreDame_De_Paris.txt 1, Miserables.txt 1
embroidery	NotreDame_De_Paris.txt 5, Miserables.txt 1
embroiled	Miserables.txt 1
embrun	Miserables.txt 7
embryo	Miserables.txt 2
embryonic	Miserables.txt 3
emen	NotreDame_De_Paris.txt 3
emerald	NotreDame_De_Paris.txt 1
emerge	Miserables.txt 31, NotreDame_De_Paris.txt 4
emerged	Miserables.txt 60, NotreDame_De_Paris.txt 9
emergencies	Miserables.txt 1
emergency	Miserables.txt 1
emerges	Miserables.txt 9, NotreDame_De_Paris.txt 1
emerging	Miserables.txt 24, NotreDame_De_Paris.txt 6
emery	NotreDame_De_Paris.txt 1
emigrants	Miserables.txt 2
emigrated	Miserables.txt 2
emigration	Miserables.txt 2
emigre	Miserables.txt 2
emigree	Miserables.txt 1
eminence	NotreDame_De_Paris.txt 21, Miserables.txt 5
eminent	Miserables.txt 2, NotreDame_De_Paris.txt 1
eminently	NotreDame_De_Paris.txt 1, Miserables.txt 1
emissaries	NotreDame_De_Paris.txt 1
emit	NotreDame_De_Paris.txt 1, Miserables.txt 1
emits	Miserables.txt 2
emitted	Miserables.txt 13
emitting	NotreDame_De_Paris.txt 1, Miserables.txt 1
emotion	Miserables.txt 33, NotreDame_De_Paris.txt 6
emotions	Miserables.txt 25, NotreDame_De_Paris.txt 3
emp	Miserables.txt 1
empereur	Miserables.txt 3
emperor	Miserables.txt 73, NotreDame_De_Paris.txt 14
emperors	Miserables.txt 4, NotreDame_De_Paris.txt 3
emphasis	NotreDame_De_Paris.txt 3, Miserables.txt 1
emphasize	Miserables.txt 3
emphasized	Miserables.txt 3, NotreDame_De_Paris.txt 1
emphasizing	Miserables.txt 5
emphatic	Miserables.txt 1
emphyteuses	Miserables.txt 1
empire	Miserables.txt 42, NotreDame_De_Paris.txt 10
empires	Miserables.txt 2
employ	Miserables.txt 4, NotreDame_De_Paris.txt 1
employed	Miserables.txt 25, NotreDame_De_Paris.txt 5
employee	Miserables.txt 2, NotreDame_De_Paris.txt 1
employees	Miserables.txt 4, NotreDame_De_Paris.txt 2
employing	Miserables.txt 5, NotreDame_De_Paris.txt 1
employment	Miserables.txt 11, NotreDame_De_Paris.txt 1
employments	Miserables.txt 1
employs	Miserables.txt 2
empowered	NotreDame_De_Paris.txt 1
empress	NotreDame_De_Paris.txt 1, Miserables.txt 1
empresses	Miserables.txt 1
emprostathonos	NotreDame_De_Paris.txt 1
emptied	Miserables.txt 9, NotreDame_De_Paris.txt 4
empties	Miserables.txt 5
emptiness	Miserables.txt 1
empty	Miserables.txt 51, NotreDame_De_Paris.txt 27
emptying	Miserables.txt 4
empurpled	Miserables.txt 7
empyrean	Miserables.txt 1
emulation	Miserables.txt 1
emulsions	Miserables.txt 1
en	Miserables.txt 31, NotreDame_De_Paris.txt 8
enable	Miserables.txt 5, NotreDame_De_Paris.txt 1
enabled	NotreDame_De_Paris.txt 2, Miserables.txt 2
enables	Miserables.txt 1
enact	Miserables.txt 1
enacted	NotreDame_De_Paris.txt 2, Miserables.txt 2
enacting	NotreDame_De_Paris.txt 1
enamel	NotreDame_De_Paris.txt 1, Miserables.txt 1
enamelled	NotreDame_De_Paris.txt 1
enamels	NotreDame_De_Paris.txt 1
encamped	Miserables.txt 2
encampment	Miserables.txt 1
encased	NotreDame_De_Paris.txt 4, Miserables.txt 1
enchained	NotreDame_De_Paris.txt 2, Miserables.txt 2
enchant	Miserables.txt 1
enchanted	NotreDame_De_Paris.txt 5, Miserables.txt 4
enchanting	NotreDame_De_Paris.txt 2, Miserables.txt 1
enchantingly	Miserables.txt 1
enchantment	NotreDame_De_Paris.txt 2, Miserables.txt 2
enchantments	Miserables.txt 3
enchantress	NotreDame_De_Paris.txt 3
enchased	NotreDame_De_Paris.txt 1
encircle	Miserables.txt 1
encircled	NotreDame_De_Paris.txt 4, Miserables.txt 1
encircling	Miserables.txt 1
enclose	NotreDame_De_Paris.txt 1, Miserables.txt 1
enclosed	Miserables.txt 10, NotreDame_De_Paris.txt 5
enclosing	Miserables.txt 1
enclosure	Miserables.txt 23, NotreDame_De_Paris.txt 19
enclosures	Miserables.txt 7, NotreDame_De_Paris.txt 2
encompass	Miserables.txt 1
encompassed	Miserables.txt 2
encore	Miserables.txt 1
encounter	Miserables.txt 32, NotreDame_De_Paris.txt 1
encountered	Miserables.txt 53, NotreDame_De_Paris.txt 4
encountering	Miserables.txt 3, NotreDame_De_Paris.txt 2
encounters	Miserables.txt 22, NotreDame_De_Paris.txt 1
encourage	Miserables.txt 2
encouraged	Miserables.txt 9, NotreDame_De_Paris.txt 1
encouragement	Miserables.txt 5, NotreDame_De_Paris.txt 1
encourages	Miserables.txt 1
encouraging	Miserables.txt 4, NotreDame_De_Paris.txt 2
encroach	NotreDame_De_Paris.txt 1
encroached	NotreDame_De_Paris.txt 2, Miserables.txt 1
encroachments	Miserables.txt 2
encumber	Miserables.txt 3
encumbered	Miserables.txt 16, NotreDame_De_Paris.txt 7
encyclopaedia	Miserables.txt 2
encyclopedia	Miserables.txt 2, NotreDame_De_Paris.txt 1
encyclopedists	Miserables.txt 1
end	Miserables.txt 267, NotreDame_De_Paris.txt 106
endeavor	Miserables.txt 3, NotreDame_De_Paris.txt 2
endeavored	NotreDame_De_Paris.txt 5, Miserables.txt 4
endeavoring	Miserables.txt 7, NotreDame_De_Paris.txt 2
endeavors	Miserables.txt 1
ended	Miserables.txt 57, NotreDame_De_Paris.txt 6
ending	Miserables.txt 5, NotreDame_De_Paris.txt 1
endless	Miserables.txt 6, NotreDame_De_Paris.txt 3
endormeurs	Miserables.txt 1
endowed	Miserables.txt 10, NotreDame_De_Paris.txt 3
endroit	Miserables.txt 1
ends	Miserables.txt 26, NotreDame_De_Paris.txt 7
endued	NotreDame_De_Paris.txt 1
endurance	Miserables.txt 1
endure	Miserables.txt 3, NotreDame_De_Paris.txt 1
endured	Miserables.txt 7, NotreDame_De_Paris.txt 4
endures	NotreDame_De_Paris.txt 1, Miserables.txt 1
enduring	NotreDame_De_Paris.txt 1, Miserables.txt 1
enemies	Miserables.txt 6, NotreDame_De_Paris.txt 3
enemy	Miserables.txt 26, NotreDame_De_Paris.txt 4
energetic	Miserables.txt 15
energetically	Miserables.txt 7, NotreDame_De_Paris.txt 2
energia	NotreDame_De_Paris.txt 1
energies	Miserables.txt 1
energy	Miserables.txt 8, NotreDame_De_Paris.txt 1
enervated	NotreDame_De_Paris.txt 1
enervation	Miserables.txt 1
enfants	Miserables.txt 3, NotreDame_De_Paris.txt 1
enfeebled	Miserables.txt 2
enfeeblement	Miserables.txt 1
enfeoffed	NotreDame_De_Paris.txt 1
enfer	Miserables.txt 3, NotreDame_De_Paris.txt 1
enforce	Miserables.txt 1
enforced	Miserables.txt 3
engage	Miserables.txt 5
engaged	Miserables.txt 45, NotreDame_De_Paris.txt 9
engagement	Miserables.txt 5
engagements	Miserables.txt 3
engages	Miserables.txt 1
engaging	NotreDame_De_Paris.txt 1
engendered	Miserables.txt 4
engendering	Miserables.txt 1
engenders	Miserables.txt 4
enghien	Miserables.txt 2
engine	Miserables.txt 4
engineer	Miserables.txt 3
engines	Miserables.txt 2
england	Miserables.txt 60, NotreDame_De_Paris.txt 4
english	Miserables.txt 128, NotreDame_De_Paris.txt 10
englishman	Miserables.txt 4
englishmen	Miserables.txt 1
englishwoman	Miserables.txt 1
engrafted	Miserables.txt 1
engrafting	Miserables.txt 2, NotreDame_De_Paris.txt 1
engraved	NotreDame_De_Paris.txt 7, Miserables.txt 5
engraver	Miserables.txt 1
engraving	Miserables.txt 2, NotreDame_De_Paris.txt 1
engravings	NotreDame_De_Paris.txt 2, Miserables.txt 2
engross	Miserables.txt 1
engrossed	NotreDame_De_Paris.txt 2, Miserables.txt 2
enguerrand	NotreDame_De_Paris.txt 1
engulf	Miserables.txt 1
engulfed	Miserables.txt 17, NotreDame_De_Paris.txt 2
engulfment	Miserables.txt 5
engulfs	Miserables.txt 1
enhanced	Miserables.txt 2
enigma	Miserables.txt 24, NotreDame_De_Paris.txt 1
enigmas	Miserables.txt 6
enigmatic	Miserables.txt 2, NotreDame_De_Paris.txt 1
enigmatical	Miserables.txt 13, NotreDame_De_Paris.txt 1
enim	NotreDame_De_Paris.txt 3
enjoin	Miserables.txt 3
enjoined	Miserables.txt 5, NotreDame_De_Paris.txt 2
enjoining	Miserables.txt 1
enjolras	Miserables.txt 256
enjoy	Miserables.txt 12, NotreDame_De_Paris.txt 1
enjoyed	NotreDame_De_Paris.txt 6, Miserables.txt 6
enjoying	Miserables.txt 3
enjoyment	Miserables.txt 11, NotreDame_De_Paris.txt 2
enjoyments	Miserables.txt 4
enjoys	Miserables.txt 2
enlarge	Miserables.txt 1
enlarged	Miserables.txt 5
enlargement	Miserables.txt 4
enlarges	Miserables.txt 1
enlarging	Miserables.txt 5
enlighten	Miserables.txt 6, NotreDame_De_Paris.txt 1
enlightened	Miserables.txt 10, NotreDame_De_Paris.txt 1
enlightening	Miserables.txt 3
enlightenment	Miserables.txt 8
enlightens	Miserables.txt 1
enlisted	Miserables.txt 2
enlists	Miserables.txt 1
enliven	NotreDame_De_Paris.txt 2
enlivened	Miserables.txt 2, NotreDame_De_Paris.txt 1
enlivens	Miserables.txt 1
enmeshing	NotreDame_De_Paris.txt 1
ennius	Miserables.txt 1
ennui	Miserables.txt 5
enormities	NotreDame_De_Paris.txt 4, Miserables.txt 2
enormity	Miserables.txt 5, NotreDame_De_Paris.txt 2
enormous	Miserables.txt 83, NotreDame_De_Paris.txt 37
enormously	Miserables.txt 2
enough	Miserables.txt 92, NotreDame_De_Paris.txt 29
enrage	Miserables.txt 1
enraged	Miserables.txt 10, NotreDame_De_Paris.txt 3
enraptured	NotreDame_De_Paris.txt 1, Miserables.txt 1
enrich	Miserables.txt 2
enriched	Miserables.txt 6, NotreDame_De_Paris.txt 2
enriching	Miserables.txt 1
enrichments	NotreDame_De_Paris.txt 2
enroll	NotreDame_De_Paris.txt 1
enrolling	Miserables.txt 1
ens	Miserables.txt 1
ensconce	Miserables.txt 1
ensconced	NotreDame_De_Paris.txt 1, Miserables.txt 1
ensemble	Miserables.txt 2, NotreDame_De_Paris.txt 1
ensenas	Miserables.txt 1
enshrined	NotreDame_De_Paris.txt 1
enshrouded	NotreDame_De_Paris.txt 1
ensigns	Miserables.txt 1
ensnared	Miserables.txt 1
ensorcela	Miserables.txt 1
ensued	Miserables.txt 31, NotreDame_De_Paris.txt 7
ensuing	Miserables.txt 1
ensuring	NotreDame_De_Paris.txt 1, Miserables.txt 1
entablature	NotreDame_De_Paris.txt 1, Miserables.txt 1
entablatures	NotreDame_De_Paris.txt 1
entail	Miserables.txt 1
entailed	Miserables.txt 3
entails	Miserables.txt 3
entangle	NotreDame_De_Paris.txt 1, Miserables.txt 1
entangled	Miserables.txt 13, NotreDame_De_Paris.txt 8
entanglement	Miserables.txt 2
entangles	Miserables.txt 1
entangling	Miserables.txt 2, NotreDame_De_Paris.txt 1
entendais	Miserables.txt 1
enter	Miserables.txt 128, NotreDame_De_Paris.txt 36
entered	Miserables.txt 270, NotreDame_De_Paris.txt 30
entering	Miserables.txt 76, NotreDame_De_Paris.txt 9
enterprise	Miserables.txt 4, NotreDame_De_Paris.txt 2
enterprises	NotreDame_De_Paris.txt 1
enterprising	NotreDame_De_Paris.txt 1
enters	Miserables.txt 21, NotreDame_De_Paris.txt 4
entertain	Miserables.txt 3, NotreDame_De_Paris.txt 1
entertained	Miserables.txt 10
entertaining	Miserables.txt 2
entertainment	NotreDame_De_Paris.txt 1
enthusiasm	Miserables.txt 24, NotreDame_De_Paris.txt 8
enthusiasms	Miserables.txt 3
enthusiastic	Miserables.txt 16, NotreDame_De_Paris.txt 2
enthusiastically	NotreDame_De_Paris.txt 1
enthusiasts	Miserables.txt 1
enticed	Miserables.txt 1
entichamber	Miserables.txt 1
enticing	Miserables.txt 2
entire	Miserables.txt 42, NotreDame_De_Paris.txt 29
entirely	Miserables.txt 46, NotreDame_De_Paris.txt 14
entirety	Miserables.txt 3, NotreDame_De_Paris.txt 1
entitle	Miserables.txt 1
entitled	Miserables.txt 11
entity	NotreDame_De_Paris.txt 4, Miserables.txt 3
entr	NotreDame_De_Paris.txt 1, Miserables.txt 1
entrail	Miserables.txt 1
entrails	Miserables.txt 5, NotreDame_De_Paris.txt 1
entrain	Miserables.txt 1
entrance	Miserables.txt 61, NotreDame_De_Paris.txt 28
entrances	Miserables.txt 5, NotreDame_De_Paris.txt 2
entrave	Miserables.txt 1
entre	Miserables.txt 1
entreat	Miserables.txt 7, NotreDame_De_Paris.txt 6
entreated	NotreDame_De_Paris.txt 2
entreating	NotreDame_De_Paris.txt 2, Miserables.txt 2
entreats	Miserables.txt 2
entreaty	Miserables.txt 1
entrenched	Miserables.txt 4
entrenchment	Miserables.txt 2
entresol	Miserables.txt 1
entrusted	Miserables.txt 4
entry	Miserables.txt 9, NotreDame_De_Paris.txt 4
entwining	Miserables.txt 1
enumerated	Miserables.txt 1
enumerating	Miserables.txt 1
enumeration	NotreDame_De_Paris.txt 1
enunciate	NotreDame_De_Paris.txt 1
enunciated	Miserables.txt 1
enunciating	Miserables.txt 1
enunciation	Miserables.txt 2
envelop	Miserables.txt 2
envelope	Miserables.txt 15, NotreDame_De_Paris.txt 9
enveloped	Miserables.txt 31, NotreDame_De_Paris.txt 7
envelopes	Miserables.txt 1
enveloping	Miserables.txt 4, NotreDame_De_Paris.txt 1
envelops	Miserables.txt 3, NotreDame_De_Paris.txt 1
envenomed	NotreDame_De_Paris.txt 2
enviable	Miserables.txt 1
envie	Miserables.txt 1
envied	Miserables.txt 6, NotreDame_De_Paris.txt 2
envious	Miserables.txt 5
environ	Miserables.txt 1
environs	Miserables.txt 7
envola	Miserables.txt 1
envoles	Miserables.txt 1
envoys	NotreDame_De_Paris.txt 4
envy	Miserables.txt 7, NotreDame_De_Paris.txt 3
enwrapped	Miserables.txt 2
enwraps	Miserables.txt 1
eon	Miserables.txt 1
epaulement	Miserables.txt 1
epaulets	Miserables.txt 10
epaulette	Miserables.txt 1
epaulettes	Miserables.txt 1
epee	Miserables.txt 1
epernay	NotreDame_De_Paris.txt 1
ephemeral	Miserables.txt 1
ephesians	Miserables.txt 2
ephestion	Miserables.txt 1
ephesus	NotreDame_De_Paris.txt 1
ephyra	Miserables.txt 1
epic	Miserables.txt 11, NotreDame_De_Paris.txt 1
epics	Miserables.txt 3, NotreDame_De_Paris.txt 1
epicurius	NotreDame_De_Paris.txt 1
epicurus	Miserables.txt 1
epidaurus	NotreDame_De_Paris.txt 1
epidemic	Miserables.txt 4
epidemics	Miserables.txt 1
epidermis	NotreDame_De_Paris.txt 1, Miserables.txt 1
epidotas	Miserables.txt 1
epilepsies	Miserables.txt 1
epilepsy	NotreDame_De_Paris.txt 1
epileptic	Miserables.txt 1
epimenides	Miserables.txt 1
epinard	Miserables.txt 1
epingle	Miserables.txt 2
epiphany	NotreDame_De_Paris.txt 1
epiphonema	Miserables.txt 1
epiphonemas	Miserables.txt 1
episcopal	Miserables.txt 14, NotreDame_De_Paris.txt 1
episcopate	Miserables.txt 2
episcopus	NotreDame_De_Paris.txt 1
episode	Miserables.txt 3, NotreDame_De_Paris.txt 1
episthates	Miserables.txt 2
epistle	Miserables.txt 9, NotreDame_De_Paris.txt 1
epistles	Miserables.txt 1
epistolas	NotreDame_De_Paris.txt 1
epitaph	NotreDame_De_Paris.txt 2, Miserables.txt 1
epitaphium	NotreDame_De_Paris.txt 1
epithalamium	NotreDame_De_Paris.txt 4
epithet	Miserables.txt 2
epithets	Miserables.txt 2
epitogia	NotreDame_De_Paris.txt 1
epoch	Miserables.txt 101, NotreDame_De_Paris.txt 22
epochs	NotreDame_De_Paris.txt 4, Miserables.txt 3
eponine	Miserables.txt 83
epouvente	Miserables.txt 1
equal	Miserables.txt 33, NotreDame_De_Paris.txt 8
equality	Miserables.txt 17
equalled	Miserables.txt 3
equally	Miserables.txt 12, NotreDame_De_Paris.txt 4
equals	Miserables.txt 3
equanimity	Miserables.txt 1
equerries	NotreDame_De_Paris.txt 1
equerry	NotreDame_De_Paris.txt 4
eques	Miserables.txt 1
equestrian	NotreDame_De_Paris.txt 1, Miserables.txt 1
equilibrium	Miserables.txt 8, NotreDame_De_Paris.txt 7
equinoctial	NotreDame_De_Paris.txt 1, Miserables.txt 1
equipage	Miserables.txt 1
equipment	NotreDame_De_Paris.txt 4, Miserables.txt 4
equipped	Miserables.txt 1
equitable	Miserables.txt 3
equitem	NotreDame_De_Paris.txt 1
equity	Miserables.txt 4
equivalent	Miserables.txt 16
equivocal	Miserables.txt 6, NotreDame_De_Paris.txt 1
equivoque	Miserables.txt 2
er	NotreDame_De_Paris.txt 2, Miserables.txt 2
era	Miserables.txt 3, NotreDame_De_Paris.txt 2
eradicated	Miserables.txt 1
eram	NotreDame_De_Paris.txt 1
erase	Miserables.txt 1
erased	Miserables.txt 4
erases	NotreDame_De_Paris.txt 1
erasing	Miserables.txt 2
erasure	Miserables.txt 2
erasures	Miserables.txt 3
erat	NotreDame_De_Paris.txt 1, Miserables.txt 1
ere	Miserables.txt 1
erect	Miserables.txt 68, NotreDame_De_Paris.txt 15
erected	Miserables.txt 12, NotreDame_De_Paris.txt 10
erecting	Miserables.txt 3, NotreDame_De_Paris.txt 1
erection	NotreDame_De_Paris.txt 2, Miserables.txt 1
erects	NotreDame_De_Paris.txt 1
erexit	Miserables.txt 1
ergaphilas	Miserables.txt 1
ergasilus	Miserables.txt 1
erigone	Miserables.txt 1
erlon	Miserables.txt 4
ermine	NotreDame_De_Paris.txt 2, Miserables.txt 2
ermitage	Miserables.txt 1
ermite	Miserables.txt 1
erostatus	NotreDame_De_Paris.txt 1
err	Miserables.txt 3
errais	Miserables.txt 1
errand	Miserables.txt 9
errands	Miserables.txt 1
erras	NotreDame_De_Paris.txt 1
erratum	Miserables.txt 2
erring	Miserables.txt 2
error	Miserables.txt 32, NotreDame_De_Paris.txt 3
errors	Miserables.txt 9, NotreDame_De_Paris.txt 4
errs	Miserables.txt 1
erudimini	Miserables.txt 1
erudite	Miserables.txt 1
erudition	NotreDame_De_Paris.txt 1, Miserables.txt 1
eruption	Miserables.txt 4, NotreDame_De_Paris.txt 2
eruptions	Miserables.txt 3
es	NotreDame_De_Paris.txt 3, Miserables.txt 2
escape	Miserables.txt 106, NotreDame_De_Paris.txt 27
escaped	Miserables.txt 42, NotreDame_De_Paris.txt 24
escapes	Miserables.txt 9, NotreDame_De_Paris.txt 4
escaping	Miserables.txt 10
escarpment	Miserables.txt 8
escarpments	Miserables.txt 2
escaut	Miserables.txt 1
escorcherie	NotreDame_De_Paris.txt 1
escort	NotreDame_De_Paris.txt 7, Miserables.txt 4
escorted	Miserables.txt 5
escorting	NotreDame_De_Paris.txt 1
escoubleau	Miserables.txt 3
escoublon	Miserables.txt 1
escousse	Miserables.txt 1
escutcheons	NotreDame_De_Paris.txt 1
esdras	Miserables.txt 1
esepius	Miserables.txt 1
esmenarda	NotreDame_De_Paris.txt 1
esmeral	NotreDame_De_Paris.txt 1
esmeralda	NotreDame_De_Paris.txt 75
espace	Miserables.txt 1
espadas	NotreDame_De_Paris.txt 1
espalier	Miserables.txt 2
espantar	NotreDame_De_Paris.txt 1
espars	NotreDame_De_Paris.txt 1
especially	NotreDame_De_Paris.txt 21, Miserables.txt 19
espied	Miserables.txt 11, NotreDame_De_Paris.txt 1
esplanade	Miserables.txt 7
esplandian	Miserables.txt 2
espouse	Miserables.txt 1
espouses	Miserables.txt 1
espousing	Miserables.txt 1
esprit	Miserables.txt 5
espy	Miserables.txt 1
espying	NotreDame_De_Paris.txt 1
esquiliae	Miserables.txt 1
esquimaux	Miserables.txt 2
essarts	NotreDame_De_Paris.txt 1
essay	Miserables.txt 1
essayed	Miserables.txt 4
essaying	Miserables.txt 1
essays	Miserables.txt 1
essence	Miserables.txt 3
essences	Miserables.txt 1
essential	Miserables.txt 7
essentially	NotreDame_De_Paris.txt 1, Miserables.txt 1
essling	Miserables.txt 1
est	Miserables.txt 33, NotreDame_De_Paris.txt 21
establish	Miserables.txt 2, NotreDame_De_Paris.txt 1
established	Miserables.txt 40, NotreDame_De_Paris.txt 7
establishes	Miserables.txt 3
establishing	Miserables.txt 3
establishment	Miserables.txt 28
establishments	Miserables.txt 3, NotreDame_De_Paris.txt 1
estaient	Miserables.txt 1
estan	NotreDame_De_Paris.txt 1
estate	Miserables.txt 7
esteem	Miserables.txt 7, NotreDame_De_Paris.txt 4
esteemed	Miserables.txt 4, NotreDame_De_Paris.txt 2
estelle	Miserables.txt 1
estellins	NotreDame_De_Paris.txt 1
estienne	Miserables.txt 2
estimable	Miserables.txt 1
estimate	Miserables.txt 2
estimated	Miserables.txt 2
estimation	Miserables.txt 1
estouteville	NotreDame_De_Paris.txt 13
estrade	NotreDame_De_Paris.txt 5
estrange	Miserables.txt 1
estrangement	Miserables.txt 4
estranging	Miserables.txt 1
estrapade	Miserables.txt 1
et	Miserables.txt 72, NotreDame_De_Paris.txt 34
etagere	Miserables.txt 1
etaient	Miserables.txt 2
etain	Miserables.txt 1
etais	Miserables.txt 2
etait	Miserables.txt 5
etala	Miserables.txt 1
etampes	NotreDame_De_Paris.txt 3
etat	Miserables.txt 4
etc	Miserables.txt 61, NotreDame_De_Paris.txt 18
etching	NotreDame_De_Paris.txt 1
ete	Miserables.txt 1
eternal	Miserables.txt 31, NotreDame_De_Paris.txt 20
eternally	NotreDame_De_Paris.txt 6, Miserables.txt 5
eternity	Miserables.txt 19, NotreDame_De_Paris.txt 5
etext	NotreDame_De_Paris.txt 1
ether	Miserables.txt 2
ethereal	Miserables.txt 1
ethiopia	NotreDame_De_Paris.txt 1
etiam	NotreDame_De_Paris.txt 1
etienne	NotreDame_De_Paris.txt 3, Miserables.txt 3
etiez	Miserables.txt 1
etiolates	Miserables.txt 1
etions	Miserables.txt 1
etiquette	Miserables.txt 2
etoile	Miserables.txt 5, NotreDame_De_Paris.txt 4
etoiles	Miserables.txt 1
etonne	Miserables.txt 1
etrange	Miserables.txt 1
etre	Miserables.txt 4
etruscan	NotreDame_De_Paris.txt 2
etuelde	NotreDame_De_Paris.txt 1
etymologically	Miserables.txt 2
etymologists	Miserables.txt 1
etymology	Miserables.txt 2
euchology	Miserables.txt 1
eucnemos	Miserables.txt 1
eudamidas	Miserables.txt 1
eugene	Miserables.txt 2
eulogium	Miserables.txt 5
eulogy	NotreDame_De_Paris.txt 2
eumenides	Miserables.txt 1
eunuch	Miserables.txt 2
eunuchs	Miserables.txt 1
euphetes	Miserables.txt 1
euphony	Miserables.txt 1
euphorion	Miserables.txt 1
euphrasie	Miserables.txt 14
eura	NotreDame_De_Paris.txt 1
euripides	Miserables.txt 2
euripylus	Miserables.txt 1
europe	Miserables.txt 49, NotreDame_De_Paris.txt 7
european	Miserables.txt 10, NotreDame_De_Paris.txt 1
euryalus	Miserables.txt 1
euryanthe	Miserables.txt 2
eusebius	Miserables.txt 2
eustache	NotreDame_De_Paris.txt 20, Miserables.txt 3
eut	Miserables.txt 1
ev	NotreDame_De_Paris.txt 5
evacuate	Miserables.txt 1
evacuated	Miserables.txt 1
evade	Miserables.txt 1
evaded	Miserables.txt 1
evadne	Miserables.txt 1
evangelical	Miserables.txt 1
evangelists	NotreDame_De_Paris.txt 1
evaporating	NotreDame_De_Paris.txt 1, Miserables.txt 1
evaporation	Miserables.txt 1
evaporations	NotreDame_De_Paris.txt 1
evasions	Miserables.txt 1
eve	Miserables.txt 14, NotreDame_De_Paris.txt 7
even	Miserables.txt 511, NotreDame_De_Paris.txt 127
evening	Miserables.txt 250, NotreDame_De_Paris.txt 50
evenings	Miserables.txt 5
event	Miserables.txt 25, NotreDame_De_Paris.txt 2
eventide	Miserables.txt 2
events	Miserables.txt 54, NotreDame_De_Paris.txt 6
eventual	Miserables.txt 1
eventually	Miserables.txt 11
eveque	Miserables.txt 1
ever	Miserables.txt 127, NotreDame_De_Paris.txt 51
every	Miserables.txt 431, NotreDame_De_Paris.txt 157
everybody	Miserables.txt 20, NotreDame_De_Paris.txt 2
everyone	Miserables.txt 4
everything	Miserables.txt 317, NotreDame_De_Paris.txt 47
everywhere	Miserables.txt 68, NotreDame_De_Paris.txt 18
evidence	Miserables.txt 7
evidences	Miserables.txt 1
evident	Miserables.txt 53, NotreDame_De_Paris.txt 8
evidently	Miserables.txt 68, NotreDame_De_Paris.txt 5
evigilabunt	Miserables.txt 1
evil	Miserables.txt 103, NotreDame_De_Paris.txt 13
evils	NotreDame_De_Paris.txt 1
evocation	Miserables.txt 1
evoe	NotreDame_De_Paris.txt 1
evohe	Miserables.txt 1
evoke	Miserables.txt 3
evoked	Miserables.txt 7, NotreDame_De_Paris.txt 2
evokes	Miserables.txt 3
evoking	NotreDame_De_Paris.txt 1, Miserables.txt 1
evolution	Miserables.txt 4
evolutions	NotreDame_De_Paris.txt 2
evolved	Miserables.txt 2
evolving	Miserables.txt 2
evreus	Miserables.txt 1
evverything	Miserables.txt 1
ex	Miserables.txt 34
exact	Miserables.txt 23
exacted	Miserables.txt 7
exactions	Miserables.txt 1
exactly	Miserables.txt 32, NotreDame_De_Paris.txt 4
exactness	Miserables.txt 3
exaggerate	Miserables.txt 3
exaggerated	Miserables.txt 7, NotreDame_De_Paris.txt 1
exaggerates	Miserables.txt 1
exaggerating	Miserables.txt 4, NotreDame_De_Paris.txt 1
exaggeration	Miserables.txt 6, NotreDame_De_Paris.txt 2
exaggerations	Miserables.txt 4
exaltation	NotreDame_De_Paris.txt 2, Miserables.txt 2
exalted	Miserables.txt 3, NotreDame_De_Paris.txt 1
examination	Miserables.txt 14, NotreDame_De_Paris.txt 5
examinations	Miserables.txt 2, NotreDame_De_Paris.txt 1
examine	Miserables.txt 12, NotreDame_De_Paris.txt 4
examined	Miserables.txt 44, NotreDame_De_Paris.txt 8
examiner	NotreDame_De_Paris.txt 1
examines	Miserables.txt 4, NotreDame_De_Paris.txt 2
examining	Miserables.txt 18, NotreDame_De_Paris.txt 9
example	Miserables.txt 30, NotreDame_De_Paris.txt 6
examples	NotreDame_De_Paris.txt 3, Miserables.txt 3
exarch	Miserables.txt 1
exasperated	Miserables.txt 12, NotreDame_De_Paris.txt 1
exasperates	Miserables.txt 1
exasperating	Miserables.txt 3
exasperation	Miserables.txt 2
exasperations	Miserables.txt 1
exaudisti	NotreDame_De_Paris.txt 1
excavated	Miserables.txt 7, NotreDame_De_Paris.txt 1
excavating	NotreDame_De_Paris.txt 1, Miserables.txt 1
excavation	Miserables.txt 4
excavations	Miserables.txt 4
exceed	Miserables.txt 2, NotreDame_De_Paris.txt 1
exceeded	Miserables.txt 5
exceeding	NotreDame_De_Paris.txt 1
exceedingly	Miserables.txt 2
exceeds	Miserables.txt 1
excellence	Miserables.txt 3
excellences	Miserables.txt 1
excellencies	Miserables.txt 1
excellency	Miserables.txt 1
excellent	Miserables.txt 23, NotreDame_De_Paris.txt 9
excellently	NotreDame_De_Paris.txt 2
except	Miserables.txt 116, NotreDame_De_Paris.txt 31
excepted	NotreDame_De_Paris.txt 1, Miserables.txt 1
excepting	Miserables.txt 1
exception	Miserables.txt 39, NotreDame_De_Paris.txt 14
exceptional	Miserables.txt 3
exceptions	Miserables.txt 4
excepts	NotreDame_De_Paris.txt 1
excess	Miserables.txt 26, NotreDame_De_Paris.txt 4
excesses	Miserables.txt 4
excessive	Miserables.txt 12, NotreDame_De_Paris.txt 2
excessively	NotreDame_De_Paris.txt 1, Miserables.txt 1
exchange	Miserables.txt 16, NotreDame_De_Paris.txt 5
exchanged	Miserables.txt 19, NotreDame_De_Paris.txt 3
exchanges	Miserables.txt 2
exchanging	NotreDame_De_Paris.txt 1, Miserables.txt 1
exchequer	Miserables.txt 1
excitati	NotreDame_De_Paris.txt 1
excite	NotreDame_De_Paris.txt 2, Miserables.txt 1
excited	Miserables.txt 8, NotreDame_De_Paris.txt 4
excitement	Miserables.txt 3
exciting	NotreDame_De_Paris.txt 1
exclaim	Miserables.txt 9, NotreDame_De_Paris.txt 1
exclaimed	Miserables.txt 183, NotreDame_De_Paris.txt 87
exclaiming	Miserables.txt 5, NotreDame_De_Paris.txt 3
exclaims	Miserables.txt 6
exclamation	Miserables.txt 15, NotreDame_De_Paris.txt 7
exclamations	Miserables.txt 2
excluded	Miserables.txt 3
excludes	Miserables.txt 1
exclusion	Miserables.txt 2, NotreDame_De_Paris.txt 1
exclusive	NotreDame_De_Paris.txt 1, Miserables.txt 1
exclusively	Miserables.txt 3, NotreDame_De_Paris.txt 2
excommunicated	Miserables.txt 2
excommunicates	NotreDame_De_Paris.txt 1
exconvict	Miserables.txt 1
excoriated	Miserables.txt 1
excoriations	Miserables.txt 1
excrement	Miserables.txt 1
excrescence	NotreDame_De_Paris.txt 1, Miserables.txt 1
excrescences	Miserables.txt 2, NotreDame_De_Paris.txt 1
excursion	Miserables.txt 1
excursions	Miserables.txt 2
excusable	Miserables.txt 1
excuse	Miserables.txt 19, NotreDame_De_Paris.txt 1
excused	Miserables.txt 2, NotreDame_De_Paris.txt 1
excuses	Miserables.txt 3
excusing	Miserables.txt 1
excutiendo	NotreDame_De_Paris.txt 1
execrable	NotreDame_De_Paris.txt 1, Miserables.txt 1
execrate	Miserables.txt 4
execrated	Miserables.txt 1
execrates	Miserables.txt 2
executatoe	NotreDame_De_Paris.txt 1
execute	Miserables.txt 6, NotreDame_De_Paris.txt 5
executed	Miserables.txt 25, NotreDame_De_Paris.txt 9
executes	Miserables.txt 2, NotreDame_De_Paris.txt 1
executing	NotreDame_De_Paris.txt 4, Miserables.txt 4
execution	Miserables.txt 13, NotreDame_De_Paris.txt 12
executioner	NotreDame_De_Paris.txt 19, Miserables.txt 16
executioners	NotreDame_De_Paris.txt 4, Miserables.txt 1
executions	NotreDame_De_Paris.txt 2, Miserables.txt 1
executive	NotreDame_De_Paris.txt 1, Miserables.txt 1
executoire	Miserables.txt 1
executor	NotreDame_De_Paris.txt 1
executory	Miserables.txt 1
exelmans	Miserables.txt 1
exemplary	NotreDame_De_Paris.txt 1
exempt	Miserables.txt 7, NotreDame_De_Paris.txt 2
exemption	Miserables.txt 1
exempts	Miserables.txt 3
exercise	Miserables.txt 6, NotreDame_De_Paris.txt 3
exercised	Miserables.txt 8
exercises	Miserables.txt 1
exercising	Miserables.txt 1
exerted	Miserables.txt 2
exerting	NotreDame_De_Paris.txt 1, Miserables.txt 1
exertions	NotreDame_De_Paris.txt 2, Miserables.txt 1
exeunte	NotreDame_De_Paris.txt 1
exfoliated	Miserables.txt 1
exhale	Miserables.txt 1
exhaled	Miserables.txt 7, NotreDame_De_Paris.txt 1
exhales	Miserables.txt 4, NotreDame_De_Paris.txt 1
exhaling	Miserables.txt 1
exhaust	Miserables.txt 1
exhausted	Miserables.txt 32, NotreDame_De_Paris.txt 9
exhausting	Miserables.txt 1
exhaustion	Miserables.txt 6, NotreDame_De_Paris.txt 1
exhaustions	Miserables.txt 1
exhausts	Miserables.txt 2
exhibit	Miserables.txt 1
exhibited	Miserables.txt 15, NotreDame_De_Paris.txt 1
exhibiting	NotreDame_De_Paris.txt 1
exhibition	Miserables.txt 1
exhibitions	Miserables.txt 2
exhilarated	Miserables.txt 1
exhilaratingly	NotreDame_De_Paris.txt 1
exhortation	Miserables.txt 2
exhorting	Miserables.txt 1
exigence	Miserables.txt 1
exigencies	Miserables.txt 2
exigency	Miserables.txt 1
exigua	NotreDame_De_Paris.txt 1
exile	Miserables.txt 11, NotreDame_De_Paris.txt 1
exiled	Miserables.txt 4
exiles	Miserables.txt 2
exist	Miserables.txt 51, NotreDame_De_Paris.txt 9
existe	NotreDame_De_Paris.txt 1
existed	Miserables.txt 78, NotreDame_De_Paris.txt 11
existence	Miserables.txt 62, NotreDame_De_Paris.txt 7
existences	Miserables.txt 3
existente	NotreDame_De_Paris.txt 1
existest	Miserables.txt 1
existing	Miserables.txt 3, NotreDame_De_Paris.txt 2
exists	Miserables.txt 58, NotreDame_De_Paris.txt 6
exit	Miserables.txt 13, NotreDame_De_Paris.txt 1
exits	Miserables.txt 3, NotreDame_De_Paris.txt 1
exodus	Miserables.txt 1
exorbitant	Miserables.txt 2, NotreDame_De_Paris.txt 1
exorcised	NotreDame_De_Paris.txt 2
exorcisms	NotreDame_De_Paris.txt 1
exordium	NotreDame_De_Paris.txt 3, Miserables.txt 1
expand	Miserables.txt 1
expanded	Miserables.txt 3, NotreDame_De_Paris.txt 2
expanding	Miserables.txt 4, NotreDame_De_Paris.txt 1
expands	Miserables.txt 4
expanse	NotreDame_De_Paris.txt 2, Miserables.txt 1
expanses	NotreDame_De_Paris.txt 3
expansion	Miserables.txt 3, NotreDame_De_Paris.txt 2
expansively	Miserables.txt 1
expect	Miserables.txt 20, NotreDame_De_Paris.txt 2
expectat	Miserables.txt 2
expectation	Miserables.txt 4
expectations	Miserables.txt 3
expected	Miserables.txt 20, NotreDame_De_Paris.txt 4
expecting	Miserables.txt 14, NotreDame_De_Paris.txt 5
expects	Miserables.txt 3
expedient	Miserables.txt 17, NotreDame_De_Paris.txt 1
expedients	Miserables.txt 6, NotreDame_De_Paris.txt 2
expedition	NotreDame_De_Paris.txt 1, Miserables.txt 1
expeditious	Miserables.txt 2, NotreDame_De_Paris.txt 1
expel	Miserables.txt 2
expelled	Miserables.txt 3, NotreDame_De_Paris.txt 1
expelling	Miserables.txt 1
expels	NotreDame_De_Paris.txt 1
expend	Miserables.txt 3, NotreDame_De_Paris.txt 1
expended	Miserables.txt 2, NotreDame_De_Paris.txt 1
expending	Miserables.txt 2, NotreDame_De_Paris.txt 1
expenditure	Miserables.txt 5, NotreDame_De_Paris.txt 1
expenditures	Miserables.txt 2
expends	Miserables.txt 4, NotreDame_De_Paris.txt 1
expense	Miserables.txt 13, NotreDame_De_Paris.txt 3
expenses	Miserables.txt 21, NotreDame_De_Paris.txt 7
expensive	Miserables.txt 3
experience	Miserables.txt 10, NotreDame_De_Paris.txt 2
experienced	Miserables.txt 38, NotreDame_De_Paris.txt 6
experiences	NotreDame_De_Paris.txt 2, Miserables.txt 2
experiment	Miserables.txt 1
experiments	Miserables.txt 4, NotreDame_De_Paris.txt 1
expert	NotreDame_De_Paris.txt 1
expiated	NotreDame_De_Paris.txt 1, Miserables.txt 1
expiates	Miserables.txt 3
expiation	Miserables.txt 14, NotreDame_De_Paris.txt 1
expiration	Miserables.txt 24, NotreDame_De_Paris.txt 5
expire	NotreDame_De_Paris.txt 2, Miserables.txt 2
expired	Miserables.txt 8, NotreDame_De_Paris.txt 3
expiring	Miserables.txt 2
explain	Miserables.txt 35, NotreDame_De_Paris.txt 15
explained	Miserables.txt 32, NotreDame_De_Paris.txt 6
explaining	Miserables.txt 6, NotreDame_De_Paris.txt 2
explains	Miserables.txt 6, NotreDame_De_Paris.txt 2
explanation	Miserables.txt 23, NotreDame_De_Paris.txt 8
explanations	Miserables.txt 4, NotreDame_De_Paris.txt 2
explicit	Miserables.txt 2, NotreDame_De_Paris.txt 1
explode	NotreDame_De_Paris.txt 1, Miserables.txt 1
exploded	Miserables.txt 1
exploits	Miserables.txt 1
exploration	Miserables.txt 1
explorations	Miserables.txt 1
explore	Miserables.txt 2, NotreDame_De_Paris.txt 1
explored	Miserables.txt 4
exploring	Miserables.txt 2, NotreDame_De_Paris.txt 1
explosion	Miserables.txt 6, NotreDame_De_Paris.txt 2
explosions	Miserables.txt 3
explosively	NotreDame_De_Paris.txt 1, Miserables.txt 1
exporting	NotreDame_De_Paris.txt 1, Miserables.txt 1
expose	Miserables.txt 4, NotreDame_De_Paris.txt 2
exposed	NotreDame_De_Paris.txt 6, Miserables.txt 4
exposes	Miserables.txt 1
exposing	Miserables.txt 1
exposition	NotreDame_De_Paris.txt 1, Miserables.txt 1
exposure	Miserables.txt 2, NotreDame_De_Paris.txt 1
express	Miserables.txt 19, NotreDame_De_Paris.txt 5
expressa	Miserables.txt 1
expressed	Miserables.txt 19, NotreDame_De_Paris.txt 3
expresses	NotreDame_De_Paris.txt 6, Miserables.txt 6
expressing	Miserables.txt 3, NotreDame_De_Paris.txt 1
expression	Miserables.txt 54, NotreDame_De_Paris.txt 29
expressions	NotreDame_De_Paris.txt 3
expressive	Miserables.txt 14, NotreDame_De_Paris.txt 1
expressly	Miserables.txt 10, NotreDame_De_Paris.txt 6
expunged	NotreDame_De_Paris.txt 1
exquisite	Miserables.txt 20, NotreDame_De_Paris.txt 2
exquisitely	Miserables.txt 1
exquisiteness	Miserables.txt 1
exsurge	NotreDame_De_Paris.txt 1
extant	NotreDame_De_Paris.txt 1, Miserables.txt 1
extend	Miserables.txt 7
extended	Miserables.txt 24, NotreDame_De_Paris.txt 11
extending	Miserables.txt 5, NotreDame_De_Paris.txt 1
extends	NotreDame_De_Paris.txt 2, Miserables.txt 2
extension	Miserables.txt 4
extensive	Miserables.txt 2
extensively	NotreDame_De_Paris.txt 1
extent	Miserables.txt 45, NotreDame_De_Paris.txt 12
extenuated	Miserables.txt 1
extenuating	Miserables.txt 3
extenuation	Miserables.txt 2
exteremely	Miserables.txt 1
exterior	Miserables.txt 12, NotreDame_De_Paris.txt 6
exterminate	Miserables.txt 5, NotreDame_De_Paris.txt 3
exterminated	Miserables.txt 6
exterminates	Miserables.txt 2
exterminating	Miserables.txt 2
extermination	Miserables.txt 5, NotreDame_De_Paris.txt 1
exterminators	Miserables.txt 1
external	Miserables.txt 9, NotreDame_De_Paris.txt 8
externally	Miserables.txt 1
externis	Miserables.txt 1
extinct	Miserables.txt 11, NotreDame_De_Paris.txt 2
extinction	Miserables.txt 8
extinguish	Miserables.txt 4, NotreDame_De_Paris.txt 1
extinguished	Miserables.txt 25, NotreDame_De_Paris.txt 10
extinguisher	NotreDame_De_Paris.txt 1, Miserables.txt 1
extinguishes	Miserables.txt 1
extirpate	NotreDame_De_Paris.txt 1
extirpated	Miserables.txt 1
extorted	NotreDame_De_Paris.txt 1
extortionate	Miserables.txt 1
extra	Miserables.txt 4, NotreDame_De_Paris.txt 1
extract	NotreDame_De_Paris.txt 4, Miserables.txt 3
extracted	Miserables.txt 12, NotreDame_De_Paris.txt 2
extracting	NotreDame_De_Paris.txt 2, Miserables.txt 1
extraction	Miserables.txt 1
extractions	Miserables.txt 1
extracts	Miserables.txt 4
extraor	NotreDame_De_Paris.txt 1
extraordinarily	NotreDame_De_Paris.txt 2
extraordinary	Miserables.txt 30, NotreDame_De_Paris.txt 14
extravagance	Miserables.txt 1
extravagant	Miserables.txt 3, NotreDame_De_Paris.txt 2
extravaganzas	Miserables.txt 1
extreme	Miserables.txt 34, NotreDame_De_Paris.txt 6
extremely	Miserables.txt 24, NotreDame_De_Paris.txt 4
extremes	Miserables.txt 5, NotreDame_De_Paris.txt 2
extremest	NotreDame_De_Paris.txt 1, Miserables.txt 1
extremities	Miserables.txt 11, NotreDame_De_Paris.txt 5
extremity	Miserables.txt 45, NotreDame_De_Paris.txt 13
extricate	NotreDame_De_Paris.txt 1, Miserables.txt 1
extricated	Miserables.txt 9
extricates	NotreDame_De_Paris.txt 1
extricating	NotreDame_De_Paris.txt 4, Miserables.txt 3
extrication	Miserables.txt 1
exuberance	Miserables.txt 1
exuded	Miserables.txt 1
exultation	NotreDame_De_Paris.txt 1
eye	Miserables.txt 134, NotreDame_De_Paris.txt 110
eyeballs	Miserables.txt 1
eyebrow	NotreDame_De_Paris.txt 1
eyebrows	Miserables.txt 4, NotreDame_De_Paris.txt 2
eyed	NotreDame_De_Paris.txt 14, Miserables.txt 4
eyeing	Miserables.txt 1
eyelashes	Miserables.txt 3, NotreDame_De_Paris.txt 1
eyelet	Miserables.txt 1
eyelid	Miserables.txt 1
eyelids	Miserables.txt 11, NotreDame_De_Paris.txt 7
eyes	Miserables.txt 538, NotreDame_De_Paris.txt 242
eyesight	Miserables.txt 1
eylau	Miserables.txt 1
eyries	Miserables.txt 1
ezekiel	Miserables.txt 1
