r	Miserables.txt 7
rabbinical	Miserables.txt 1
rabbinicum	Miserables.txt 1
rabbit	Miserables.txt 3
rabbits	Miserables.txt 1
rabble	Miserables.txt 15
rabelais	Miserables.txt 4
rabellais	Miserables.txt 1
rabouin	Miserables.txt 4
race	Miserables.txt 68
races	Miserables.txt 7
racine	Miserables.txt 5
racing	Miserables.txt 2
rack	Miserables.txt 1
racket	Miserables.txt 1
radcliffe	Miserables.txt 1
radiance	Miserables.txt 37
radiances	Miserables.txt 3
radiant	Miserables.txt 36
radiantly	Miserables.txt 1
radiate	Miserables.txt 1
radiated	Miserables.txt 2
radiating	Miserables.txt 1
radiation	Miserables.txt 2
radiations	Miserables.txt 1
radish	Miserables.txt 1
raffermir	Miserables.txt 1
raft	Miserables.txt 3
rafters	Miserables.txt 1
rafts	Miserables.txt 1
rag	Miserables.txt 30
rage	Miserables.txt 38
raged	Miserables.txt 1
rages	Miserables.txt 1
ragged	Miserables.txt 14
raging	Miserables.txt 9
ragpicker	Miserables.txt 1
ragpickers	Miserables.txt 1
rags	Miserables.txt 59
raid	Miserables.txt 2
raiding	Miserables.txt 1
railed	Miserables.txt 1
railing	Miserables.txt 10
railings	Miserables.txt 1
raille	Miserables.txt 1
raillery	Miserables.txt 3
railles	Miserables.txt 1
railroads	Miserables.txt 1
rails	Miserables.txt 2
railway	Miserables.txt 5
rain	Miserables.txt 73
rained	Miserables.txt 13
raining	Miserables.txt 12
rains	Miserables.txt 13
rainstorm	Miserables.txt 2
rainy	Miserables.txt 2
raise	Miserables.txt 29
raised	Miserables.txt 159
raises	Miserables.txt 3
raisin	Miserables.txt 1
raising	Miserables.txt 27
raisons	Miserables.txt 1
rallied	Miserables.txt 10
rallies	Miserables.txt 1
rally	Miserables.txt 1
rallying	Miserables.txt 5
ram	Miserables.txt 4
ramble	Miserables.txt 1
rambled	Miserables.txt 1
rambler	Miserables.txt 3
rambouillet	Miserables.txt 1
rambuteau	Miserables.txt 4
rameau	Miserables.txt 1
ramification	Miserables.txt 1
ramifications	Miserables.txt 6
ramified	Miserables.txt 1
ramillies	Miserables.txt 1
ramis	Miserables.txt 1
rampart	Miserables.txt 3
ramponneau	Miserables.txt 1
ramrods	Miserables.txt 1
ramshackle	Miserables.txt 2
ramus	Miserables.txt 1
ran	Miserables.txt 80
rancid	Miserables.txt 1
rancor	Miserables.txt 6
rancors	Miserables.txt 1
random	Miserables.txt 20
rang	Miserables.txt 13
range	Miserables.txt 6
ranged	Miserables.txt 9
ranges	Miserables.txt 1
ranging	Miserables.txt 1
rangling	Miserables.txt 1
rank	Miserables.txt 11
ranked	Miserables.txt 1
ranks	Miserables.txt 22
ransacking	Miserables.txt 2
raoul	Miserables.txt 2
rap	Miserables.txt 1
rapee	Miserables.txt 3
raphael	Miserables.txt 2
rapid	Miserables.txt 31
rapidity	Miserables.txt 4
rapidly	Miserables.txt 47
rapids	Miserables.txt 1
rapin	Miserables.txt 1
rapine	Miserables.txt 2
rapped	Miserables.txt 3
rappelez	Miserables.txt 1
rappelles	Miserables.txt 1
rapture	Miserables.txt 5
rapturous	Miserables.txt 2
rare	Miserables.txt 50
rarely	Miserables.txt 15
rarest	Miserables.txt 1
rarity	Miserables.txt 4
ras	Miserables.txt 2
rascal	Miserables.txt 20
rascalion	Miserables.txt 1
rascalities	Miserables.txt 1
rascality	Miserables.txt 1
rascally	Miserables.txt 3
rascals	Miserables.txt 14
rat	Miserables.txt 8
rate	Miserables.txt 9
rated	Miserables.txt 1
rates	Miserables.txt 1
rather	Miserables.txt 160
ratichon	Miserables.txt 1
ratiocinate	Miserables.txt 1
rational	Miserables.txt 1
ratisbon	Miserables.txt 1
rats	Miserables.txt 12
rattan	Miserables.txt 1
rattle	Miserables.txt 17
rattled	Miserables.txt 4
rattles	Miserables.txt 1
rattling	Miserables.txt 9
raux	Miserables.txt 1
ravaged	Miserables.txt 1
ravages	Miserables.txt 5
ravaging	Miserables.txt 1
raved	Miserables.txt 1
raven	Miserables.txt 1
ravine	Miserables.txt 10
ravined	Miserables.txt 1
ravines	Miserables.txt 2
raving	Miserables.txt 3
ravished	Miserables.txt 1
ravishing	Miserables.txt 8
ravissait	Miserables.txt 1
ravissants	Miserables.txt 1
raw	Miserables.txt 7
ray	Miserables.txt 31
raynal	Miserables.txt 1
rays	Miserables.txt 17
razes	Miserables.txt 1
razor	Miserables.txt 2
re	Miserables.txt 107
reach	Miserables.txt 49
reached	Miserables.txt 154
reaches	Miserables.txt 10
reaching	Miserables.txt 17
reacted	Miserables.txt 1
reaction	Miserables.txt 6
read	Miserables.txt 152
readable	Miserables.txt 2
reader	Miserables.txt 133
readers	Miserables.txt 5
readest	Miserables.txt 2
readily	Miserables.txt 9
readiness	Miserables.txt 8
reading	Miserables.txt 33
reads	Miserables.txt 1
ready	Miserables.txt 53
reagents	Miserables.txt 1
real	Miserables.txt 73
realities	Miserables.txt 22
reality	Miserables.txt 45
realizations	Miserables.txt 1
realize	Miserables.txt 6
realized	Miserables.txt 13
realizes	Miserables.txt 3
really	Miserables.txt 100
realm	Miserables.txt 4
reanimated	Miserables.txt 3
reaped	Miserables.txt 1
reappear	Miserables.txt 10
reappearance	Miserables.txt 2
reappeared	Miserables.txt 11
reappears	Miserables.txt 6
rear	Miserables.txt 39
reared	Miserables.txt 10
rearguard	Miserables.txt 1
rearing	Miserables.txt 2
rears	Miserables.txt 2
reason	Miserables.txt 70
reasonable	Miserables.txt 6
reasoned	Miserables.txt 3
reasoning	Miserables.txt 11
reasons	Miserables.txt 32
reasserts	Miserables.txt 2
reassume	Miserables.txt 1
reassurance	Miserables.txt 1
reassure	Miserables.txt 1
reassured	Miserables.txt 18
reassuring	Miserables.txt 6
reawakening	Miserables.txt 1
rebellion	Miserables.txt 10
rebellions	Miserables.txt 1
rebellious	Miserables.txt 3
rebels	Miserables.txt 1
rebless	Miserables.txt 1
rebound	Miserables.txt 3
rebounded	Miserables.txt 4
rebounding	Miserables.txt 1
rebounds	Miserables.txt 1
rebuffed	Miserables.txt 1
rebuild	Miserables.txt 1
rebuilt	Miserables.txt 1
rebuke	Miserables.txt 1
rebus	Miserables.txt 3
rebuses	Miserables.txt 1
rebuttoned	Miserables.txt 1
recall	Miserables.txt 29
recalled	Miserables.txt 35
recalling	Miserables.txt 6
recalls	Miserables.txt 6
recamier	Miserables.txt 1
recantations	Miserables.txt 1
recapitulation	Miserables.txt 1
recapture	Miserables.txt 1
recaptured	Miserables.txt 8
recast	Miserables.txt 1
receded	Miserables.txt 2
receipt	Miserables.txt 6
receipts	Miserables.txt 2
receive	Miserables.txt 43
received	Miserables.txt 108
receiver	Miserables.txt 1
receives	Miserables.txt 6
receiving	Miserables.txt 9
recent	Miserables.txt 6
recently	Miserables.txt 21
receptacle	Miserables.txt 1
reception	Miserables.txt 3
receptions	Miserables.txt 1
recess	Miserables.txt 10
recesses	Miserables.txt 3
recipes	Miserables.txt 1
reciprocal	Miserables.txt 2
reciprocally	Miserables.txt 1
reciprocle	Miserables.txt 1
recital	Miserables.txt 2
recite	Miserables.txt 1
reckless	Miserables.txt 1
reckon	Miserables.txt 3
reckoned	Miserables.txt 8
reckoning	Miserables.txt 7
reckons	Miserables.txt 1
reclaim	Miserables.txt 1
reclining	Miserables.txt 3
reclosed	Miserables.txt 1
recluses	Miserables.txt 2
recognition	Miserables.txt 6
recognizable	Miserables.txt 10
recognize	Miserables.txt 67
recognized	Miserables.txt 101
recognizes	Miserables.txt 4
recognizing	Miserables.txt 11
recoil	Miserables.txt 6
recoiled	Miserables.txt 24
recollect	Miserables.txt 6
recollected	Miserables.txt 2
recollection	Miserables.txt 9
recollections	Miserables.txt 3
recommence	Miserables.txt 2
recommenced	Miserables.txt 2
recommend	Miserables.txt 3
recommendation	Miserables.txt 5
recommended	Miserables.txt 7
recommending	Miserables.txt 1
recommends	Miserables.txt 2
recommitted	Miserables.txt 1
recompense	Miserables.txt 10
recompensed	Miserables.txt 3
recomposition	Miserables.txt 1
reconcile	Miserables.txt 1
reconciled	Miserables.txt 3
reconciliation	Miserables.txt 3
reconciling	Miserables.txt 2
reconnaisance	Miserables.txt 1
reconnaissance	Miserables.txt 1
reconnoitre	Miserables.txt 4
reconstitute	Miserables.txt 1
reconstituted	Miserables.txt 1
reconstruct	Miserables.txt 1
reconstructed	Miserables.txt 3
reconstructing	Miserables.txt 1
reconstruction	Miserables.txt 1
reconstructions	Miserables.txt 2
reconstructs	Miserables.txt 2
record	Miserables.txt 4
recorded	Miserables.txt 2
recording	Miserables.txt 2
records	Miserables.txt 2
recount	Miserables.txt 1
recounted	Miserables.txt 1
recourse	Miserables.txt 7
recover	Miserables.txt 10
recovered	Miserables.txt 19
recovering	Miserables.txt 5
recovers	Miserables.txt 2
recreation	Miserables.txt 8
recrudescence	Miserables.txt 4
recruit	Miserables.txt 3
recruited	Miserables.txt 3
recruiting	Miserables.txt 1
recruits	Miserables.txt 7
rectangle	Miserables.txt 1
rectification	Miserables.txt 1
rectified	Miserables.txt 2
rectifying	Miserables.txt 1
rectilinear	Miserables.txt 7
rectitude	Miserables.txt 2
rector	Miserables.txt 1
recumbent	Miserables.txt 1
recur	Miserables.txt 8
recurred	Miserables.txt 16
recurrence	Miserables.txt 1
recurring	Miserables.txt 1
red	Miserables.txt 134
redan	Miserables.txt 1
redans	Miserables.txt 1
redbreast	Miserables.txt 1
redbreasts	Miserables.txt 1
reddened	Miserables.txt 3
reddening	Miserables.txt 1
reddest	Miserables.txt 1
reddish	Miserables.txt 10
redeem	Miserables.txt 1
redeems	Miserables.txt 1
redhaired	Miserables.txt 1
redistribute	Miserables.txt 1
redistributing	Miserables.txt 2
redistribution	Miserables.txt 2
redivivus	Miserables.txt 1
redly	Miserables.txt 1
redouble	Miserables.txt 1
redoubled	Miserables.txt 23
redoubling	Miserables.txt 2
redoubt	Miserables.txt 33
redoubtable	Miserables.txt 21
redoubts	Miserables.txt 2
redress	Miserables.txt 2
reds	Miserables.txt 3
reduced	Miserables.txt 14
reducible	Miserables.txt 1
reduction	Miserables.txt 4
reed	Miserables.txt 5
reef	Miserables.txt 2
reefs	Miserables.txt 1
reeks	Miserables.txt 1
reel	Miserables.txt 1
reeled	Miserables.txt 2
reeling	Miserables.txt 2
refait	Miserables.txt 1
refectory	Miserables.txt 7
refer	Miserables.txt 3
reference	Miserables.txt 5
references	Miserables.txt 3
referred	Miserables.txt 5
refers	Miserables.txt 1
refilled	Miserables.txt 1
refilling	Miserables.txt 1
refine	Miserables.txt 1
refined	Miserables.txt 1
refinement	Miserables.txt 1
refinements	Miserables.txt 2
reflect	Miserables.txt 15
reflected	Miserables.txt 38
reflecting	Miserables.txt 4
reflection	Miserables.txt 45
reflections	Miserables.txt 13
reflects	Miserables.txt 1
refoncez	Miserables.txt 1
reform	Miserables.txt 1
reformed	Miserables.txt 2
reformer	Miserables.txt 1
reformers	Miserables.txt 1
reforms	Miserables.txt 1
refractory	Miserables.txt 5
refrain	Miserables.txt 32
refrained	Miserables.txt 1
refrains	Miserables.txt 3
refresh	Miserables.txt 1
refuge	Miserables.txt 37
refugees	Miserables.txt 2
refuges	Miserables.txt 2
refund	Miserables.txt 10
refurnish	Miserables.txt 1
refusal	Miserables.txt 8
refuse	Miserables.txt 17
refused	Miserables.txt 34
refuses	Miserables.txt 5
refusing	Miserables.txt 5
refuting	Miserables.txt 1
regain	Miserables.txt 4
regained	Miserables.txt 20
regaining	Miserables.txt 3
regains	Miserables.txt 1
regale	Miserables.txt 1
regard	Miserables.txt 28
regarded	Miserables.txt 18
regardez	Miserables.txt 1
regarding	Miserables.txt 6
regards	Miserables.txt 5
regency	Miserables.txt 1
regenerated	Miserables.txt 1
regent	Miserables.txt 1
regia	Miserables.txt 1
regicide	Miserables.txt 4
regicides	Miserables.txt 3
regild	Miserables.txt 2
regilded	Miserables.txt 1
regime	Miserables.txt 11
regiment	Miserables.txt 26
regimentals	Miserables.txt 1
regiments	Miserables.txt 17
region	Miserables.txt 9
regions	Miserables.txt 10
register	Miserables.txt 1
registered	Miserables.txt 2
registers	Miserables.txt 2
registry	Miserables.txt 1
regnier	Miserables.txt 3
regret	Miserables.txt 22
regretfully	Miserables.txt 1
regrets	Miserables.txt 1
regrettable	Miserables.txt 1
regretted	Miserables.txt 10
regrettedest	Miserables.txt 1
regretting	Miserables.txt 1
reguise	Miserables.txt 1
regular	Miserables.txt 27
regularity	Miserables.txt 4
regularly	Miserables.txt 6
regulas	Miserables.txt 1
regulate	Miserables.txt 1
regulated	Miserables.txt 10
regulates	Miserables.txt 2
regulating	Miserables.txt 3
regulation	Miserables.txt 5
regulations	Miserables.txt 13
rehabilitated	Miserables.txt 1
rehabilitation	Miserables.txt 2
rehung	Miserables.txt 1
reichenau	Miserables.txt 1
reichstadt	Miserables.txt 1
reign	Miserables.txt 18
reigned	Miserables.txt 24
reigning	Miserables.txt 9
reigns	Miserables.txt 9
reille	Miserables.txt 6
reims	Miserables.txt 2
rein	Miserables.txt 1
reinforce	Miserables.txt 1
reinforced	Miserables.txt 1
reinforcement	Miserables.txt 3
reinforcements	Miserables.txt 5
reject	Miserables.txt 8
rejected	Miserables.txt 7
rejecting	Miserables.txt 2
rejects	Miserables.txt 2
rejoice	Miserables.txt 1
rejoiced	Miserables.txt 1
rejoices	Miserables.txt 1
rejoicing	Miserables.txt 1
rejoicings	Miserables.txt 1
rejoin	Miserables.txt 1
rejoinder	Miserables.txt 1
rejoined	Miserables.txt 5
rejuvenation	Miserables.txt 1
relapse	Miserables.txt 1
relapsed	Miserables.txt 5
relapses	Miserables.txt 1
relate	Miserables.txt 12
related	Miserables.txt 14
relates	Miserables.txt 3
relating	Miserables.txt 11
relation	Miserables.txt 5
relations	Miserables.txt 10
relationship	Miserables.txt 3
relationships	Miserables.txt 1
relative	Miserables.txt 9
relatively	Miserables.txt 1
relatives	Miserables.txt 14
relax	Miserables.txt 2
relaxation	Miserables.txt 1
relaxed	Miserables.txt 3
relaxing	Miserables.txt 1
relay	Miserables.txt 2
relays	Miserables.txt 3
release	Miserables.txt 9
released	Miserables.txt 25
releasing	Miserables.txt 5
relegated	Miserables.txt 1
relic	Miserables.txt 8
relics	Miserables.txt 3
relied	Miserables.txt 2
relief	Miserables.txt 11
reliefs	Miserables.txt 1
relieve	Miserables.txt 5
relieved	Miserables.txt 12
relieves	Miserables.txt 1
relieving	Miserables.txt 1
relighted	Miserables.txt 1
religion	Miserables.txt 34
religionists	Miserables.txt 1
religions	Miserables.txt 5
religious	Miserables.txt 27
religiously	Miserables.txt 5
relinquish	Miserables.txt 1
relinquishes	Miserables.txt 1
reliquaries	Miserables.txt 1
reliquary	Miserables.txt 1
reload	Miserables.txt 1
reloaded	Miserables.txt 1
reloading	Miserables.txt 2
remain	Miserables.txt 93
remainder	Miserables.txt 7
remained	Miserables.txt 239
remaining	Miserables.txt 21
remains	Miserables.txt 43
remark	Miserables.txt 55
remarkable	Miserables.txt 19
remarked	Miserables.txt 26
remarks	Miserables.txt 13
rembrandt	Miserables.txt 1
remedies	Miserables.txt 1
remedy	Miserables.txt 6
remember	Miserables.txt 52
remembered	Miserables.txt 43
remembering	Miserables.txt 1
remembers	Miserables.txt 1
remind	Miserables.txt 10
reminded	Miserables.txt 3
reminder	Miserables.txt 1
reminiscences	Miserables.txt 1
remittances	Miserables.txt 1
remitted	Miserables.txt 1
remnant	Miserables.txt 8
remnants	Miserables.txt 2
remonstrance	Miserables.txt 1
remonstrances	Miserables.txt 2
remorse	Miserables.txt 8
remote	Miserables.txt 4
remotest	Miserables.txt 1
remoto	Miserables.txt 2
remount	Miserables.txt 1
removal	Miserables.txt 3
remove	Miserables.txt 7
removed	Miserables.txt 31
removes	Miserables.txt 3
removing	Miserables.txt 5
renamed	Miserables.txt 1
renard	Miserables.txt 4
rend	Miserables.txt 3
render	Miserables.txt 41
rendered	Miserables.txt 84
rendering	Miserables.txt 10
renders	Miserables.txt 12
rendez	Miserables.txt 2
rendezvous	Miserables.txt 6
rending	Miserables.txt 11
rends	Miserables.txt 2
renee	Miserables.txt 1
renew	Miserables.txt 2
renewed	Miserables.txt 6
renounce	Miserables.txt 8
renounced	Miserables.txt 5
renouncing	Miserables.txt 4
renown	Miserables.txt 7
renowned	Miserables.txt 2
rent	Miserables.txt 30
rentre	Miserables.txt 1
rents	Miserables.txt 4
renunciation	Miserables.txt 7
renunciations	Miserables.txt 1
reorganization	Miserables.txt 1
repaid	Miserables.txt 3
repair	Miserables.txt 4
repaired	Miserables.txt 7
repairing	Miserables.txt 4
repairs	Miserables.txt 3
reparation	Miserables.txt 10
repassed	Miserables.txt 1
repast	Miserables.txt 4
repasts	Miserables.txt 2
repaving	Miserables.txt 1
repay	Miserables.txt 4
repeat	Miserables.txt 31
repeated	Miserables.txt 58
repeatedly	Miserables.txt 2
repeating	Miserables.txt 5
repeats	Miserables.txt 3
repelled	Miserables.txt 3
repentance	Miserables.txt 5
repentant	Miserables.txt 1
repented	Miserables.txt 1
repertory	Miserables.txt 8
repete	Miserables.txt 1
repetition	Miserables.txt 2
repetitions	Miserables.txt 1
replace	Miserables.txt 13
replaced	Miserables.txt 32
replacement	Miserables.txt 5
replaces	Miserables.txt 6
replacing	Miserables.txt 3
replied	Miserables.txt 309
replies	Miserables.txt 15
reply	Miserables.txt 81
replying	Miserables.txt 19
repondu	Miserables.txt 1
report	Miserables.txt 29
reported	Miserables.txt 7
reports	Miserables.txt 8
repose	Miserables.txt 27
reposes	Miserables.txt 2
reposing	Miserables.txt 1
reprends	Miserables.txt 1
represent	Miserables.txt 6
representation	Miserables.txt 1
representations	Miserables.txt 3
representative	Miserables.txt 7
represented	Miserables.txt 30
representing	Miserables.txt 4
represents	Miserables.txt 4
repress	Miserables.txt 5
repressed	Miserables.txt 8
repression	Miserables.txt 7
reprimand	Miserables.txt 2
reprinted	Miserables.txt 1
reprisal	Miserables.txt 1
reprisals	Miserables.txt 3
reproach	Miserables.txt 19
reproached	Miserables.txt 8
reproaches	Miserables.txt 5
reproachful	Miserables.txt 1
reproaching	Miserables.txt 2
reprobation	Miserables.txt 1
reproduce	Miserables.txt 4
reproduced	Miserables.txt 5
reprove	Miserables.txt 1
reproved	Miserables.txt 4
reptile	Miserables.txt 1
reptitalmus	Miserables.txt 1
republic	Miserables.txt 51
republican	Miserables.txt 11
republicans	Miserables.txt 8
republics	Miserables.txt 4
repudiate	Miserables.txt 1
repudiated	Miserables.txt 1
repugnance	Miserables.txt 2
repugnant	Miserables.txt 7
repulse	Miserables.txt 1
repulsed	Miserables.txt 6
repulsing	Miserables.txt 1
repulsive	Miserables.txt 14
repulsiveness	Miserables.txt 1
reputation	Miserables.txt 7
reputations	Miserables.txt 3
repute	Miserables.txt 3
reputed	Miserables.txt 3
request	Miserables.txt 10
requested	Miserables.txt 6
requesting	Miserables.txt 1
requests	Miserables.txt 1
requiem	Miserables.txt 1
requiescant	Miserables.txt 2
requiescat	Miserables.txt 1
require	Miserables.txt 17
required	Miserables.txt 60
requirement	Miserables.txt 1
requirements	Miserables.txt 11
requires	Miserables.txt 4
requiring	Miserables.txt 1
requisite	Miserables.txt 8
requisites	Miserables.txt 1
requisition	Miserables.txt 2
requite	Miserables.txt 1
requited	Miserables.txt 1
requiting	Miserables.txt 1
res	Miserables.txt 3
rescue	Miserables.txt 6
rescued	Miserables.txt 5
rescuer	Miserables.txt 1
rescuing	Miserables.txt 3
research	Miserables.txt 2
researches	Miserables.txt 9
reseated	Miserables.txt 1
resemblance	Miserables.txt 15
resemblances	Miserables.txt 1
resemble	Miserables.txt 25
resembled	Miserables.txt 71
resembles	Miserables.txt 37
resemblest	Miserables.txt 1
resembling	Miserables.txt 14
resentful	Miserables.txt 1
reservation	Miserables.txt 2
reservations	Miserables.txt 2
reserve	Miserables.txt 12
reserved	Miserables.txt 21
reserves	Miserables.txt 5
reserving	Miserables.txt 3
reservoir	Miserables.txt 2
reside	Miserables.txt 1
resided	Miserables.txt 2
residence	Miserables.txt 12
resident	Miserables.txt 1
residuum	Miserables.txt 1
resign	Miserables.txt 4
resignation	Miserables.txt 11
resigned	Miserables.txt 5
resigning	Miserables.txt 1
resin	Miserables.txt 4
resinous	Miserables.txt 1
resist	Miserables.txt 14
resistance	Miserables.txt 22
resistances	Miserables.txt 3
resisted	Miserables.txt 12
resisting	Miserables.txt 5
resists	Miserables.txt 4
resolute	Miserables.txt 7
resolutely	Miserables.txt 17
resolution	Miserables.txt 20
resolutions	Miserables.txt 4
resolve	Miserables.txt 8
resolved	Miserables.txt 14
resolves	Miserables.txt 1
resort	Miserables.txt 2
resounded	Miserables.txt 5
resounding	Miserables.txt 1
resource	Miserables.txt 10
resources	Miserables.txt 11
respect	Miserables.txt 70
respectability	Miserables.txt 2
respectable	Miserables.txt 19
respected	Miserables.txt 10
respectful	Miserables.txt 19
respectfully	Miserables.txt 5
respecting	Miserables.txt 2
respective	Miserables.txt 1
respects	Miserables.txt 7
respirable	Miserables.txt 2
respiration	Miserables.txt 10
respite	Miserables.txt 6
resplendent	Miserables.txt 5
responded	Miserables.txt 23
responding	Miserables.txt 2
responds	Miserables.txt 2
response	Miserables.txt 4
responsibility	Miserables.txt 3
responsible	Miserables.txt 8
rest	Miserables.txt 126
restai	Miserables.txt 1
restaurant	Miserables.txt 6
reste	Miserables.txt 2
rested	Miserables.txt 29
restif	Miserables.txt 1
resting	Miserables.txt 24
restitution	Miserables.txt 5
restive	Miserables.txt 1
restless	Miserables.txt 2
restoration	Miserables.txt 26
restore	Miserables.txt 7
restored	Miserables.txt 14
restores	Miserables.txt 4
restoring	Miserables.txt 3
restrain	Miserables.txt 6
restrained	Miserables.txt 6
restrict	Miserables.txt 1
restricted	Miserables.txt 8
restriction	Miserables.txt 3
restrictions	Miserables.txt 3
rests	Miserables.txt 7
result	Miserables.txt 52
resulted	Miserables.txt 6
resulting	Miserables.txt 2
results	Miserables.txt 22
resume	Miserables.txt 5
resumed	Miserables.txt 168
resumes	Miserables.txt 1
resuming	Miserables.txt 2
resurrection	Miserables.txt 7
resuscitate	Miserables.txt 1
resuscitated	Miserables.txt 2
resuscitating	Miserables.txt 1
retail	Miserables.txt 1
retain	Miserables.txt 8
retained	Miserables.txt 14
retaining	Miserables.txt 2
retains	Miserables.txt 2
retaken	Miserables.txt 1
retaliation	Miserables.txt 1
retard	Miserables.txt 1
retarded	Miserables.txt 3
retarding	Miserables.txt 1
reticence	Miserables.txt 1
retinue	Miserables.txt 1
retire	Miserables.txt 10
retired	Miserables.txt 30
retirement	Miserables.txt 1
retires	Miserables.txt 1
retiring	Miserables.txt 2
retort	Miserables.txt 7
retorted	Miserables.txt 46
retorting	Miserables.txt 1
retorts	Miserables.txt 1
retourner	Miserables.txt 1
retrace	Miserables.txt 7
retraced	Miserables.txt 12
retracing	Miserables.txt 2
retract	Miserables.txt 3
retreat	Miserables.txt 33
retreated	Miserables.txt 34
retreating	Miserables.txt 16
retreats	Miserables.txt 3
retrench	Miserables.txt 1
retrenching	Miserables.txt 1
retro	Miserables.txt 1
retrocedes	Miserables.txt 1
retrograde	Miserables.txt 1
retrograding	Miserables.txt 1
retrospective	Miserables.txt 1
retrospectively	Miserables.txt 1
return	Miserables.txt 124
returned	Miserables.txt 182
returning	Miserables.txt 26
returns	Miserables.txt 20
reuilly	Miserables.txt 1
reunion	Miserables.txt 1
reunions	Miserables.txt 1
reunited	Miserables.txt 1
revarnished	Miserables.txt 1
revasseries	Miserables.txt 1
reveal	Miserables.txt 7
revealed	Miserables.txt 8
revealer	Miserables.txt 1
revealers	Miserables.txt 1
revealing	Miserables.txt 1
reveals	Miserables.txt 1
revelation	Miserables.txt 9
revelations	Miserables.txt 5
revenge	Miserables.txt 10
revenging	Miserables.txt 1
revenue	Miserables.txt 1
revenues	Miserables.txt 2
reverberation	Miserables.txt 1
reverberations	Miserables.txt 2
revere	Miserables.txt 2
revered	Miserables.txt 2
reverence	Miserables.txt 2
reverend	Miserables.txt 32
reveries	Miserables.txt 8
revers	Miserables.txt 3
reversal	Miserables.txt 2
reverse	Miserables.txt 4
reversed	Miserables.txt 5
reverses	Miserables.txt 1
reversing	Miserables.txt 3
reversion	Miserables.txt 1
reverted	Miserables.txt 4
reverting	Miserables.txt 1
revery	Miserables.txt 59
revictual	Miserables.txt 1
review	Miserables.txt 14
revised	Miserables.txt 1
revising	Miserables.txt 1
revision	Miserables.txt 1
revived	Miserables.txt 2
reviving	Miserables.txt 1
revocation	Miserables.txt 1
revolt	Miserables.txt 49
revolted	Miserables.txt 1
revolting	Miserables.txt 1
revolts	Miserables.txt 7
revolution	Miserables.txt 163
revolutionary	Miserables.txt 33
revolutionist	Miserables.txt 4
revolutionists	Miserables.txt 5
revolutions	Miserables.txt 31
revolved	Miserables.txt 1
revolving	Miserables.txt 2
rewards	Miserables.txt 1
reyniere	Miserables.txt 2
rheims	Miserables.txt 3
rhetorician	Miserables.txt 1
rheumatism	Miserables.txt 2
rhine	Miserables.txt 4
rhodes	Miserables.txt 1
rhododendron	Miserables.txt 4
rhone	Miserables.txt 1
rhyme	Miserables.txt 2
rhymed	Miserables.txt 1
rhymes	Miserables.txt 2
rhythm	Miserables.txt 3
riait	Miserables.txt 1
ribbed	Miserables.txt 2
ribbon	Miserables.txt 22
ribboned	Miserables.txt 1
ribbons	Miserables.txt 10
ribonribette	Miserables.txt 1
ribonribo	Miserables.txt 1
ribotte	Miserables.txt 1
ribs	Miserables.txt 6
rich	Miserables.txt 77
richard	Miserables.txt 1
richefeu	Miserables.txt 5
richelieu	Miserables.txt 4
richer	Miserables.txt 1
riches	Miserables.txt 13
richest	Miserables.txt 2
richly	Miserables.txt 1
richmond	Miserables.txt 1
rickety	Miserables.txt 1
rid	Miserables.txt 17
ridden	Miserables.txt 6
riddle	Miserables.txt 1
riddled	Miserables.txt 5
riddles	Miserables.txt 2
riddling	Miserables.txt 2
ride	Miserables.txt 4
rider	Miserables.txt 3
riders	Miserables.txt 3
ridet	Miserables.txt 1
ridge	Miserables.txt 4
ridicule	Miserables.txt 2
ridicules	Miserables.txt 1
ridiculous	Miserables.txt 15
riding	Miserables.txt 1
riego	Miserables.txt 1
rien	Miserables.txt 2
rife	Miserables.txt 1
rifle	Miserables.txt 13
rifled	Miserables.txt 4
rift	Miserables.txt 2
rigadoons	Miserables.txt 1
rigging	Miserables.txt 4
right	Miserables.txt 421
righted	Miserables.txt 1
rightly	Miserables.txt 5
rights	Miserables.txt 35
rigid	Miserables.txt 11
rigidity	Miserables.txt 3
rigmarole	Miserables.txt 2
rigorous	Miserables.txt 2
rigorously	Miserables.txt 3
rim	Miserables.txt 3
rimmed	Miserables.txt 1
rind	Miserables.txt 1
ring	Miserables.txt 14
ringer	Miserables.txt 1
ringing	Miserables.txt 3
rings	Miserables.txt 8
rinse	Miserables.txt 1
rio	Miserables.txt 1
riot	Miserables.txt 22
rioter	Miserables.txt 2
rioters	Miserables.txt 1
rioting	Miserables.txt 2
riots	Miserables.txt 9
rip	Miserables.txt 2
ripe	Miserables.txt 15
riper	Miserables.txt 1
ripped	Miserables.txt 1
ripple	Miserables.txt 1
rippling	Miserables.txt 1
rire	Miserables.txt 1
rise	Miserables.txt 57
risen	Miserables.txt 23
rises	Miserables.txt 16
rising	Miserables.txt 33
risings	Miserables.txt 1
risk	Miserables.txt 29
risked	Miserables.txt 10
risking	Miserables.txt 1
risks	Miserables.txt 4
risky	Miserables.txt 1
rite	Miserables.txt 1
ritournelles	Miserables.txt 1
rival	Miserables.txt 1
rivalled	Miserables.txt 2
rivalries	Miserables.txt 1
rivalry	Miserables.txt 3
river	Miserables.txt 46
rivers	Miserables.txt 5
riverside	Miserables.txt 1
riveted	Miserables.txt 13
rivetted	Miserables.txt 1
rivoli	Miserables.txt 5
rivulet	Miserables.txt 3
rivulets	Miserables.txt 1
road	Miserables.txt 144
roadmending	Miserables.txt 1
roads	Miserables.txt 33
roadsteads	Miserables.txt 1
roam	Miserables.txt 4
roamed	Miserables.txt 2
roamer	Miserables.txt 2
roaming	Miserables.txt 1
roams	Miserables.txt 1
roar	Miserables.txt 14
roared	Miserables.txt 4
roars	Miserables.txt 2
roast	Miserables.txt 2
roastbeef	Miserables.txt 1
roasting	Miserables.txt 3
rob	Miserables.txt 9
robbed	Miserables.txt 21
robber	Miserables.txt 8
robberies	Miserables.txt 1
robbers	Miserables.txt 9
robbery	Miserables.txt 6
robbing	Miserables.txt 3
robe	Miserables.txt 10
robecque	Miserables.txt 1
robed	Miserables.txt 1
robert	Miserables.txt 3
robes	Miserables.txt 5
robespierre	Miserables.txt 18
robin	Miserables.txt 3
robust	Miserables.txt 16
rocaille	Miserables.txt 1
roche	Miserables.txt 3
rochefort	Miserables.txt 1
rock	Miserables.txt 22
rocked	Miserables.txt 2
rocks	Miserables.txt 4
rocky	Miserables.txt 1
rococo	Miserables.txt 2
rod	Miserables.txt 3
rode	Miserables.txt 2
rodents	Miserables.txt 1
rods	Miserables.txt 1
roger	Miserables.txt 1
rogue	Miserables.txt 7
rogueries	Miserables.txt 1
roguery	Miserables.txt 1
roguet	Miserables.txt 3
roguish	Miserables.txt 3
rohan	Miserables.txt 7
roi	Miserables.txt 14
roland	Miserables.txt 1
roles	Miserables.txt 3
roll	Miserables.txt 29
rolleboise	Miserables.txt 1
rolled	Miserables.txt 14
rollet	Miserables.txt 1
rollin	Miserables.txt 3
rolling	Miserables.txt 10
rolls	Miserables.txt 9
romainville	Miserables.txt 6
roman	Miserables.txt 16
romance	Miserables.txt 22
romancers	Miserables.txt 1
romances	Miserables.txt 10
romanoffs	Miserables.txt 1
romans	Miserables.txt 3
romantic	Miserables.txt 8
romantically	Miserables.txt 1
romanticism	Miserables.txt 2
rome	Miserables.txt 45
romeo	Miserables.txt 3
romorantin	Miserables.txt 1
romulus	Miserables.txt 1
ronde	Miserables.txt 1
ronds	Miserables.txt 2
roof	Miserables.txt 59
roofed	Miserables.txt 1
roofers	Miserables.txt 1
roofs	Miserables.txt 27
room	Miserables.txt 302
rooms	Miserables.txt 28
roost	Miserables.txt 1
roosts	Miserables.txt 1
root	Miserables.txt 7
rooted	Miserables.txt 4
rootless	Miserables.txt 1
roots	Miserables.txt 11
rope	Miserables.txt 72
ropes	Miserables.txt 14
roquelaure	Miserables.txt 3
roquette	Miserables.txt 1
rosa	Miserables.txt 2
rosary	Miserables.txt 3
rose	Miserables.txt 132
rosebush	Miserables.txt 1
rosee	Miserables.txt 1
roses	Miserables.txt 22
rosette	Miserables.txt 3
rosettes	Miserables.txt 1
rosewood	Miserables.txt 1
rosse	Miserables.txt 1
rosses	Miserables.txt 1
rossomme	Miserables.txt 6
rostopchine	Miserables.txt 1
rostrum	Miserables.txt 2
rosy	Miserables.txt 36
rot	Miserables.txt 1
rota	Miserables.txt 1
rothschild	Miserables.txt 3
rotted	Miserables.txt 2
rotten	Miserables.txt 6
rottenness	Miserables.txt 2
rotting	Miserables.txt 3
rotunda	Miserables.txt 4
roubles	Miserables.txt 1
rouen	Miserables.txt 2
rouge	Miserables.txt 2
rouged	Miserables.txt 1
rouges	Miserables.txt 3
rouget	Miserables.txt 1
rough	Miserables.txt 22
roughened	Miserables.txt 2
roughhewn	Miserables.txt 1
roughly	Miserables.txt 17
roughness	Miserables.txt 2
roula	Miserables.txt 1
roule	Miserables.txt 1
roulette	Miserables.txt 1
roulotte	Miserables.txt 1
roumania	Miserables.txt 1
round	Miserables.txt 174
roundabout	Miserables.txt 2
rounded	Miserables.txt 2
rounding	Miserables.txt 1
roundness	Miserables.txt 1
rounds	Miserables.txt 8
roundsman	Miserables.txt 1
rouse	Miserables.txt 7
roused	Miserables.txt 11
rousing	Miserables.txt 1
rousseau	Miserables.txt 19
rousses	Miserables.txt 1
roussins	Miserables.txt 1
rout	Miserables.txt 12
route	Miserables.txt 7
routed	Miserables.txt 2
routes	Miserables.txt 1
routine	Miserables.txt 1
routines	Miserables.txt 1
rover	Miserables.txt 1
row	Miserables.txt 15
rows	Miserables.txt 14
royal	Miserables.txt 41
royale	Miserables.txt 4
royalism	Miserables.txt 5
royalist	Miserables.txt 24
royalists	Miserables.txt 6
royally	Miserables.txt 2
royalties	Miserables.txt 2
royalty	Miserables.txt 23
royer	Miserables.txt 2
roysterers	Miserables.txt 1
roze	Miserables.txt 2
rubans	Miserables.txt 1
rubaudiere	Miserables.txt 2
rubbed	Miserables.txt 7
rubbing	Miserables.txt 3
rubbish	Miserables.txt 23
rubicon	Miserables.txt 2
rubies	Miserables.txt 3
rubigine	Miserables.txt 1
rubric	Miserables.txt 1
rubs	Miserables.txt 2
ruddy	Miserables.txt 7
rude	Miserables.txt 6
rudely	Miserables.txt 3
rudeness	Miserables.txt 2
rudimentary	Miserables.txt 1
rue	Miserables.txt 667
rues	Miserables.txt 4
ruffian	Miserables.txt 12
ruffianism	Miserables.txt 3
ruffians	Miserables.txt 46
ruffle	Miserables.txt 1
ruffled	Miserables.txt 2
rug	Miserables.txt 2
ruin	Miserables.txt 42
ruined	Miserables.txt 19
ruining	Miserables.txt 4
ruinous	Miserables.txt 1
ruins	Miserables.txt 16
ruisseau	Miserables.txt 1
rule	Miserables.txt 29
ruled	Miserables.txt 2
ruler	Miserables.txt 1
rules	Miserables.txt 6
rumble	Miserables.txt 5
rumbled	Miserables.txt 5
rumbling	Miserables.txt 3
rummage	Miserables.txt 3
rummaged	Miserables.txt 6
rummager	Miserables.txt 1
rummages	Miserables.txt 1
rummaging	Miserables.txt 2
rumor	Miserables.txt 6
rumored	Miserables.txt 1
rumors	Miserables.txt 7
run	Miserables.txt 64
runaway	Miserables.txt 1
rung	Miserables.txt 2
rungs	Miserables.txt 3
runners	Miserables.txt 1
running	Miserables.txt 26
runs	Miserables.txt 14
ruppin	Miserables.txt 1
ruptures	Miserables.txt 1
rural	Miserables.txt 3
ruris	Miserables.txt 1
ruse	Miserables.txt 4
rush	Miserables.txt 11
rushed	Miserables.txt 30
rushes	Miserables.txt 1
rushing	Miserables.txt 1
russe	Miserables.txt 1
russet	Miserables.txt 1
russia	Miserables.txt 5
russian	Miserables.txt 7
russians	Miserables.txt 3
rust	Miserables.txt 4
rusted	Miserables.txt 2
rustic	Miserables.txt 10
rusticating	Miserables.txt 1
rusticity	Miserables.txt 1
rustics	Miserables.txt 2
rusting	Miserables.txt 1
rustle	Miserables.txt 4
rustled	Miserables.txt 4
rustler	Miserables.txt 2
rustles	Miserables.txt 1
rustling	Miserables.txt 4
rusty	Miserables.txt 10
rut	Miserables.txt 3
ruthlessly	Miserables.txt 1
ruts	Miserables.txt 6
ruysdeel	Miserables.txt 1
ruyter	Miserables.txt 1
rye	Miserables.txt 7
rylandt	Miserables.txt 2
ryssel	Miserables.txt 1
