u	Miserables.txt 14
ubaye	Miserables.txt 1
ubayette	Miserables.txt 1
ubiquity	Miserables.txt 2
uce	Miserables.txt 1
uche	Miserables.txt 1
ugliest	Miserables.txt 1
ugliness	Miserables.txt 8
ugly	Miserables.txt 38
ugolino	Miserables.txt 1
uhlans	Miserables.txt 1
ulbach	Miserables.txt 2
ulcer	Miserables.txt 4
ulcers	Miserables.txt 2
ulm	Miserables.txt 2
ulterior	Miserables.txt 4
ultime	Miserables.txt 5
ultra	Miserables.txt 8
ultramontane	Miserables.txt 1
ultras	Miserables.txt 2
ulysses	Miserables.txt 1
umbrella	Miserables.txt 8
un	Miserables.txt 45
unable	Miserables.txt 5
unaccepted	Miserables.txt 1
unaccompanied	Miserables.txt 1
unaccustomed	Miserables.txt 1
unacquainted	Miserables.txt 1
unaided	Miserables.txt 1
unamiable	Miserables.txt 1
unanimities	Miserables.txt 1
unanimity	Miserables.txt 3
unanimous	Miserables.txt 4
unanimously	Miserables.txt 1
unanswerable	Miserables.txt 2
unanswered	Miserables.txt 2
unapproachable	Miserables.txt 1
unarmed	Miserables.txt 1
unassailable	Miserables.txt 1
unattractive	Miserables.txt 1
unavenged	Miserables.txt 1
unavowed	Miserables.txt 1
unaware	Miserables.txt 1
unbearable	Miserables.txt 1
unblessed	Miserables.txt 1
unbound	Miserables.txt 1
unbreathable	Miserables.txt 1
unbribable	Miserables.txt 1
unbridled	Miserables.txt 2
unbroken	Miserables.txt 1
unbuckling	Miserables.txt 1
unbuttoned	Miserables.txt 3
uncanny	Miserables.txt 1
unceasing	Miserables.txt 1
unceasingly	Miserables.txt 1
unceremoniousness	Miserables.txt 1
uncertain	Miserables.txt 5
uncertainty	Miserables.txt 5
unchained	Miserables.txt 2
uncharitable	Miserables.txt 1
uncle	Miserables.txt 9
unclean	Miserables.txt 8
uncleannesses	Miserables.txt 1
unclouded	Miserables.txt 1
uncoiffed	Miserables.txt 1
uncoiled	Miserables.txt 1
uncomfortable	Miserables.txt 3
uncompromising	Miserables.txt 1
unconcern	Miserables.txt 1
unconcerned	Miserables.txt 1
unconquerable	Miserables.txt 3
unconscious	Miserables.txt 10
unconsciously	Miserables.txt 10
uncovered	Miserables.txt 5
uncultivated	Miserables.txt 2
uncurtained	Miserables.txt 1
undeceive	Miserables.txt 2
undeceived	Miserables.txt 1
undecided	Miserables.txt 5
undecipherable	Miserables.txt 1
undeclared	Miserables.txt 1
undefinable	Miserables.txt 1
undefined	Miserables.txt 1
under	Miserables.txt 466
underbrush	Miserables.txt 2
underfoot	Miserables.txt 2
undergo	Miserables.txt 10
undergoes	Miserables.txt 2
undergoing	Miserables.txt 8
undergone	Miserables.txt 14
underground	Miserables.txt 6
undergrowth	Miserables.txt 2
underhand	Miserables.txt 2
underline	Miserables.txt 1
underlined	Miserables.txt 2
underlying	Miserables.txt 4
undermined	Miserables.txt 3
undermines	Miserables.txt 6
undermining	Miserables.txt 1
underminings	Miserables.txt 1
underneath	Miserables.txt 5
underpinning	Miserables.txt 3
understand	Miserables.txt 127
understanding	Miserables.txt 23
understands	Miserables.txt 9
understate	Miserables.txt 1
understood	Miserables.txt 87
undertake	Miserables.txt 5
undertaken	Miserables.txt 7
undertaker	Miserables.txt 12
undertakers	Miserables.txt 1
undertakes	Miserables.txt 2
undertaking	Miserables.txt 2
undertone	Miserables.txt 2
undertook	Miserables.txt 6
underwent	Miserables.txt 11
undid	Miserables.txt 2
undiscoverable	Miserables.txt 2
undisputed	Miserables.txt 2
undo	Miserables.txt 1
undoing	Miserables.txt 1
undone	Miserables.txt 2
undoubtedly	Miserables.txt 3
undress	Miserables.txt 3
undressed	Miserables.txt 1
undressing	Miserables.txt 4
undulate	Miserables.txt 1
undulated	Miserables.txt 7
undulates	Miserables.txt 1
undulating	Miserables.txt 6
undulation	Miserables.txt 1
undulations	Miserables.txt 6
une	Miserables.txt 15
unearthed	Miserables.txt 3
uneasily	Miserables.txt 2
uneasiness	Miserables.txt 14
uneasy	Miserables.txt 41
uneffaceable	Miserables.txt 1
unemployed	Miserables.txt 2
unenclosed	Miserables.txt 1
unendurable	Miserables.txt 2
unenforceability	Miserables.txt 1
unequal	Miserables.txt 6
unequally	Miserables.txt 1
unescorted	Miserables.txt 1
uneven	Miserables.txt 4
unevenness	Miserables.txt 3
unexpected	Miserables.txt 39
unexpectedly	Miserables.txt 4
unfailing	Miserables.txt 1
unfaithful	Miserables.txt 1
unfamiliar	Miserables.txt 3
unfastened	Miserables.txt 2
unfathomable	Miserables.txt 9
unfinished	Miserables.txt 1
unfit	Miserables.txt 1
unfitted	Miserables.txt 1
unfold	Miserables.txt 3
unfolded	Miserables.txt 22
unfolding	Miserables.txt 7
unfoldings	Miserables.txt 1
unfolds	Miserables.txt 1
unforeseen	Miserables.txt 13
unfortunate	Miserables.txt 36
unfortunately	Miserables.txt 8
unfortunates	Miserables.txt 1
unfrequented	Miserables.txt 1
unfurnished	Miserables.txt 1
ungild	Miserables.txt 1
unglued	Miserables.txt 1
ungovernable	Miserables.txt 1
ungraceful	Miserables.txt 1
ungracious	Miserables.txt 1
ungrafted	Miserables.txt 1
ungrateful	Miserables.txt 5
unhappily	Miserables.txt 1
unhappiness	Miserables.txt 15
unhappy	Miserables.txt 56
unharness	Miserables.txt 2
unharnessed	Miserables.txt 5
unharnessing	Miserables.txt 1
unhealthy	Miserables.txt 15
unheard	Miserables.txt 14
unhesitatingly	Miserables.txt 1
unhewn	Miserables.txt 1
unhook	Miserables.txt 2
unhooked	Miserables.txt 1
unhooking	Miserables.txt 1
unhorsed	Miserables.txt 1
uniform	Miserables.txt 25
uniformity	Miserables.txt 1
uniforms	Miserables.txt 10
uninhabited	Miserables.txt 9
unintelligible	Miserables.txt 6
unintentionally	Miserables.txt 2
uninterruptedly	Miserables.txt 3
union	Miserables.txt 4
unique	Miserables.txt 8
unison	Miserables.txt 3
unite	Miserables.txt 6
united	Miserables.txt 18
unites	Miserables.txt 1
unity	Miserables.txt 8
universal	Miserables.txt 31
universally	Miserables.txt 1
universe	Miserables.txt 29
universite	Miserables.txt 1
unjust	Miserables.txt 14
unjustifiable	Miserables.txt 1
unjustly	Miserables.txt 5
unkind	Miserables.txt 2
unknown	Miserables.txt 88
unknowns	Miserables.txt 1
unlearning	Miserables.txt 2
unless	Miserables.txt 22
unlettered	Miserables.txt 2
unlike	Miserables.txt 6
unlink	Miserables.txt 1
unload	Miserables.txt 1
unloading	Miserables.txt 1
unlocked	Miserables.txt 1
unlooked	Miserables.txt 1
unloosed	Miserables.txt 1
unlucky	Miserables.txt 4
unmade	Miserables.txt 1
unmarried	Miserables.txt 5
unmasked	Miserables.txt 8
unmasking	Miserables.txt 1
unmerited	Miserables.txt 1
unmethodical	Miserables.txt 1
unmistakably	Miserables.txt 1
unmitigated	Miserables.txt 1
unnailed	Miserables.txt 1
unnatural	Miserables.txt 1
unnecessary	Miserables.txt 7
unnoticed	Miserables.txt 3
unobjectionable	Miserables.txt 1
unobtrusive	Miserables.txt 2
unoccupied	Miserables.txt 2
unorganized	Miserables.txt 1
unpardoningly	Miserables.txt 1
unpasted	Miserables.txt 1
unpaved	Miserables.txt 7
unperceived	Miserables.txt 1
unpleasant	Miserables.txt 6
unpleasantness	Miserables.txt 4
unpolished	Miserables.txt 1
unprecedented	Miserables.txt 23
unpremeditated	Miserables.txt 2
unprepared	Miserables.txt 2
unprepossessing	Miserables.txt 4
unpretending	Miserables.txt 1
unprofitable	Miserables.txt 1
unprotected	Miserables.txt 3
unprovided	Miserables.txt 1
unpublished	Miserables.txt 3
unravelled	Miserables.txt 1
unread	Miserables.txt 1
unreasonable	Miserables.txt 2
unreasoning	Miserables.txt 1
unrecognizable	Miserables.txt 3
unreserved	Miserables.txt 1
unriddled	Miserables.txt 1
unrolled	Miserables.txt 2
uns	Miserables.txt 6
unscrew	Miserables.txt 1
unscrewed	Miserables.txt 2
unscrupulous	Miserables.txt 2
unsealed	Miserables.txt 3
unseated	Miserables.txt 2
unseen	Miserables.txt 3
unshaded	Miserables.txt 1
unsheathed	Miserables.txt 2
unsheltered	Miserables.txt 2
unskilful	Miserables.txt 1
unsolicited	Miserables.txt 1
unsolved	Miserables.txt 1
unspeakable	Miserables.txt 2
unspeakably	Miserables.txt 1
unspotted	Miserables.txt 1
unstable	Miserables.txt 1
unstopped	Miserables.txt 1
unstrung	Miserables.txt 1
unsuccessful	Miserables.txt 1
unsuspicious	Miserables.txt 1
untidy	Miserables.txt 1
untie	Miserables.txt 2
untied	Miserables.txt 6
until	Miserables.txt 97
untraceable	Miserables.txt 1
untrue	Miserables.txt 1
untwine	Miserables.txt 1
unused	Miserables.txt 3
unusual	Miserables.txt 2
unutterable	Miserables.txt 4
unvarying	Miserables.txt 1
unveil	Miserables.txt 1
unveiled	Miserables.txt 2
unwelded	Miserables.txt 1
unwilling	Miserables.txt 1
unwinding	Miserables.txt 1
unwittingly	Miserables.txt 1
unwonted	Miserables.txt 1
unworthy	Miserables.txt 6
up	Miserables.txt 930
updated	Miserables.txt 2
upheaval	Miserables.txt 1
upheaves	Miserables.txt 1
upheld	Miserables.txt 12
uphold	Miserables.txt 4
upholders	Miserables.txt 1
upholding	Miserables.txt 4
upholstered	Miserables.txt 1
uplift	Miserables.txt 1
uplifted	Miserables.txt 10
uplifting	Miserables.txt 1
uplifts	Miserables.txt 1
upon	Miserables.txt 484
upper	Miserables.txt 36
upraised	Miserables.txt 2
upright	Miserables.txt 23
uprightness	Miserables.txt 1
uprising	Miserables.txt 23
uprisings	Miserables.txt 7
uproar	Miserables.txt 39
uproariously	Miserables.txt 1
uprooted	Miserables.txt 5
uproots	Miserables.txt 1
upset	Miserables.txt 6
upsets	Miserables.txt 2
upsetting	Miserables.txt 4
upside	Miserables.txt 4
upstairs	Miserables.txt 5
upstream	Miserables.txt 2
upward	Miserables.txt 3
upwards	Miserables.txt 3
urbain	Miserables.txt 6
urbanists	Miserables.txt 1
urbi	Miserables.txt 1
urbis	Miserables.txt 3
urchin	Miserables.txt 19
urchindom	Miserables.txt 1
urchins	Miserables.txt 5
urfe	Miserables.txt 1
urge	Miserables.txt 1
urged	Miserables.txt 9
urgency	Miserables.txt 1
urgent	Miserables.txt 3
urges	Miserables.txt 2
urging	Miserables.txt 2
uri	Miserables.txt 1
urine	Miserables.txt 1
urn	Miserables.txt 2
ursule	Miserables.txt 21
ursuline	Miserables.txt 1
ursulines	Miserables.txt 1
us	Miserables.txt 519
usage	Miserables.txt 3
usages	Miserables.txt 1
use	Miserables.txt 101
used	Miserables.txt 54
useful	Miserables.txt 45
usefully	Miserables.txt 4
usefulness	Miserables.txt 2
useless	Miserables.txt 40
uselessness	Miserables.txt 2
user	Miserables.txt 3
uses	Miserables.txt 4
usher	Miserables.txt 21
ushers	Miserables.txt 3
using	Miserables.txt 7
usual	Miserables.txt 32
usually	Miserables.txt 14
usurer	Miserables.txt 1
usurp	Miserables.txt 1
usurpation	Miserables.txt 3
usurped	Miserables.txt 1
usurper	Miserables.txt 3
usurps	Miserables.txt 1
usury	Miserables.txt 1
usus	Miserables.txt 1
ut	Miserables.txt 3
utensil	Miserables.txt 1
utensils	Miserables.txt 4
utility	Miserables.txt 7
utilize	Miserables.txt 1
utilized	Miserables.txt 1
utmost	Miserables.txt 1
utopia	Miserables.txt 11
utopians	Miserables.txt 2
utopias	Miserables.txt 1
utrecht	Miserables.txt 5
utter	Miserables.txt 35
utterance	Miserables.txt 7
uttered	Miserables.txt 83
utterest	Miserables.txt 1
uttering	Miserables.txt 23
utterly	Miserables.txt 28
utters	Miserables.txt 3
uxbridge	Miserables.txt 2
