c	NotreDame_De_Paris.txt 6
cabal	NotreDame_De_Paris.txt 1
cabalistic	NotreDame_De_Paris.txt 2
cabalistics	NotreDame_De_Paris.txt 1
cabaret	NotreDame_De_Paris.txt 1
cabbage	NotreDame_De_Paris.txt 2
cabbages	NotreDame_De_Paris.txt 1
cabellero	NotreDame_De_Paris.txt 1
cabin	NotreDame_De_Paris.txt 4
cabinet	NotreDame_De_Paris.txt 2
cadences	NotreDame_De_Paris.txt 1
caesar	NotreDame_De_Paris.txt 2
cage	NotreDame_De_Paris.txt 31
cages	NotreDame_De_Paris.txt 3
cagoule	NotreDame_De_Paris.txt 1
caillart	NotreDame_De_Paris.txt 1
caillouville	NotreDame_De_Paris.txt 1
cain	NotreDame_De_Paris.txt 1
cake	NotreDame_De_Paris.txt 27
cakes	NotreDame_De_Paris.txt 1
calabash	NotreDame_De_Paris.txt 1
calabrian	NotreDame_De_Paris.txt 1
calamitous	NotreDame_De_Paris.txt 1
calamity	NotreDame_De_Paris.txt 3
calatagirone	NotreDame_De_Paris.txt 1
calculate	NotreDame_De_Paris.txt 1
calculated	NotreDame_De_Paris.txt 4
calculating	NotreDame_De_Paris.txt 1
calendar	NotreDame_De_Paris.txt 1
calendre	NotreDame_De_Paris.txt 1
calf	NotreDame_De_Paris.txt 1
caligraphy	NotreDame_De_Paris.txt 1
calixtus	NotreDame_De_Paris.txt 1
call	NotreDame_De_Paris.txt 33
callebotte	NotreDame_De_Paris.txt 1
called	NotreDame_De_Paris.txt 63
callest	NotreDame_De_Paris.txt 1
calling	NotreDame_De_Paris.txt 8
callot	NotreDame_De_Paris.txt 1
callous	NotreDame_De_Paris.txt 3
calls	NotreDame_De_Paris.txt 3
calm	NotreDame_De_Paris.txt 14
calmed	NotreDame_De_Paris.txt 5
calming	NotreDame_De_Paris.txt 1
calmly	NotreDame_De_Paris.txt 1
calves	NotreDame_De_Paris.txt 1
cambrai	NotreDame_De_Paris.txt 2
came	NotreDame_De_Paris.txt 92
camel	NotreDame_De_Paris.txt 1
camelot	NotreDame_De_Paris.txt 2
camichon	NotreDame_De_Paris.txt 1
camlet	NotreDame_De_Paris.txt 1
camp	NotreDame_De_Paris.txt 3
camped	NotreDame_De_Paris.txt 1
camphor	NotreDame_De_Paris.txt 1
camulog	NotreDame_De_Paris.txt 1
can	NotreDame_De_Paris.txt 116
canal	NotreDame_De_Paris.txt 2
candid	NotreDame_De_Paris.txt 2
candida	NotreDame_De_Paris.txt 1
candidate	NotreDame_De_Paris.txt 1
candide	NotreDame_De_Paris.txt 1
candle	NotreDame_De_Paris.txt 12
candlemas	NotreDame_De_Paris.txt 2
candles	NotreDame_De_Paris.txt 19
candlestick	NotreDame_De_Paris.txt 1
cannon	NotreDame_De_Paris.txt 4
cannons	NotreDame_De_Paris.txt 4
cannot	NotreDame_De_Paris.txt 26
canon	NotreDame_De_Paris.txt 5
canonical	NotreDame_De_Paris.txt 1
canonicus	NotreDame_De_Paris.txt 1
canonized	NotreDame_De_Paris.txt 1
canons	NotreDame_De_Paris.txt 8
cantica	NotreDame_De_Paris.txt 2
canticorum	NotreDame_De_Paris.txt 1
cantilenoe	NotreDame_De_Paris.txt 1
canvas	NotreDame_De_Paris.txt 1
cao	NotreDame_De_Paris.txt 2
cap	NotreDame_De_Paris.txt 19
capable	NotreDame_De_Paris.txt 3
caparison	NotreDame_De_Paris.txt 1
caparisoned	NotreDame_De_Paris.txt 1
caparisons	NotreDame_De_Paris.txt 1
cape	NotreDame_De_Paris.txt 1
capella	NotreDame_De_Paris.txt 1
capillos	NotreDame_De_Paris.txt 1
capita	NotreDame_De_Paris.txt 1
capitaine	NotreDame_De_Paris.txt 1
capital	NotreDame_De_Paris.txt 16
capitals	NotreDame_De_Paris.txt 11
capitol	NotreDame_De_Paris.txt 1
capitularies	NotreDame_De_Paris.txt 3
capitulate	NotreDame_De_Paris.txt 1
capon	NotreDame_De_Paris.txt 1
cappa	NotreDame_De_Paris.txt 1
capped	NotreDame_De_Paris.txt 2
cappettam	NotreDame_De_Paris.txt 1
cappettes	NotreDame_De_Paris.txt 1
caprice	NotreDame_De_Paris.txt 2
caprices	NotreDame_De_Paris.txt 2
capricious	NotreDame_De_Paris.txt 7
capriciousness	NotreDame_De_Paris.txt 1
caps	NotreDame_De_Paris.txt 9
capstan	NotreDame_De_Paris.txt 1
capsule	NotreDame_De_Paris.txt 1
captain	NotreDame_De_Paris.txt 143
captivated	NotreDame_De_Paris.txt 1
capture	NotreDame_De_Paris.txt 1
caputia	NotreDame_De_Paris.txt 1
caravan	NotreDame_De_Paris.txt 1
carbon	NotreDame_De_Paris.txt 1
carbuncles	NotreDame_De_Paris.txt 1
carcasses	NotreDame_De_Paris.txt 1
carcer	NotreDame_De_Paris.txt 1
carceres	NotreDame_De_Paris.txt 1
card	NotreDame_De_Paris.txt 4
cardboard	NotreDame_De_Paris.txt 2
cardinal	NotreDame_De_Paris.txt 71
cardinals	NotreDame_De_Paris.txt 2
cards	NotreDame_De_Paris.txt 1
care	NotreDame_De_Paris.txt 21
cared	NotreDame_De_Paris.txt 6
career	NotreDame_De_Paris.txt 2
careful	NotreDame_De_Paris.txt 3
carefully	NotreDame_De_Paris.txt 5
careless	NotreDame_De_Paris.txt 2
carelessly	NotreDame_De_Paris.txt 4
carelessness	NotreDame_De_Paris.txt 1
cares	NotreDame_De_Paris.txt 1
caress	NotreDame_De_Paris.txt 3
caressed	NotreDame_De_Paris.txt 5
caresses	NotreDame_De_Paris.txt 7
caressing	NotreDame_De_Paris.txt 12
caring	NotreDame_De_Paris.txt 1
caritatem	NotreDame_De_Paris.txt 3
carlovingian	NotreDame_De_Paris.txt 2
carminis	NotreDame_De_Paris.txt 1
carnival	NotreDame_De_Paris.txt 1
carolling	NotreDame_De_Paris.txt 1
carousing	NotreDame_De_Paris.txt 2
carp	NotreDame_De_Paris.txt 1
carpenter	NotreDame_De_Paris.txt 3
carpenters	NotreDame_De_Paris.txt 1
carpet	NotreDame_De_Paris.txt 6
carpeted	NotreDame_De_Paris.txt 1
carping	NotreDame_De_Paris.txt 1
carreaux	NotreDame_De_Paris.txt 2
carriage	NotreDame_De_Paris.txt 1
carried	NotreDame_De_Paris.txt 25
carries	NotreDame_De_Paris.txt 1
carrion	NotreDame_De_Paris.txt 1
carry	NotreDame_De_Paris.txt 13
carrying	NotreDame_De_Paris.txt 9
cart	NotreDame_De_Paris.txt 19
carter	NotreDame_De_Paris.txt 1
carters	NotreDame_De_Paris.txt 1
carthaginian	NotreDame_De_Paris.txt 1
carthusian	NotreDame_De_Paris.txt 1
cartloads	NotreDame_De_Paris.txt 1
carts	NotreDame_De_Paris.txt 1
carved	NotreDame_De_Paris.txt 29
carver	NotreDame_De_Paris.txt 1
carving	NotreDame_De_Paris.txt 7
carvings	NotreDame_De_Paris.txt 8
cas	NotreDame_De_Paris.txt 1
cascade	NotreDame_De_Paris.txt 1
case	NotreDame_De_Paris.txt 23
casement	NotreDame_De_Paris.txt 2
casements	NotreDame_De_Paris.txt 3
cases	NotreDame_De_Paris.txt 7
cask	NotreDame_De_Paris.txt 8
casks	NotreDame_De_Paris.txt 1
casque	NotreDame_De_Paris.txt 1
cassiodorus	NotreDame_De_Paris.txt 1
cassock	NotreDame_De_Paris.txt 12
cassocks	NotreDame_De_Paris.txt 1
cast	NotreDame_De_Paris.txt 51
castanets	NotreDame_De_Paris.txt 4
caste	NotreDame_De_Paris.txt 3
castellanies	NotreDame_De_Paris.txt 1
castellany	NotreDame_De_Paris.txt 1
castellated	NotreDame_De_Paris.txt 1
castelleti	NotreDame_De_Paris.txt 1
castilian	NotreDame_De_Paris.txt 1
casting	NotreDame_De_Paris.txt 9
castle	NotreDame_De_Paris.txt 2
castra	NotreDame_De_Paris.txt 1
cat	NotreDame_De_Paris.txt 17
cataclysm	NotreDame_De_Paris.txt 1
catalogue	NotreDame_De_Paris.txt 3
catalonia	NotreDame_De_Paris.txt 3
catapult	NotreDame_De_Paris.txt 2
catastrophe	NotreDame_De_Paris.txt 3
catch	NotreDame_De_Paris.txt 10
catching	NotreDame_De_Paris.txt 3
catenas	NotreDame_De_Paris.txt 1
caterpillar	NotreDame_De_Paris.txt 1
caterpillars	NotreDame_De_Paris.txt 1
cathay	NotreDame_De_Paris.txt 1
cathedral	NotreDame_De_Paris.txt 47
cathedralis	NotreDame_De_Paris.txt 1
cathedrals	NotreDame_De_Paris.txt 7
catherine	NotreDame_De_Paris.txt 3
catholic	NotreDame_De_Paris.txt 1
catholicism	NotreDame_De_Paris.txt 2
catiline	NotreDame_De_Paris.txt 1
cats	NotreDame_De_Paris.txt 5
caudebec	NotreDame_De_Paris.txt 1
caught	NotreDame_De_Paris.txt 40
cauldron	NotreDame_De_Paris.txt 4
cauliflowers	NotreDame_De_Paris.txt 1
causa	NotreDame_De_Paris.txt 1
cause	NotreDame_De_Paris.txt 25
caused	NotreDame_De_Paris.txt 36
causes	NotreDame_De_Paris.txt 7
causeth	NotreDame_De_Paris.txt 1
causing	NotreDame_De_Paris.txt 5
cautious	NotreDame_De_Paris.txt 1
cautiously	NotreDame_De_Paris.txt 1
cavalcade	NotreDame_De_Paris.txt 5
cavalier	NotreDame_De_Paris.txt 3
cavaliers	NotreDame_De_Paris.txt 5
cavallo	NotreDame_De_Paris.txt 1
cavalry	NotreDame_De_Paris.txt 5
cave	NotreDame_De_Paris.txt 4
cavern	NotreDame_De_Paris.txt 8
cavernous	NotreDame_De_Paris.txt 1
caverns	NotreDame_De_Paris.txt 2
caves	NotreDame_De_Paris.txt 1
cavities	NotreDame_De_Paris.txt 2
cavity	NotreDame_De_Paris.txt 2
ce	NotreDame_De_Paris.txt 4
cease	NotreDame_De_Paris.txt 4
ceased	NotreDame_De_Paris.txt 21
ceiled	NotreDame_De_Paris.txt 1
ceiling	NotreDame_De_Paris.txt 14
cela	NotreDame_De_Paris.txt 1
celandine	NotreDame_De_Paris.txt 1
celebrants	NotreDame_De_Paris.txt 1
celebrated	NotreDame_De_Paris.txt 4
celebrates	NotreDame_De_Paris.txt 1
celestial	NotreDame_De_Paris.txt 3
celestine	NotreDame_De_Paris.txt 1
celestins	NotreDame_De_Paris.txt 1
cell	NotreDame_De_Paris.txt 102
cellar	NotreDame_De_Paris.txt 13
cellars	NotreDame_De_Paris.txt 5
cells	NotreDame_De_Paris.txt 3
celtic	NotreDame_De_Paris.txt 3
celts	NotreDame_De_Paris.txt 1
cemetery	NotreDame_De_Paris.txt 4
cenaine	NotreDame_De_Paris.txt 5
cenalis	NotreDame_De_Paris.txt 1
censor	NotreDame_De_Paris.txt 1
centaur	NotreDame_De_Paris.txt 1
centipedes	NotreDame_De_Paris.txt 1
central	NotreDame_De_Paris.txt 15
centre	NotreDame_De_Paris.txt 21
centum	NotreDame_De_Paris.txt 1
centuries	NotreDame_De_Paris.txt 24
century	NotreDame_De_Paris.txt 69
cequis	NotreDame_De_Paris.txt 1
cerate	NotreDame_De_Paris.txt 1
cerberus	NotreDame_De_Paris.txt 1
cercidas	NotreDame_De_Paris.txt 1
ceremonial	NotreDame_De_Paris.txt 1
ceremonies	NotreDame_De_Paris.txt 1
ceremony	NotreDame_De_Paris.txt 5
ceres	NotreDame_De_Paris.txt 1
cernay	NotreDame_De_Paris.txt 1
certain	NotreDame_De_Paris.txt 57
certainly	NotreDame_De_Paris.txt 35
certainty	NotreDame_De_Paris.txt 1
certified	NotreDame_De_Paris.txt 1
cessat	NotreDame_De_Paris.txt 1
cesspool	NotreDame_De_Paris.txt 1
ceux	NotreDame_De_Paris.txt 1
ch	NotreDame_De_Paris.txt 60
chafing	NotreDame_De_Paris.txt 1
chaillot	NotreDame_De_Paris.txt 1
chain	NotreDame_De_Paris.txt 11
chained	NotreDame_De_Paris.txt 1
chains	NotreDame_De_Paris.txt 20
chair	NotreDame_De_Paris.txt 28
chairs	NotreDame_De_Paris.txt 2
chaldea	NotreDame_De_Paris.txt 1
chaldean	NotreDame_De_Paris.txt 1
chalelet	NotreDame_De_Paris.txt 1
chalk	NotreDame_De_Paris.txt 2
chalky	NotreDame_De_Paris.txt 1
challenge	NotreDame_De_Paris.txt 1
challuau	NotreDame_De_Paris.txt 1
chamber	NotreDame_De_Paris.txt 64
chamberlain	NotreDame_De_Paris.txt 3
chambers	NotreDame_De_Paris.txt 3
chambord	NotreDame_De_Paris.txt 1
chambre	NotreDame_De_Paris.txt 1
champ	NotreDame_De_Paris.txt 1
champagne	NotreDame_De_Paris.txt 4
champchevrier	NotreDame_De_Paris.txt 2
champeaux	NotreDame_De_Paris.txt 1
champing	NotreDame_De_Paris.txt 1
champs	NotreDame_De_Paris.txt 6
chance	NotreDame_De_Paris.txt 11
chanced	NotreDame_De_Paris.txt 2
chancel	NotreDame_De_Paris.txt 1
chancellery	NotreDame_De_Paris.txt 2
chancellor	NotreDame_De_Paris.txt 7
chancellorship	NotreDame_De_Paris.txt 1
chandelier	NotreDame_De_Paris.txt 1
chandeliers	NotreDame_De_Paris.txt 1
change	NotreDame_De_Paris.txt 23
changed	NotreDame_De_Paris.txt 19
changer	NotreDame_De_Paris.txt 1
changes	NotreDame_De_Paris.txt 3
changeurs	NotreDame_De_Paris.txt 4
changing	NotreDame_De_Paris.txt 3
channel	NotreDame_De_Paris.txt 1
channels	NotreDame_De_Paris.txt 1
chant	NotreDame_De_Paris.txt 1
chante	NotreDame_De_Paris.txt 2
chanted	NotreDame_De_Paris.txt 5
chantefleurie	NotreDame_De_Paris.txt 22
chanteprune	NotreDame_De_Paris.txt 1
chanter	NotreDame_De_Paris.txt 4
chanters	NotreDame_De_Paris.txt 1
chanting	NotreDame_De_Paris.txt 5
chanvre	NotreDame_De_Paris.txt 3
chaos	NotreDame_De_Paris.txt 7
chapel	NotreDame_De_Paris.txt 23
chapelle	NotreDame_De_Paris.txt 10
chapels	NotreDame_De_Paris.txt 5
chaplains	NotreDame_De_Paris.txt 3
chapped	NotreDame_De_Paris.txt 1
chappelle	NotreDame_De_Paris.txt 1
chapter	NotreDame_De_Paris.txt 66
chapters	NotreDame_De_Paris.txt 14
character	NotreDame_De_Paris.txt 14
characteristic	NotreDame_De_Paris.txt 2
characteristics	NotreDame_De_Paris.txt 2
characterize	NotreDame_De_Paris.txt 1
characterizes	NotreDame_De_Paris.txt 1
characters	NotreDame_De_Paris.txt 4
charcoal	NotreDame_De_Paris.txt 3
charenton	NotreDame_De_Paris.txt 1
charge	NotreDame_De_Paris.txt 19
charged	NotreDame_De_Paris.txt 6
charges	NotreDame_De_Paris.txt 6
chariot	NotreDame_De_Paris.txt 1
chariots	NotreDame_De_Paris.txt 1
charitable	NotreDame_De_Paris.txt 6
charities	NotreDame_De_Paris.txt 1
charity	NotreDame_De_Paris.txt 10
charlemagne	NotreDame_De_Paris.txt 6
charlerange	NotreDame_De_Paris.txt 1
charles	NotreDame_De_Paris.txt 32
charm	NotreDame_De_Paris.txt 13
charmed	NotreDame_De_Paris.txt 6
charmer	NotreDame_De_Paris.txt 2
charming	NotreDame_De_Paris.txt 41
charmingly	NotreDame_De_Paris.txt 1
charmolue	NotreDame_De_Paris.txt 53
charms	NotreDame_De_Paris.txt 2
charnel	NotreDame_De_Paris.txt 1
charnier	NotreDame_De_Paris.txt 1
charonne	NotreDame_De_Paris.txt 1
charter	NotreDame_De_Paris.txt 2
charters	NotreDame_De_Paris.txt 1
chartier	NotreDame_De_Paris.txt 2
chartres	NotreDame_De_Paris.txt 1
chartreux	NotreDame_De_Paris.txt 1
charybdis	NotreDame_De_Paris.txt 3
chased	NotreDame_De_Paris.txt 6
chasing	NotreDame_De_Paris.txt 2
chassieux	NotreDame_De_Paris.txt 1
chastely	NotreDame_De_Paris.txt 1
chastest	NotreDame_De_Paris.txt 1
chastised	NotreDame_De_Paris.txt 2
chastity	NotreDame_De_Paris.txt 4
chasuble	NotreDame_De_Paris.txt 1
chasubles	NotreDame_De_Paris.txt 1
chateau	NotreDame_De_Paris.txt 2
chateaupers	NotreDame_De_Paris.txt 2
chats	NotreDame_De_Paris.txt 1
chatter	NotreDame_De_Paris.txt 1
chattered	NotreDame_De_Paris.txt 4
chatterer	NotreDame_De_Paris.txt 1
chatterers	NotreDame_De_Paris.txt 2
chattering	NotreDame_De_Paris.txt 3
chatting	NotreDame_De_Paris.txt 3
chauss	NotreDame_De_Paris.txt 2
che	NotreDame_De_Paris.txt 1
cheated	NotreDame_De_Paris.txt 1
cheating	NotreDame_De_Paris.txt 1
check	NotreDame_De_Paris.txt 3
checked	NotreDame_De_Paris.txt 1
checker	NotreDame_De_Paris.txt 2
checkered	NotreDame_De_Paris.txt 3
checks	NotreDame_De_Paris.txt 1
cheek	NotreDame_De_Paris.txt 2
cheeked	NotreDame_De_Paris.txt 1
cheeks	NotreDame_De_Paris.txt 13
cheer	NotreDame_De_Paris.txt 1
cheerful	NotreDame_De_Paris.txt 2
cheering	NotreDame_De_Paris.txt 1
cheers	NotreDame_De_Paris.txt 1
cheese	NotreDame_De_Paris.txt 4
chef	NotreDame_De_Paris.txt 1
chembault	NotreDame_De_Paris.txt 1
cheminum	NotreDame_De_Paris.txt 1
chemisan	NotreDame_De_Paris.txt 1
chemisette	NotreDame_De_Paris.txt 1
chemist	NotreDame_De_Paris.txt 1
cheneteau	NotreDame_De_Paris.txt 1
cheops	NotreDame_De_Paris.txt 1
cherish	NotreDame_De_Paris.txt 4
cherished	NotreDame_De_Paris.txt 11
cherisheth	NotreDame_De_Paris.txt 1
cherry	NotreDame_De_Paris.txt 1
cherubim	NotreDame_De_Paris.txt 1
chess	NotreDame_De_Paris.txt 1
chesserie	NotreDame_De_Paris.txt 1
chest	NotreDame_De_Paris.txt 6
chestnuts	NotreDame_De_Paris.txt 1
chests	NotreDame_De_Paris.txt 1
chevalier	NotreDame_De_Paris.txt 12
chevron	NotreDame_De_Paris.txt 1
chewing	NotreDame_De_Paris.txt 1
chews	NotreDame_De_Paris.txt 1
chi	NotreDame_De_Paris.txt 2
chiart	NotreDame_De_Paris.txt 1
chiccory	NotreDame_De_Paris.txt 2
chicken	NotreDame_De_Paris.txt 1
chickens	NotreDame_De_Paris.txt 3
chicor	NotreDame_De_Paris.txt 1
chiding	NotreDame_De_Paris.txt 1
chief	NotreDame_De_Paris.txt 11
chiefly	NotreDame_De_Paris.txt 1
child	NotreDame_De_Paris.txt 165
childebert	NotreDame_De_Paris.txt 1
childish	NotreDame_De_Paris.txt 2
children	NotreDame_De_Paris.txt 38
chill	NotreDame_De_Paris.txt 2
chilled	NotreDame_De_Paris.txt 8
chilperic	NotreDame_De_Paris.txt 1
chime	NotreDame_De_Paris.txt 5
chimed	NotreDame_De_Paris.txt 1
chimera	NotreDame_De_Paris.txt 4
chimeras	NotreDame_De_Paris.txt 3
chimerical	NotreDame_De_Paris.txt 1
chimes	NotreDame_De_Paris.txt 3
chimney	NotreDame_De_Paris.txt 9
chimneys	NotreDame_De_Paris.txt 11
chin	NotreDame_De_Paris.txt 10
chisel	NotreDame_De_Paris.txt 2
chiselling	NotreDame_De_Paris.txt 1
choart	NotreDame_De_Paris.txt 2
choice	NotreDame_De_Paris.txt 7
choir	NotreDame_De_Paris.txt 13
choked	NotreDame_De_Paris.txt 1
choose	NotreDame_De_Paris.txt 6
chooses	NotreDame_De_Paris.txt 1
chop	NotreDame_De_Paris.txt 1
chopin	NotreDame_De_Paris.txt 3
chops	NotreDame_De_Paris.txt 1
chose	NotreDame_De_Paris.txt 1
chosen	NotreDame_De_Paris.txt 3
christ	NotreDame_De_Paris.txt 5
christendom	NotreDame_De_Paris.txt 1
christening	NotreDame_De_Paris.txt 1
christeuil	NotreDame_De_Paris.txt 5
christi	NotreDame_De_Paris.txt 1
christian	NotreDame_De_Paris.txt 7
christianity	NotreDame_De_Paris.txt 2
christians	NotreDame_De_Paris.txt 1
christmas	NotreDame_De_Paris.txt 4
christmasses	NotreDame_De_Paris.txt 1
christopher	NotreDame_De_Paris.txt 4
chronicle	NotreDame_De_Paris.txt 1
chronicles	NotreDame_De_Paris.txt 1
chubby	NotreDame_De_Paris.txt 2
church	NotreDame_De_Paris.txt 144
churches	NotreDame_De_Paris.txt 24
cibi	NotreDame_De_Paris.txt 1
ciboriums	NotreDame_De_Paris.txt 1
cicero	NotreDame_De_Paris.txt 5
ciceronian	NotreDame_De_Paris.txt 1
cid	NotreDame_De_Paris.txt 1
cider	NotreDame_De_Paris.txt 1
cinquantenier	NotreDame_De_Paris.txt 1
cipher	NotreDame_De_Paris.txt 2
circle	NotreDame_De_Paris.txt 32
circled	NotreDame_De_Paris.txt 1
circles	NotreDame_De_Paris.txt 3
circling	NotreDame_De_Paris.txt 1
circuit	NotreDame_De_Paris.txt 5
circuitous	NotreDame_De_Paris.txt 1
circuits	NotreDame_De_Paris.txt 1
circular	NotreDame_De_Paris.txt 13
circulate	NotreDame_De_Paris.txt 2
circulated	NotreDame_De_Paris.txt 2
circulates	NotreDame_De_Paris.txt 1
circulation	NotreDame_De_Paris.txt 3
circumdantis	NotreDame_De_Paris.txt 1
circumdedit	NotreDame_De_Paris.txt 1
circumference	NotreDame_De_Paris.txt 2
circumscribing	NotreDame_De_Paris.txt 1
circumstance	NotreDame_De_Paris.txt 3
circumstances	NotreDame_De_Paris.txt 2
cistern	NotreDame_De_Paris.txt 1
citadel	NotreDame_De_Paris.txt 3
cite	NotreDame_De_Paris.txt 2
cities	NotreDame_De_Paris.txt 9
citizen	NotreDame_De_Paris.txt 1
citizens	NotreDame_De_Paris.txt 3
city	NotreDame_De_Paris.txt 126
cives	NotreDame_De_Paris.txt 1
civibus	NotreDame_De_Paris.txt 1
civic	NotreDame_De_Paris.txt 1
civil	NotreDame_De_Paris.txt 6
civilization	NotreDame_De_Paris.txt 5
civilized	NotreDame_De_Paris.txt 1
civitatis	NotreDame_De_Paris.txt 1
clad	NotreDame_De_Paris.txt 25
claim	NotreDame_De_Paris.txt 10
claimed	NotreDame_De_Paris.txt 2
claims	NotreDame_De_Paris.txt 1
clamavi	NotreDame_De_Paris.txt 1
clambering	NotreDame_De_Paris.txt 2
clamor	NotreDame_De_Paris.txt 11
clamored	NotreDame_De_Paris.txt 1
clamorously	NotreDame_De_Paris.txt 1
clamors	NotreDame_De_Paris.txt 3
clamped	NotreDame_De_Paris.txt 1
clamps	NotreDame_De_Paris.txt 1
clang	NotreDame_De_Paris.txt 2
clanging	NotreDame_De_Paris.txt 1
clanked	NotreDame_De_Paris.txt 1
clanking	NotreDame_De_Paris.txt 1
clap	NotreDame_De_Paris.txt 5
clapped	NotreDame_De_Paris.txt 6
clapper	NotreDame_De_Paris.txt 4
clapping	NotreDame_De_Paris.txt 6
claret	NotreDame_De_Paris.txt 2
clarinets	NotreDame_De_Paris.txt 1
clarion	NotreDame_De_Paris.txt 1
clash	NotreDame_De_Paris.txt 1
clashing	NotreDame_De_Paris.txt 3
clasp	NotreDame_De_Paris.txt 2
clasped	NotreDame_De_Paris.txt 16
clasping	NotreDame_De_Paris.txt 9
clasps	NotreDame_De_Paris.txt 1
class	NotreDame_De_Paris.txt 3
classed	NotreDame_De_Paris.txt 1
classic	NotreDame_De_Paris.txt 6
classical	NotreDame_De_Paris.txt 1
classically	NotreDame_De_Paris.txt 1
classicism	NotreDame_De_Paris.txt 1
classico	NotreDame_De_Paris.txt 1
classified	NotreDame_De_Paris.txt 1
clatter	NotreDame_De_Paris.txt 2
claude	NotreDame_De_Paris.txt 166
claudi	NotreDame_De_Paris.txt 1
claudius	NotreDame_De_Paris.txt 1
claudo	NotreDame_De_Paris.txt 1
claw	NotreDame_De_Paris.txt 1
claws	NotreDame_De_Paris.txt 6
clayey	NotreDame_De_Paris.txt 1
clays	NotreDame_De_Paris.txt 1
clean	NotreDame_De_Paris.txt 1
cleanest	NotreDame_De_Paris.txt 1
clear	NotreDame_De_Paris.txt 12
cleared	NotreDame_De_Paris.txt 5
clearing	NotreDame_De_Paris.txt 1
clearly	NotreDame_De_Paris.txt 10
clearness	NotreDame_De_Paris.txt 2
clemency	NotreDame_De_Paris.txt 5
clement	NotreDame_De_Paris.txt 1
clench	NotreDame_De_Paris.txt 1
clenched	NotreDame_De_Paris.txt 6
clercs	NotreDame_De_Paris.txt 3
clergy	NotreDame_De_Paris.txt 7
clergyman	NotreDame_De_Paris.txt 1
clerical	NotreDame_De_Paris.txt 3
clericis	NotreDame_De_Paris.txt 1
clerk	NotreDame_De_Paris.txt 30
clerks	NotreDame_De_Paris.txt 18
clermont	NotreDame_De_Paris.txt 3
clever	NotreDame_De_Paris.txt 2
cleverly	NotreDame_De_Paris.txt 1
clew	NotreDame_De_Paris.txt 1
cliable	NotreDame_De_Paris.txt 1
clichon	NotreDame_De_Paris.txt 1
client	NotreDame_De_Paris.txt 1
climate	NotreDame_De_Paris.txt 2
climb	NotreDame_De_Paris.txt 7
climbed	NotreDame_De_Paris.txt 9
climbing	NotreDame_De_Paris.txt 7
cling	NotreDame_De_Paris.txt 6
clinging	NotreDame_De_Paris.txt 10
clings	NotreDame_De_Paris.txt 1
clinked	NotreDame_De_Paris.txt 1
clinking	NotreDame_De_Paris.txt 1
cloak	NotreDame_De_Paris.txt 13
cloaked	NotreDame_De_Paris.txt 1
clock	NotreDame_De_Paris.txt 28
clocks	NotreDame_De_Paris.txt 1
clod	NotreDame_De_Paris.txt 1
cloister	NotreDame_De_Paris.txt 30
cloistered	NotreDame_De_Paris.txt 3
cloistration	NotreDame_De_Paris.txt 1
clopin	NotreDame_De_Paris.txt 66
close	NotreDame_De_Paris.txt 24
closed	NotreDame_De_Paris.txt 53
closely	NotreDame_De_Paris.txt 11
closer	NotreDame_De_Paris.txt 8
closes	NotreDame_De_Paris.txt 1
closing	NotreDame_De_Paris.txt 7
cloth	NotreDame_De_Paris.txt 15
clothed	NotreDame_De_Paris.txt 7
clothes	NotreDame_De_Paris.txt 6
clothing	NotreDame_De_Paris.txt 1
cloud	NotreDame_De_Paris.txt 16
clouded	NotreDame_De_Paris.txt 3
clouds	NotreDame_De_Paris.txt 15
clout	NotreDame_De_Paris.txt 2
cloven	NotreDame_De_Paris.txt 1
club	NotreDame_De_Paris.txt 6
clubs	NotreDame_De_Paris.txt 1
clumsy	NotreDame_De_Paris.txt 1
clung	NotreDame_De_Paris.txt 10
cluny	NotreDame_De_Paris.txt 2
cluster	NotreDame_De_Paris.txt 5
clustered	NotreDame_De_Paris.txt 4
clusters	NotreDame_De_Paris.txt 1
clutched	NotreDame_De_Paris.txt 4
clutches	NotreDame_De_Paris.txt 2
co	NotreDame_De_Paris.txt 3
coals	NotreDame_De_Paris.txt 5
coarse	NotreDame_De_Paris.txt 5
coat	NotreDame_De_Paris.txt 5
coats	NotreDame_De_Paris.txt 5
coaxed	NotreDame_De_Paris.txt 1
cobble	NotreDame_De_Paris.txt 1
cobblestones	NotreDame_De_Paris.txt 1
cock	NotreDame_De_Paris.txt 1
cockchafer	NotreDame_De_Paris.txt 1
code	NotreDame_De_Paris.txt 2
codes	NotreDame_De_Paris.txt 1
coelestem	NotreDame_De_Paris.txt 1
coeur	NotreDame_De_Paris.txt 2
coeurs	NotreDame_De_Paris.txt 1
coffer	NotreDame_De_Paris.txt 6
coffin	NotreDame_De_Paris.txt 3
cofre	NotreDame_De_Paris.txt 1
cogitabuntur	NotreDame_De_Paris.txt 1
cohabitation	NotreDame_De_Paris.txt 1
coictier	NotreDame_De_Paris.txt 39
coif	NotreDame_De_Paris.txt 2
coiffed	NotreDame_De_Paris.txt 5
coiled	NotreDame_De_Paris.txt 1
coin	NotreDame_De_Paris.txt 9
coinage	NotreDame_De_Paris.txt 1
coined	NotreDame_De_Paris.txt 1
coins	NotreDame_De_Paris.txt 4
cold	NotreDame_De_Paris.txt 50
colder	NotreDame_De_Paris.txt 1
coldly	NotreDame_De_Paris.txt 14
coldness	NotreDame_De_Paris.txt 2
coleghens	NotreDame_De_Paris.txt 1
colette	NotreDame_De_Paris.txt 1
colic	NotreDame_De_Paris.txt 1
coligni	NotreDame_De_Paris.txt 1
coliseum	NotreDame_De_Paris.txt 2
collar	NotreDame_De_Paris.txt 7
collared	NotreDame_De_Paris.txt 1
colleague	NotreDame_De_Paris.txt 1
collect	NotreDame_De_Paris.txt 6
collected	NotreDame_De_Paris.txt 3
collecting	NotreDame_De_Paris.txt 2
collection	NotreDame_De_Paris.txt 7
collections	NotreDame_De_Paris.txt 1
collective	NotreDame_De_Paris.txt 2
college	NotreDame_De_Paris.txt 13
colleges	NotreDame_De_Paris.txt 3
colloquy	NotreDame_De_Paris.txt 2
cologne	NotreDame_De_Paris.txt 2
colombe	NotreDame_De_Paris.txt 9
colonnade	NotreDame_De_Paris.txt 6
colonnades	NotreDame_De_Paris.txt 1
color	NotreDame_De_Paris.txt 11
colored	NotreDame_De_Paris.txt 13
coloris	NotreDame_De_Paris.txt 1
colors	NotreDame_De_Paris.txt 7
colossal	NotreDame_De_Paris.txt 6
colossus	NotreDame_De_Paris.txt 2
column	NotreDame_De_Paris.txt 13
columns	NotreDame_De_Paris.txt 13
comb	NotreDame_De_Paris.txt 2
combat	NotreDame_De_Paris.txt 4
combative	NotreDame_De_Paris.txt 1
combination	NotreDame_De_Paris.txt 1
combinations	NotreDame_De_Paris.txt 2
combined	NotreDame_De_Paris.txt 5
combines	NotreDame_De_Paris.txt 1
combing	NotreDame_De_Paris.txt 1
come	NotreDame_De_Paris.txt 178
comedian	NotreDame_De_Paris.txt 3
comedians	NotreDame_De_Paris.txt 3
comedies	NotreDame_De_Paris.txt 1
comedy	NotreDame_De_Paris.txt 10
comer	NotreDame_De_Paris.txt 2
comers	NotreDame_De_Paris.txt 2
comes	NotreDame_De_Paris.txt 25
comet	NotreDame_De_Paris.txt 3
comfits	NotreDame_De_Paris.txt 2
comfortable	NotreDame_De_Paris.txt 1
comfortably	NotreDame_De_Paris.txt 1
comic	NotreDame_De_Paris.txt 1
comical	NotreDame_De_Paris.txt 1
comines	NotreDame_De_Paris.txt 3
coming	NotreDame_De_Paris.txt 16
command	NotreDame_De_Paris.txt 7
commander	NotreDame_De_Paris.txt 4
commanding	NotreDame_De_Paris.txt 1
commandingly	NotreDame_De_Paris.txt 1
commands	NotreDame_De_Paris.txt 3
comme	NotreDame_De_Paris.txt 1
commence	NotreDame_De_Paris.txt 3
comment	NotreDame_De_Paris.txt 1
commented	NotreDame_De_Paris.txt 2
comments	NotreDame_De_Paris.txt 1
commerce	NotreDame_De_Paris.txt 3
commercial	NotreDame_De_Paris.txt 1
commission	NotreDame_De_Paris.txt 1
commissioner	NotreDame_De_Paris.txt 1
commissioners	NotreDame_De_Paris.txt 1
commit	NotreDame_De_Paris.txt 1
commits	NotreDame_De_Paris.txt 2
committed	NotreDame_De_Paris.txt 6
committing	NotreDame_De_Paris.txt 1
common	NotreDame_De_Paris.txt 12
commonality	NotreDame_De_Paris.txt 1
commonplace	NotreDame_De_Paris.txt 3
commonwealth	NotreDame_De_Paris.txt 1
commotion	NotreDame_De_Paris.txt 4
commotions	NotreDame_De_Paris.txt 1
communal	NotreDame_De_Paris.txt 3
communes	NotreDame_De_Paris.txt 1
communicate	NotreDame_De_Paris.txt 3
communicated	NotreDame_De_Paris.txt 4
communicating	NotreDame_De_Paris.txt 2
communication	NotreDame_De_Paris.txt 6
communion	NotreDame_De_Paris.txt 1
communities	NotreDame_De_Paris.txt 1
community	NotreDame_De_Paris.txt 5
compact	NotreDame_De_Paris.txt 3
companies	NotreDame_De_Paris.txt 2
companion	NotreDame_De_Paris.txt 22
companions	NotreDame_De_Paris.txt 6
company	NotreDame_De_Paris.txt 29
comparable	NotreDame_De_Paris.txt 3
compare	NotreDame_De_Paris.txt 4
compared	NotreDame_De_Paris.txt 4
compares	NotreDame_De_Paris.txt 2
comparing	NotreDame_De_Paris.txt 4
comparison	NotreDame_De_Paris.txt 3
comparisons	NotreDame_De_Paris.txt 1
compartment	NotreDame_De_Paris.txt 1
compartments	NotreDame_De_Paris.txt 3
compass	NotreDame_De_Paris.txt 1
compassed	NotreDame_De_Paris.txt 1
compasses	NotreDame_De_Paris.txt 2
compassion	NotreDame_De_Paris.txt 8
compedesque	NotreDame_De_Paris.txt 1
compendium	NotreDame_De_Paris.txt 1
compensation	NotreDame_De_Paris.txt 1
competition	NotreDame_De_Paris.txt 1
competitors	NotreDame_De_Paris.txt 3
compilation	NotreDame_De_Paris.txt 1
compiler	NotreDame_De_Paris.txt 1
complacency	NotreDame_De_Paris.txt 1
complain	NotreDame_De_Paris.txt 1
complaining	NotreDame_De_Paris.txt 2
complains	NotreDame_De_Paris.txt 1
complaint	NotreDame_De_Paris.txt 4
complaints	NotreDame_De_Paris.txt 5
complete	NotreDame_De_Paris.txt 21
completed	NotreDame_De_Paris.txt 9
completely	NotreDame_De_Paris.txt 18
completing	NotreDame_De_Paris.txt 1
completion	NotreDame_De_Paris.txt 1
complex	NotreDame_De_Paris.txt 3
complexion	NotreDame_De_Paris.txt 1
compliance	NotreDame_De_Paris.txt 5
complicated	NotreDame_De_Paris.txt 7
complicity	NotreDame_De_Paris.txt 2
compliment	NotreDame_De_Paris.txt 1
complimenting	NotreDame_De_Paris.txt 1
compliments	NotreDame_De_Paris.txt 1
compline	NotreDame_De_Paris.txt 1
comply	NotreDame_De_Paris.txt 6
complying	NotreDame_De_Paris.txt 4
component	NotreDame_De_Paris.txt 1
compose	NotreDame_De_Paris.txt 1
composed	NotreDame_De_Paris.txt 8
composer	NotreDame_De_Paris.txt 1
composing	NotreDame_De_Paris.txt 2
composition	NotreDame_De_Paris.txt 1
composure	NotreDame_De_Paris.txt 2
compound	NotreDame_De_Paris.txt 1
comprar	NotreDame_De_Paris.txt 1
comprehend	NotreDame_De_Paris.txt 6
comprehended	NotreDame_De_Paris.txt 2
comprehending	NotreDame_De_Paris.txt 3
comprehensible	NotreDame_De_Paris.txt 1
comprehensive	NotreDame_De_Paris.txt 1
compressed	NotreDame_De_Paris.txt 3
compromising	NotreDame_De_Paris.txt 1
comptes	NotreDame_De_Paris.txt 1
comptroller	NotreDame_De_Paris.txt 1
computer	NotreDame_De_Paris.txt 2
computers	NotreDame_De_Paris.txt 2
comrade	NotreDame_De_Paris.txt 10
comrades	NotreDame_De_Paris.txt 9
comt	NotreDame_De_Paris.txt 1
comte	NotreDame_De_Paris.txt 5
con	NotreDame_De_Paris.txt 2
conceal	NotreDame_De_Paris.txt 9
concealed	NotreDame_De_Paris.txt 24
concealing	NotreDame_De_Paris.txt 1
concede	NotreDame_De_Paris.txt 1
conceits	NotreDame_De_Paris.txt 1
conceived	NotreDame_De_Paris.txt 2
concentrate	NotreDame_De_Paris.txt 1
concentrated	NotreDame_De_Paris.txt 6
concentric	NotreDame_De_Paris.txt 4
concept	NotreDame_De_Paris.txt 2
conception	NotreDame_De_Paris.txt 1
concern	NotreDame_De_Paris.txt 4
concerned	NotreDame_De_Paris.txt 4
concernente	NotreDame_De_Paris.txt 1
concerning	NotreDame_De_Paris.txt 5
concerns	NotreDame_De_Paris.txt 1
concert	NotreDame_De_Paris.txt 5
concession	NotreDame_De_Paris.txt 1
conciliator	NotreDame_De_Paris.txt 1
conclave	NotreDame_De_Paris.txt 2
conclude	NotreDame_De_Paris.txt 1
concluded	NotreDame_De_Paris.txt 3
concluding	NotreDame_De_Paris.txt 4
conclusion	NotreDame_De_Paris.txt 3
conclusive	NotreDame_De_Paris.txt 1
concocting	NotreDame_De_Paris.txt 1
concourse	NotreDame_De_Paris.txt 2
concrete	NotreDame_De_Paris.txt 2
condemn	NotreDame_De_Paris.txt 5
condemnation	NotreDame_De_Paris.txt 3
condemned	NotreDame_De_Paris.txt 36
condemning	NotreDame_De_Paris.txt 2
condensed	NotreDame_De_Paris.txt 1
condescension	NotreDame_De_Paris.txt 1
condiment	NotreDame_De_Paris.txt 1
condition	NotreDame_De_Paris.txt 11
condone	NotreDame_De_Paris.txt 1
conduct	NotreDame_De_Paris.txt 4
conducted	NotreDame_De_Paris.txt 3
conducting	NotreDame_De_Paris.txt 2
conductresses	NotreDame_De_Paris.txt 1
cone	NotreDame_De_Paris.txt 3
confectionery	NotreDame_De_Paris.txt 1
conference	NotreDame_De_Paris.txt 1
conferences	NotreDame_De_Paris.txt 2
confers	NotreDame_De_Paris.txt 1
confess	NotreDame_De_Paris.txt 11
confessed	NotreDame_De_Paris.txt 8
confessing	NotreDame_De_Paris.txt 2
confession	NotreDame_De_Paris.txt 2
confessor	NotreDame_De_Paris.txt 2
confided	NotreDame_De_Paris.txt 2
confidence	NotreDame_De_Paris.txt 2
confiding	NotreDame_De_Paris.txt 2
configuration	NotreDame_De_Paris.txt 1
confine	NotreDame_De_Paris.txt 1
confined	NotreDame_De_Paris.txt 3
confirmation	NotreDame_De_Paris.txt 1
confirmed	NotreDame_De_Paris.txt 2
confiteor	NotreDame_De_Paris.txt 1
conflagration	NotreDame_De_Paris.txt 1
conflans	NotreDame_De_Paris.txt 1
conflict	NotreDame_De_Paris.txt 3
conflicting	NotreDame_De_Paris.txt 1
conformity	NotreDame_De_Paris.txt 1
confound	NotreDame_De_Paris.txt 3
confounded	NotreDame_De_Paris.txt 1
confounding	NotreDame_De_Paris.txt 1
confronting	NotreDame_De_Paris.txt 1
confused	NotreDame_De_Paris.txt 22
confusedly	NotreDame_De_Paris.txt 11
confusing	NotreDame_De_Paris.txt 2
confusion	NotreDame_De_Paris.txt 9
congealed	NotreDame_De_Paris.txt 1
congeals	NotreDame_De_Paris.txt 1
congratulatory	NotreDame_De_Paris.txt 1
congregated	NotreDame_De_Paris.txt 1
congregation	NotreDame_De_Paris.txt 1
congregations	NotreDame_De_Paris.txt 1
conical	NotreDame_De_Paris.txt 1
conjectures	NotreDame_De_Paris.txt 1
conjuncta	NotreDame_De_Paris.txt 1
conjuncture	NotreDame_De_Paris.txt 1
conjunctures	NotreDame_De_Paris.txt 1
conjure	NotreDame_De_Paris.txt 1
conjured	NotreDame_De_Paris.txt 1
conjuring	NotreDame_De_Paris.txt 1
connected	NotreDame_De_Paris.txt 3
connection	NotreDame_De_Paris.txt 4
connoisseur	NotreDame_De_Paris.txt 1
conquered	NotreDame_De_Paris.txt 5
conqueror	NotreDame_De_Paris.txt 2
conquest	NotreDame_De_Paris.txt 1
conscience	NotreDame_De_Paris.txt 5
conscious	NotreDame_De_Paris.txt 9
consciousness	NotreDame_De_Paris.txt 4
consecrate	NotreDame_De_Paris.txt 1
consecrated	NotreDame_De_Paris.txt 2
consecrates	NotreDame_De_Paris.txt 1
consecration	NotreDame_De_Paris.txt 2
consecutive	NotreDame_De_Paris.txt 1
consent	NotreDame_De_Paris.txt 3
consequence	NotreDame_De_Paris.txt 6
consequences	NotreDame_De_Paris.txt 1
consequential	NotreDame_De_Paris.txt 1
consequently	NotreDame_De_Paris.txt 8
conservatione	NotreDame_De_Paris.txt 1
conservative	NotreDame_De_Paris.txt 1
conserve	NotreDame_De_Paris.txt 1
consider	NotreDame_De_Paris.txt 5
considerable	NotreDame_De_Paris.txt 19
considerably	NotreDame_De_Paris.txt 1
considered	NotreDame_De_Paris.txt 8
considering	NotreDame_De_Paris.txt 1
consist	NotreDame_De_Paris.txt 1
consisted	NotreDame_De_Paris.txt 3
consistency	NotreDame_De_Paris.txt 1
consists	NotreDame_De_Paris.txt 2
consolation	NotreDame_De_Paris.txt 6
consoled	NotreDame_De_Paris.txt 2
consoling	NotreDame_De_Paris.txt 2
conspicuous	NotreDame_De_Paris.txt 2
constable	NotreDame_De_Paris.txt 5
constablery	NotreDame_De_Paris.txt 2
constant	NotreDame_De_Paris.txt 5
constantinople	NotreDame_De_Paris.txt 2
constantly	NotreDame_De_Paris.txt 9
constellations	NotreDame_De_Paris.txt 1
consternation	NotreDame_De_Paris.txt 4
constituted	NotreDame_De_Paris.txt 6
constitutes	NotreDame_De_Paris.txt 1
constitution	NotreDame_De_Paris.txt 3
constrain	NotreDame_De_Paris.txt 1
constrained	NotreDame_De_Paris.txt 3
constraint	NotreDame_De_Paris.txt 1
construct	NotreDame_De_Paris.txt 1
constructed	NotreDame_De_Paris.txt 14
construction	NotreDame_De_Paris.txt 5
constructions	NotreDame_De_Paris.txt 1
consubstantial	NotreDame_De_Paris.txt 1
consuetudine	NotreDame_De_Paris.txt 1
consul	NotreDame_De_Paris.txt 1
consult	NotreDame_De_Paris.txt 4
consulted	NotreDame_De_Paris.txt 2
consumed	NotreDame_De_Paris.txt 2
consuming	NotreDame_De_Paris.txt 1
consummated	NotreDame_De_Paris.txt 1
consumptive	NotreDame_De_Paris.txt 1
contact	NotreDame_De_Paris.txt 18
contagious	NotreDame_De_Paris.txt 2
contain	NotreDame_De_Paris.txt 7
contained	NotreDame_De_Paris.txt 10
containing	NotreDame_De_Paris.txt 3
contains	NotreDame_De_Paris.txt 3
contemplate	NotreDame_De_Paris.txt 2
contemplated	NotreDame_De_Paris.txt 6
contemplates	NotreDame_De_Paris.txt 1
contemplating	NotreDame_De_Paris.txt 3
contemplation	NotreDame_De_Paris.txt 9
contemporary	NotreDame_De_Paris.txt 2
contended	NotreDame_De_Paris.txt 1
contending	NotreDame_De_Paris.txt 1
contends	NotreDame_De_Paris.txt 1
content	NotreDame_De_Paris.txt 14
contented	NotreDame_De_Paris.txt 6
contentment	NotreDame_De_Paris.txt 1
contents	NotreDame_De_Paris.txt 5
contest	NotreDame_De_Paris.txt 3
contiguous	NotreDame_De_Paris.txt 2
continentur	NotreDame_De_Paris.txt 1
contingents	NotreDame_De_Paris.txt 1
continual	NotreDame_De_Paris.txt 4
continually	NotreDame_De_Paris.txt 3
continuance	NotreDame_De_Paris.txt 1
continuation	NotreDame_De_Paris.txt 8
continue	NotreDame_De_Paris.txt 16
continued	NotreDame_De_Paris.txt 73
continues	NotreDame_De_Paris.txt 1
continuing	NotreDame_De_Paris.txt 2
contorted	NotreDame_De_Paris.txt 3
contortions	NotreDame_De_Paris.txt 1
contour	NotreDame_De_Paris.txt 1
contract	NotreDame_De_Paris.txt 1
contracted	NotreDame_De_Paris.txt 13
contracting	NotreDame_De_Paris.txt 1
contraction	NotreDame_De_Paris.txt 1
contrary	NotreDame_De_Paris.txt 6
contrast	NotreDame_De_Paris.txt 4
contrasted	NotreDame_De_Paris.txt 1
contribute	NotreDame_De_Paris.txt 1
contributed	NotreDame_De_Paris.txt 4
contributes	NotreDame_De_Paris.txt 1
contribution	NotreDame_De_Paris.txt 1
contributions	NotreDame_De_Paris.txt 2
contrition	NotreDame_De_Paris.txt 2
contrivances	NotreDame_De_Paris.txt 1
contrive	NotreDame_De_Paris.txt 1
contrived	NotreDame_De_Paris.txt 1
control	NotreDame_De_Paris.txt 1
controlled	NotreDame_De_Paris.txt 1
controller	NotreDame_De_Paris.txt 1
controlling	NotreDame_De_Paris.txt 1
contusions	NotreDame_De_Paris.txt 2
conty	NotreDame_De_Paris.txt 1
convenience	NotreDame_De_Paris.txt 1
convenient	NotreDame_De_Paris.txt 1
conveniently	NotreDame_De_Paris.txt 2
convent	NotreDame_De_Paris.txt 2
convents	NotreDame_De_Paris.txt 3
converged	NotreDame_De_Paris.txt 1
conversation	NotreDame_De_Paris.txt 19
conversations	NotreDame_De_Paris.txt 2
converse	NotreDame_De_Paris.txt 3
conversing	NotreDame_De_Paris.txt 3
convert	NotreDame_De_Paris.txt 2
converted	NotreDame_De_Paris.txt 3
converting	NotreDame_De_Paris.txt 1
converts	NotreDame_De_Paris.txt 2
convey	NotreDame_De_Paris.txt 2
convict	NotreDame_De_Paris.txt 1
convicted	NotreDame_De_Paris.txt 1
convincing	NotreDame_De_Paris.txt 1
convulsed	NotreDame_De_Paris.txt 1
convulsion	NotreDame_De_Paris.txt 2
convulsions	NotreDame_De_Paris.txt 4
convulsive	NotreDame_De_Paris.txt 3
convulsively	NotreDame_De_Paris.txt 4
cooings	NotreDame_De_Paris.txt 1
cook	NotreDame_De_Paris.txt 5
cooking	NotreDame_De_Paris.txt 1
cooks	NotreDame_De_Paris.txt 3
cool	NotreDame_De_Paris.txt 2
cooled	NotreDame_De_Paris.txt 1
coolly	NotreDame_De_Paris.txt 2
coolness	NotreDame_De_Paris.txt 1
cope	NotreDame_De_Paris.txt 4
copeaue	NotreDame_De_Paris.txt 1
copes	NotreDame_De_Paris.txt 6
copied	NotreDame_De_Paris.txt 3
copies	NotreDame_De_Paris.txt 9
coppenole	NotreDame_De_Paris.txt 47
copper	NotreDame_De_Paris.txt 12
coppersmith	NotreDame_De_Paris.txt 1
copy	NotreDame_De_Paris.txt 17
copying	NotreDame_De_Paris.txt 4
copyright	NotreDame_De_Paris.txt 14
coquetries	NotreDame_De_Paris.txt 1
coquetry	NotreDame_De_Paris.txt 1
coquettes	NotreDame_De_Paris.txt 1
coquettish	NotreDame_De_Paris.txt 1
cor	NotreDame_De_Paris.txt 1
coralie	NotreDame_De_Paris.txt 1
coram	NotreDame_De_Paris.txt 1
corbacque	NotreDame_De_Paris.txt 1
corbeau	NotreDame_De_Paris.txt 1
corbeil	NotreDame_De_Paris.txt 2
corboeuf	NotreDame_De_Paris.txt 2
cord	NotreDame_De_Paris.txt 1
corde	NotreDame_De_Paris.txt 4
cordeliers	NotreDame_De_Paris.txt 1
corders	NotreDame_De_Paris.txt 1
cordial	NotreDame_De_Paris.txt 2
cordially	NotreDame_De_Paris.txt 2
cordon	NotreDame_De_Paris.txt 2
cordova	NotreDame_De_Paris.txt 2
cordovan	NotreDame_De_Paris.txt 1
cords	NotreDame_De_Paris.txt 2
corinthian	NotreDame_De_Paris.txt 1
cormontreuil	NotreDame_De_Paris.txt 2
corne	NotreDame_De_Paris.txt 8
corneille	NotreDame_De_Paris.txt 2
cornemahom	NotreDame_De_Paris.txt 1
corner	NotreDame_De_Paris.txt 58
corners	NotreDame_De_Paris.txt 14
cornice	NotreDame_De_Paris.txt 1
cornices	NotreDame_De_Paris.txt 1
cornme	NotreDame_De_Paris.txt 1
cornutus	NotreDame_De_Paris.txt 1
corollary	NotreDame_De_Paris.txt 2
coronation	NotreDame_De_Paris.txt 4
coronet	NotreDame_De_Paris.txt 2
corporation	NotreDame_De_Paris.txt 3
corps	NotreDame_De_Paris.txt 2
corpse	NotreDame_De_Paris.txt 1
corpus	NotreDame_De_Paris.txt 1
correct	NotreDame_De_Paris.txt 4
corrected	NotreDame_De_Paris.txt 3
correcting	NotreDame_De_Paris.txt 1
correspond	NotreDame_De_Paris.txt 1
corridor	NotreDame_De_Paris.txt 2
corridors	NotreDame_De_Paris.txt 2
corrosive	NotreDame_De_Paris.txt 1
corrozet	NotreDame_De_Paris.txt 1
corrupt	NotreDame_De_Paris.txt 1
corrupted	NotreDame_De_Paris.txt 1
corsage	NotreDame_De_Paris.txt 3
cortege	NotreDame_De_Paris.txt 3
corvin	NotreDame_De_Paris.txt 1
cosa	NotreDame_De_Paris.txt 1
cossonnerie	NotreDame_De_Paris.txt 1
cost	NotreDame_De_Paris.txt 13
costeth	NotreDame_De_Paris.txt 1
costs	NotreDame_De_Paris.txt 4
costume	NotreDame_De_Paris.txt 15
costumes	NotreDame_De_Paris.txt 2
cosy	NotreDame_De_Paris.txt 1
cothurnus	NotreDame_De_Paris.txt 1
cotier	NotreDame_De_Paris.txt 1
cots	NotreDame_De_Paris.txt 1
cottages	NotreDame_De_Paris.txt 1
couch	NotreDame_De_Paris.txt 3
cough	NotreDame_De_Paris.txt 1
coughed	NotreDame_De_Paris.txt 3
coughing	NotreDame_De_Paris.txt 1
coughs	NotreDame_De_Paris.txt 1
could	NotreDame_De_Paris.txt 185
couldn	NotreDame_De_Paris.txt 1
couldst	NotreDame_De_Paris.txt 2
couleveiniers	NotreDame_De_Paris.txt 1
council	NotreDame_De_Paris.txt 2
councillor	NotreDame_De_Paris.txt 5
councillors	NotreDame_De_Paris.txt 2
councils	NotreDame_De_Paris.txt 1
counsel	NotreDame_De_Paris.txt 2
counsellor	NotreDame_De_Paris.txt 6
counsellors	NotreDame_De_Paris.txt 1
counsels	NotreDame_De_Paris.txt 2
count	NotreDame_De_Paris.txt 4
counted	NotreDame_De_Paris.txt 5
countenance	NotreDame_De_Paris.txt 13
countenances	NotreDame_De_Paris.txt 2
counter	NotreDame_De_Paris.txt 7
counterbands	NotreDame_De_Paris.txt 1
counterfeit	NotreDame_De_Paris.txt 1
counterfeiter	NotreDame_De_Paris.txt 2
counterfeiters	NotreDame_De_Paris.txt 1
counterpart	NotreDame_De_Paris.txt 1
counterpoint	NotreDame_De_Paris.txt 1
counting	NotreDame_De_Paris.txt 1
countries	NotreDame_De_Paris.txt 3
country	NotreDame_De_Paris.txt 21
counts	NotreDame_De_Paris.txt 4
county	NotreDame_De_Paris.txt 1
coupe	NotreDame_De_Paris.txt 5
couple	NotreDame_De_Paris.txt 2
coupled	NotreDame_De_Paris.txt 3
couples	NotreDame_De_Paris.txt 3
couplets	NotreDame_De_Paris.txt 1
cour	NotreDame_De_Paris.txt 11
courage	NotreDame_De_Paris.txt 7
courcy	NotreDame_De_Paris.txt 1
couronnes	NotreDame_De_Paris.txt 1
course	NotreDame_De_Paris.txt 30
courses	NotreDame_De_Paris.txt 1
court	NotreDame_De_Paris.txt 47
courteous	NotreDame_De_Paris.txt 1
courtesan	NotreDame_De_Paris.txt 2
courtesy	NotreDame_De_Paris.txt 2
courtier	NotreDame_De_Paris.txt 2
courtiers	NotreDame_De_Paris.txt 3
courtille	NotreDame_De_Paris.txt 3
courting	NotreDame_De_Paris.txt 1
courts	NotreDame_De_Paris.txt 27
courtyard	NotreDame_De_Paris.txt 6
courtyards	NotreDame_De_Paris.txt 2
cousin	NotreDame_De_Paris.txt 30
coutellerie	NotreDame_De_Paris.txt 3
couvrent	NotreDame_De_Paris.txt 1
cover	NotreDame_De_Paris.txt 9
covered	NotreDame_De_Paris.txt 37
covering	NotreDame_De_Paris.txt 2
coverlet	NotreDame_De_Paris.txt 2
covertly	NotreDame_De_Paris.txt 1
covey	NotreDame_De_Paris.txt 1
cow	NotreDame_De_Paris.txt 3
cowardly	NotreDame_De_Paris.txt 2
cowards	NotreDame_De_Paris.txt 2
cower	NotreDame_De_Paris.txt 1
cowering	NotreDame_De_Paris.txt 1
cowl	NotreDame_De_Paris.txt 6
cowls	NotreDame_De_Paris.txt 1
cowper	NotreDame_De_Paris.txt 1
cows	NotreDame_De_Paris.txt 2
crabbed	NotreDame_De_Paris.txt 5
crabs	NotreDame_De_Paris.txt 1
crack	NotreDame_De_Paris.txt 4
cracked	NotreDame_De_Paris.txt 13
cracker	NotreDame_De_Paris.txt 2
crackers	NotreDame_De_Paris.txt 1
cracking	NotreDame_De_Paris.txt 2
crackled	NotreDame_De_Paris.txt 1
crackling	NotreDame_De_Paris.txt 1
cracks	NotreDame_De_Paris.txt 2
cradle	NotreDame_De_Paris.txt 4
craft	NotreDame_De_Paris.txt 2
crafty	NotreDame_De_Paris.txt 2
crammed	NotreDame_De_Paris.txt 1
cramped	NotreDame_De_Paris.txt 2
cramps	NotreDame_De_Paris.txt 1
crams	NotreDame_De_Paris.txt 1
cranequiniers	NotreDame_De_Paris.txt 1
crape	NotreDame_De_Paris.txt 1
crashed	NotreDame_De_Paris.txt 1
crater	NotreDame_De_Paris.txt 1
craving	NotreDame_De_Paris.txt 1
cravings	NotreDame_De_Paris.txt 1
crawl	NotreDame_De_Paris.txt 2
crawled	NotreDame_De_Paris.txt 3
crawling	NotreDame_De_Paris.txt 7
crawls	NotreDame_De_Paris.txt 1
crazy	NotreDame_De_Paris.txt 1
creak	NotreDame_De_Paris.txt 2
creaked	NotreDame_De_Paris.txt 2
creaking	NotreDame_De_Paris.txt 1
created	NotreDame_De_Paris.txt 9
creating	NotreDame_De_Paris.txt 4
creation	NotreDame_De_Paris.txt 5
creature	NotreDame_De_Paris.txt 47
creatures	NotreDame_De_Paris.txt 4
creber	NotreDame_De_Paris.txt 1
credible	NotreDame_De_Paris.txt 2
credit	NotreDame_De_Paris.txt 5
creditors	NotreDame_De_Paris.txt 1
credo	NotreDame_De_Paris.txt 2
credulous	NotreDame_De_Paris.txt 1
creep	NotreDame_De_Paris.txt 1
creeping	NotreDame_De_Paris.txt 2
crenelated	NotreDame_De_Paris.txt 1
crenellated	NotreDame_De_Paris.txt 1
crepitans	NotreDame_De_Paris.txt 1
crescendo	NotreDame_De_Paris.txt 1
crescent	NotreDame_De_Paris.txt 5
crescents	NotreDame_De_Paris.txt 1
crest	NotreDame_De_Paris.txt 3
crests	NotreDame_De_Paris.txt 2
crete	NotreDame_De_Paris.txt 2
crevice	NotreDame_De_Paris.txt 2
crevices	NotreDame_De_Paris.txt 2
crew	NotreDame_De_Paris.txt 1
cribbed	NotreDame_De_Paris.txt 1
cricket	NotreDame_De_Paris.txt 2
cried	NotreDame_De_Paris.txt 85
cries	NotreDame_De_Paris.txt 20
crime	NotreDame_De_Paris.txt 8
crimes	NotreDame_De_Paris.txt 4
criminal	NotreDame_De_Paris.txt 18
criminals	NotreDame_De_Paris.txt 1
crimine	NotreDame_De_Paris.txt 1
criminis	NotreDame_De_Paris.txt 1
crimson	NotreDame_De_Paris.txt 8
crimsoned	NotreDame_De_Paris.txt 1
cripple	NotreDame_De_Paris.txt 6
crippled	NotreDame_De_Paris.txt 2
cripples	NotreDame_De_Paris.txt 5
crisis	NotreDame_De_Paris.txt 2
critic	NotreDame_De_Paris.txt 1
critical	NotreDame_De_Paris.txt 9
criticise	NotreDame_De_Paris.txt 1
criticism	NotreDame_De_Paris.txt 2
croaking	NotreDame_De_Paris.txt 1
crock	NotreDame_De_Paris.txt 7
crocodile	NotreDame_De_Paris.txt 5
croix	NotreDame_De_Paris.txt 4
cromlech	NotreDame_De_Paris.txt 2
crone	NotreDame_De_Paris.txt 11
crones	NotreDame_De_Paris.txt 1
crooked	NotreDame_De_Paris.txt 4
cropping	NotreDame_De_Paris.txt 2
croque	NotreDame_De_Paris.txt 2
crosier	NotreDame_De_Paris.txt 2
cross	NotreDame_De_Paris.txt 58
crossbow	NotreDame_De_Paris.txt 4
crossbows	NotreDame_De_Paris.txt 1
crossed	NotreDame_De_Paris.txt 15
crosses	NotreDame_De_Paris.txt 6
crossing	NotreDame_De_Paris.txt 5
crossings	NotreDame_De_Paris.txt 1
crouch	NotreDame_De_Paris.txt 2
crouched	NotreDame_De_Paris.txt 7
crouching	NotreDame_De_Paris.txt 14
crowbars	NotreDame_De_Paris.txt 3
crowd	NotreDame_De_Paris.txt 89
crowded	NotreDame_De_Paris.txt 12
crown	NotreDame_De_Paris.txt 34
crowned	NotreDame_De_Paris.txt 10
crowning	NotreDame_De_Paris.txt 2
crowns	NotreDame_De_Paris.txt 9
crows	NotreDame_De_Paris.txt 2
crozier	NotreDame_De_Paris.txt 1
croziers	NotreDame_De_Paris.txt 1
crucesque	NotreDame_De_Paris.txt 1
crucible	NotreDame_De_Paris.txt 2
crucifixion	NotreDame_De_Paris.txt 1
cruel	NotreDame_De_Paris.txt 6
cruelly	NotreDame_De_Paris.txt 3
cruelties	NotreDame_De_Paris.txt 1
crumble	NotreDame_De_Paris.txt 6
crumbled	NotreDame_De_Paris.txt 1
crumbling	NotreDame_De_Paris.txt 3
crumbs	NotreDame_De_Paris.txt 2
crupper	NotreDame_De_Paris.txt 2
cruppers	NotreDame_De_Paris.txt 1
crusade	NotreDame_De_Paris.txt 1
crusades	NotreDame_De_Paris.txt 4
crush	NotreDame_De_Paris.txt 2
crushed	NotreDame_De_Paris.txt 11
crushes	NotreDame_De_Paris.txt 1
crushing	NotreDame_De_Paris.txt 1
crust	NotreDame_De_Paris.txt 5
crutch	NotreDame_De_Paris.txt 1
crutches	NotreDame_De_Paris.txt 3
cry	NotreDame_De_Paris.txt 38
crying	NotreDame_De_Paris.txt 14
crystal	NotreDame_De_Paris.txt 4
crystallization	NotreDame_De_Paris.txt 1
crystals	NotreDame_De_Paris.txt 1
cub	NotreDame_De_Paris.txt 1
cube	NotreDame_De_Paris.txt 2
cubic	NotreDame_De_Paris.txt 1
cubit	NotreDame_De_Paris.txt 2
cudgel	NotreDame_De_Paris.txt 3
cudgelled	NotreDame_De_Paris.txt 1
cudgelling	NotreDame_De_Paris.txt 1
cudgels	NotreDame_De_Paris.txt 1
cuellos	NotreDame_De_Paris.txt 1
cuffs	NotreDame_De_Paris.txt 1
cuiquam	NotreDame_De_Paris.txt 1
cuirass	NotreDame_De_Paris.txt 2
cuirassed	NotreDame_De_Paris.txt 1
cujus	NotreDame_De_Paris.txt 1
culminating	NotreDame_De_Paris.txt 3
culprit	NotreDame_De_Paris.txt 3
cultivated	NotreDame_De_Paris.txt 4
culverines	NotreDame_De_Paris.txt 1
cum	NotreDame_De_Paris.txt 8
cup	NotreDame_De_Paris.txt 4
cupa	NotreDame_De_Paris.txt 1
cupam	NotreDame_De_Paris.txt 1
cupboard	NotreDame_De_Paris.txt 2
cupboards	NotreDame_De_Paris.txt 1
cupido	NotreDame_De_Paris.txt 2
cupids	NotreDame_De_Paris.txt 1
cups	NotreDame_De_Paris.txt 1
cur	NotreDame_De_Paris.txt 2
curacies	NotreDame_De_Paris.txt 1
cure	NotreDame_De_Paris.txt 2
cured	NotreDame_De_Paris.txt 5
curfew	NotreDame_De_Paris.txt 4
curiosities	NotreDame_De_Paris.txt 1
curiosity	NotreDame_De_Paris.txt 10
curious	NotreDame_De_Paris.txt 23
curiously	NotreDame_De_Paris.txt 4
curled	NotreDame_De_Paris.txt 2
curling	NotreDame_De_Paris.txt 1
curly	NotreDame_De_Paris.txt 4
current	NotreDame_De_Paris.txt 9
currents	NotreDame_De_Paris.txt 2
curried	NotreDame_De_Paris.txt 1
currit	NotreDame_De_Paris.txt 1
curse	NotreDame_De_Paris.txt 6
cursed	NotreDame_De_Paris.txt 10
curses	NotreDame_De_Paris.txt 1
cursing	NotreDame_De_Paris.txt 3
curt	NotreDame_De_Paris.txt 4
curta	NotreDame_De_Paris.txt 1
curtain	NotreDame_De_Paris.txt 2
curtains	NotreDame_De_Paris.txt 1
curve	NotreDame_De_Paris.txt 2
curves	NotreDame_De_Paris.txt 1
cushions	NotreDame_De_Paris.txt 1
custom	NotreDame_De_Paris.txt 9
customary	NotreDame_De_Paris.txt 2
customers	NotreDame_De_Paris.txt 1
customs	NotreDame_De_Paris.txt 3
custos	NotreDame_De_Paris.txt 2
cut	NotreDame_De_Paris.txt 46
cutlass	NotreDame_De_Paris.txt 1
cutpurse	NotreDame_De_Paris.txt 1
cutpurses	NotreDame_De_Paris.txt 1
cutter	NotreDame_De_Paris.txt 1
cutting	NotreDame_De_Paris.txt 2
cuyere	NotreDame_De_Paris.txt 1
cy	NotreDame_De_Paris.txt 1
cyclopean	NotreDame_De_Paris.txt 4
cyclops	NotreDame_De_Paris.txt 5
cygne	NotreDame_De_Paris.txt 1
cynicism	NotreDame_De_Paris.txt 1
cyprus	NotreDame_De_Paris.txt 1
cyrus	NotreDame_De_Paris.txt 1
