n	NotreDame_De_Paris.txt 8
na	NotreDame_De_Paris.txt 2
nacelle	NotreDame_De_Paris.txt 1
nadir	NotreDame_De_Paris.txt 1
nail	NotreDame_De_Paris.txt 7
nailed	NotreDame_De_Paris.txt 2
nails	NotreDame_De_Paris.txt 18
naively	NotreDame_De_Paris.txt 3
naivete	NotreDame_De_Paris.txt 2
naked	NotreDame_De_Paris.txt 16
nal	NotreDame_De_Paris.txt 1
name	NotreDame_De_Paris.txt 124
named	NotreDame_De_Paris.txt 7
names	NotreDame_De_Paris.txt 16
naming	NotreDame_De_Paris.txt 1
nape	NotreDame_De_Paris.txt 1
napery	NotreDame_De_Paris.txt 1
napoleon	NotreDame_De_Paris.txt 2
naquois	NotreDame_De_Paris.txt 1
narde	NotreDame_De_Paris.txt 18
narrow	NotreDame_De_Paris.txt 16
narrower	NotreDame_De_Paris.txt 2
narrowly	NotreDame_De_Paris.txt 1
nasal	NotreDame_De_Paris.txt 3
nasally	NotreDame_De_Paris.txt 1
naso	NotreDame_De_Paris.txt 1
nasum	NotreDame_De_Paris.txt 1
nation	NotreDame_De_Paris.txt 8
national	NotreDame_De_Paris.txt 1
nations	NotreDame_De_Paris.txt 4
native	NotreDame_De_Paris.txt 1
natural	NotreDame_De_Paris.txt 13
naturally	NotreDame_De_Paris.txt 1
nature	NotreDame_De_Paris.txt 27
naught	NotreDame_De_Paris.txt 3
naughty	NotreDame_De_Paris.txt 2
navarre	NotreDame_De_Paris.txt 1
nave	NotreDame_De_Paris.txt 15
naves	NotreDame_De_Paris.txt 1
ne	NotreDame_De_Paris.txt 9
neapolitan	NotreDame_De_Paris.txt 1
near	NotreDame_De_Paris.txt 49
nearer	NotreDame_De_Paris.txt 8
nearest	NotreDame_De_Paris.txt 2
nearing	NotreDame_De_Paris.txt 1
nearly	NotreDame_De_Paris.txt 17
neatness	NotreDame_De_Paris.txt 1
nec	NotreDame_De_Paris.txt 1
necessarily	NotreDame_De_Paris.txt 4
necessary	NotreDame_De_Paris.txt 17
necessities	NotreDame_De_Paris.txt 1
necessity	NotreDame_De_Paris.txt 5
neck	NotreDame_De_Paris.txt 51
necklace	NotreDame_De_Paris.txt 1
necks	NotreDame_De_Paris.txt 3
necromancy	NotreDame_De_Paris.txt 1
need	NotreDame_De_Paris.txt 26
needed	NotreDame_De_Paris.txt 8
needle	NotreDame_De_Paris.txt 1
needles	NotreDame_De_Paris.txt 2
needlework	NotreDame_De_Paris.txt 1
needs	NotreDame_De_Paris.txt 4
nefas	NotreDame_De_Paris.txt 1
negative	NotreDame_De_Paris.txt 2
neglected	NotreDame_De_Paris.txt 2
neglecting	NotreDame_De_Paris.txt 2
negligence	NotreDame_De_Paris.txt 2
negligent	NotreDame_De_Paris.txt 1
negligently	NotreDame_De_Paris.txt 2
nego	NotreDame_De_Paris.txt 1
neighbor	NotreDame_De_Paris.txt 24
neighborhood	NotreDame_De_Paris.txt 2
neighboring	NotreDame_De_Paris.txt 8
neighbors	NotreDame_De_Paris.txt 15
neighed	NotreDame_De_Paris.txt 1
neither	NotreDame_De_Paris.txt 46
nemours	NotreDame_De_Paris.txt 3
nephew	NotreDame_De_Paris.txt 3
neptune	NotreDame_De_Paris.txt 2
neptunerie	NotreDame_De_Paris.txt 1
neptunus	NotreDame_De_Paris.txt 1
nerros	NotreDame_De_Paris.txt 1
nes	NotreDame_De_Paris.txt 1
nesle	NotreDame_De_Paris.txt 8
ness	NotreDame_De_Paris.txt 2
nest	NotreDame_De_Paris.txt 6
nestled	NotreDame_De_Paris.txt 1
nestling	NotreDame_De_Paris.txt 1
nestor	NotreDame_De_Paris.txt 1
nests	NotreDame_De_Paris.txt 2
net	NotreDame_De_Paris.txt 1
network	NotreDame_De_Paris.txt 4
neuf	NotreDame_De_Paris.txt 5
neufs	NotreDame_De_Paris.txt 1
neutralizing	NotreDame_De_Paris.txt 1
neuve	NotreDame_De_Paris.txt 2
never	NotreDame_De_Paris.txt 90
nevers	NotreDame_De_Paris.txt 1
nevertheless	NotreDame_De_Paris.txt 80
new	NotreDame_De_Paris.txt 71
newby	NotreDame_De_Paris.txt 1
newcomer	NotreDame_De_Paris.txt 1
newer	NotreDame_De_Paris.txt 1
newly	NotreDame_De_Paris.txt 2
news	NotreDame_De_Paris.txt 4
newsletter	NotreDame_De_Paris.txt 1
next	NotreDame_De_Paris.txt 14
ni	NotreDame_De_Paris.txt 6
nibelungen	NotreDame_De_Paris.txt 2
nice	NotreDame_De_Paris.txt 1
niche	NotreDame_De_Paris.txt 3
niches	NotreDame_De_Paris.txt 3
nicholas	NotreDame_De_Paris.txt 5
nick	NotreDame_De_Paris.txt 1
nicolas	NotreDame_De_Paris.txt 7
niggardly	NotreDame_De_Paris.txt 1
nigh	NotreDame_De_Paris.txt 1
night	NotreDame_De_Paris.txt 132
nightcaps	NotreDame_De_Paris.txt 1
nightfall	NotreDame_De_Paris.txt 3
nightingale	NotreDame_De_Paris.txt 1
nightmare	NotreDame_De_Paris.txt 3
nightmares	NotreDame_De_Paris.txt 1
nights	NotreDame_De_Paris.txt 4
nile	NotreDame_De_Paris.txt 1
nimbly	NotreDame_De_Paris.txt 3
nine	NotreDame_De_Paris.txt 8
nineteen	NotreDame_De_Paris.txt 4
nineteenth	NotreDame_De_Paris.txt 2
ninety	NotreDame_De_Paris.txt 2
ninnies	NotreDame_De_Paris.txt 1
ninth	NotreDame_De_Paris.txt 4
nipples	NotreDame_De_Paris.txt 1
nitric	NotreDame_De_Paris.txt 1
no	NotreDame_De_Paris.txt 540
noah	NotreDame_De_Paris.txt 1
nobility	NotreDame_De_Paris.txt 9
noble	NotreDame_De_Paris.txt 15
nobleman	NotreDame_De_Paris.txt 1
nobler	NotreDame_De_Paris.txt 1
nobles	NotreDame_De_Paris.txt 1
nobly	NotreDame_De_Paris.txt 1
nobody	NotreDame_De_Paris.txt 1
nocturnal	NotreDame_De_Paris.txt 7
nodded	NotreDame_De_Paris.txt 1
noel	NotreDame_De_Paris.txt 12
noiret	NotreDame_De_Paris.txt 1
noise	NotreDame_De_Paris.txt 50
noised	NotreDame_De_Paris.txt 1
noiselessly	NotreDame_De_Paris.txt 1
noises	NotreDame_De_Paris.txt 3
noisily	NotreDame_De_Paris.txt 3
noisome	NotreDame_De_Paris.txt 1
noisy	NotreDame_De_Paris.txt 11
noli	NotreDame_De_Paris.txt 1
nom	NotreDame_De_Paris.txt 1
nombril	NotreDame_De_Paris.txt 1
nombrill	NotreDame_De_Paris.txt 1
nomen	NotreDame_De_Paris.txt 1
nominor	NotreDame_De_Paris.txt 1
non	NotreDame_De_Paris.txt 18
nonaindi	NotreDame_De_Paris.txt 1
none	NotreDame_De_Paris.txt 16
nonproprietary	NotreDame_De_Paris.txt 1
nonsense	NotreDame_De_Paris.txt 4
nook	NotreDame_De_Paris.txt 4
nooks	NotreDame_De_Paris.txt 1
noon	NotreDame_De_Paris.txt 2
noonday	NotreDame_De_Paris.txt 4
noose	NotreDame_De_Paris.txt 5
nor	NotreDame_De_Paris.txt 84
nordhausen	NotreDame_De_Paris.txt 1
norimbergoe	NotreDame_De_Paris.txt 1
normal	NotreDame_De_Paris.txt 1
norman	NotreDame_De_Paris.txt 2
normandy	NotreDame_De_Paris.txt 2
normans	NotreDame_De_Paris.txt 1
nornine	NotreDame_De_Paris.txt 1
north	NotreDame_De_Paris.txt 11
northern	NotreDame_De_Paris.txt 4
northward	NotreDame_De_Paris.txt 1
nos	NotreDame_De_Paris.txt 1
nose	NotreDame_De_Paris.txt 24
nosed	NotreDame_De_Paris.txt 1
nosegay	NotreDame_De_Paris.txt 1
noses	NotreDame_De_Paris.txt 2
noster	NotreDame_De_Paris.txt 2
nostrils	NotreDame_De_Paris.txt 3
nostroe	NotreDame_De_Paris.txt 3
nostrum	NotreDame_De_Paris.txt 1
not	NotreDame_De_Paris.txt 1133
notable	NotreDame_De_Paris.txt 3
notary	NotreDame_De_Paris.txt 5
notch	NotreDame_De_Paris.txt 1
notched	NotreDame_De_Paris.txt 6
note	NotreDame_De_Paris.txt 7
noted	NotreDame_De_Paris.txt 1
notes	NotreDame_De_Paris.txt 3
nothing	NotreDame_De_Paris.txt 149
nothingness	NotreDame_De_Paris.txt 3
notice	NotreDame_De_Paris.txt 6
noticeable	NotreDame_De_Paris.txt 1
noticed	NotreDame_De_Paris.txt 26
noticing	NotreDame_De_Paris.txt 1
notifies	NotreDame_De_Paris.txt 1
notify	NotreDame_De_Paris.txt 1
notre	NotreDame_De_Paris.txt 153
nourish	NotreDame_De_Paris.txt 1
nourished	NotreDame_De_Paris.txt 3
nourishment	NotreDame_De_Paris.txt 1
nova	NotreDame_De_Paris.txt 1
novelty	NotreDame_De_Paris.txt 1
november	NotreDame_De_Paris.txt 3
novice	NotreDame_De_Paris.txt 1
now	NotreDame_De_Paris.txt 141
nowadays	NotreDame_De_Paris.txt 4
noyon	NotreDame_De_Paris.txt 1
nuces	NotreDame_De_Paris.txt 1
nude	NotreDame_De_Paris.txt 2
nudity	NotreDame_De_Paris.txt 1
nudus	NotreDame_De_Paris.txt 1
nuevas	NotreDame_De_Paris.txt 1
nuit	NotreDame_De_Paris.txt 2
nullo	NotreDame_De_Paris.txt 2
nullus	NotreDame_De_Paris.txt 1
number	NotreDame_De_Paris.txt 24
numberless	NotreDame_De_Paris.txt 4
numbers	NotreDame_De_Paris.txt 3
numbness	NotreDame_De_Paris.txt 1
numellas	NotreDame_De_Paris.txt 1
numen	NotreDame_De_Paris.txt 1
numerous	NotreDame_De_Paris.txt 11
nun	NotreDame_De_Paris.txt 10
nunc	NotreDame_De_Paris.txt 1
nunlike	NotreDame_De_Paris.txt 1
nuns	NotreDame_De_Paris.txt 2
nuper	NotreDame_De_Paris.txt 1
nuptial	NotreDame_De_Paris.txt 2
nuremberg	NotreDame_De_Paris.txt 2
nurse	NotreDame_De_Paris.txt 2
nursed	NotreDame_De_Paris.txt 1
nurses	NotreDame_De_Paris.txt 1
nursing	NotreDame_De_Paris.txt 1
nut	NotreDame_De_Paris.txt 3
nutshell	NotreDame_De_Paris.txt 1
nymph	NotreDame_De_Paris.txt 1
nypho	NotreDame_De_Paris.txt 1
