s	NotreDame_De_Paris.txt 681
sa	NotreDame_De_Paris.txt 1
sabbath	NotreDame_De_Paris.txt 12
sabbaths	NotreDame_De_Paris.txt 1
sables	NotreDame_De_Paris.txt 1
sabnac	NotreDame_De_Paris.txt 1
sacerdotal	NotreDame_De_Paris.txt 4
sacerdotalism	NotreDame_De_Paris.txt 1
sachette	NotreDame_De_Paris.txt 2
sack	NotreDame_De_Paris.txt 20
sacked	NotreDame_De_Paris.txt 10
sacks	NotreDame_De_Paris.txt 1
sacred	NotreDame_De_Paris.txt 14
sacrifice	NotreDame_De_Paris.txt 3
sacrifices	NotreDame_De_Paris.txt 1
sacrilege	NotreDame_De_Paris.txt 2
sacristan	NotreDame_De_Paris.txt 1
sacristries	NotreDame_De_Paris.txt 1
sacristy	NotreDame_De_Paris.txt 2
sad	NotreDame_De_Paris.txt 18
saddened	NotreDame_De_Paris.txt 1
saddle	NotreDame_De_Paris.txt 6
sadly	NotreDame_De_Paris.txt 12
sadness	NotreDame_De_Paris.txt 7
safe	NotreDame_De_Paris.txt 4
safeguard	NotreDame_De_Paris.txt 1
safekeeping	NotreDame_De_Paris.txt 2
safer	NotreDame_De_Paris.txt 1
safety	NotreDame_De_Paris.txt 5
sagacious	NotreDame_De_Paris.txt 3
sagacity	NotreDame_De_Paris.txt 1
sage	NotreDame_De_Paris.txt 3
sages	NotreDame_De_Paris.txt 1
said	NotreDame_De_Paris.txt 720
saillarde	NotreDame_De_Paris.txt 1
saint	NotreDame_De_Paris.txt 215
sainte	NotreDame_De_Paris.txt 38
saints	NotreDame_De_Paris.txt 9
saisina	NotreDame_De_Paris.txt 1
saith	NotreDame_De_Paris.txt 7
sake	NotreDame_De_Paris.txt 18
salamander	NotreDame_De_Paris.txt 2
salamanders	NotreDame_De_Paris.txt 1
salaries	NotreDame_De_Paris.txt 1
salary	NotreDame_De_Paris.txt 3
salic	NotreDame_De_Paris.txt 1
salient	NotreDame_De_Paris.txt 2
sally	NotreDame_De_Paris.txt 1
salmon	NotreDame_De_Paris.txt 1
salons	NotreDame_De_Paris.txt 1
salsify	NotreDame_De_Paris.txt 1
salt	NotreDame_De_Paris.txt 3
salts	NotreDame_De_Paris.txt 1
salus	NotreDame_De_Paris.txt 1
salutations	NotreDame_De_Paris.txt 1
salute	NotreDame_De_Paris.txt 2
saluted	NotreDame_De_Paris.txt 8
saluting	NotreDame_De_Paris.txt 1
salva	NotreDame_De_Paris.txt 1
salvation	NotreDame_De_Paris.txt 1
salvator	NotreDame_De_Paris.txt 1
salve	NotreDame_De_Paris.txt 2
salvien	NotreDame_De_Paris.txt 1
salvum	NotreDame_De_Paris.txt 2
samaritan	NotreDame_De_Paris.txt 1
same	NotreDame_De_Paris.txt 134
samuel	NotreDame_De_Paris.txt 1
sancti	NotreDame_De_Paris.txt 1
sanctity	NotreDame_De_Paris.txt 2
sanctoe	NotreDame_De_Paris.txt 1
sanctuaries	NotreDame_De_Paris.txt 1
sanctuary	NotreDame_De_Paris.txt 19
sanctus	NotreDame_De_Paris.txt 1
sand	NotreDame_De_Paris.txt 2
sandal	NotreDame_De_Paris.txt 1
sandstone	NotreDame_De_Paris.txt 1
sang	NotreDame_De_Paris.txt 11
sanguin	NotreDame_De_Paris.txt 1
sanguine	NotreDame_De_Paris.txt 1
sank	NotreDame_De_Paris.txt 10
sans	NotreDame_De_Paris.txt 2
saouls	NotreDame_De_Paris.txt 3
sap	NotreDame_De_Paris.txt 6
sapere	NotreDame_De_Paris.txt 1
sapientes	NotreDame_De_Paris.txt 1
sapin	NotreDame_De_Paris.txt 1
sapping	NotreDame_De_Paris.txt 1
sarabands	NotreDame_De_Paris.txt 1
saracen	NotreDame_De_Paris.txt 2
saracens	NotreDame_De_Paris.txt 1
sarcasm	NotreDame_De_Paris.txt 1
sarcasms	NotreDame_De_Paris.txt 2
sarcophagus	NotreDame_De_Paris.txt 1
sardonic	NotreDame_De_Paris.txt 1
sardonical	NotreDame_De_Paris.txt 1
sash	NotreDame_De_Paris.txt 1
sat	NotreDame_De_Paris.txt 9
satan	NotreDame_De_Paris.txt 8
satanic	NotreDame_De_Paris.txt 1
satans	NotreDame_De_Paris.txt 1
satiated	NotreDame_De_Paris.txt 1
satin	NotreDame_De_Paris.txt 5
satire	NotreDame_De_Paris.txt 2
satis	NotreDame_De_Paris.txt 1
satisfaction	NotreDame_De_Paris.txt 5
satisfactory	NotreDame_De_Paris.txt 1
satisfied	NotreDame_De_Paris.txt 5
satisfy	NotreDame_De_Paris.txt 2
saturated	NotreDame_De_Paris.txt 1
saturday	NotreDame_De_Paris.txt 3
saturn	NotreDame_De_Paris.txt 1
saturnalia	NotreDame_De_Paris.txt 1
saturnalitias	NotreDame_De_Paris.txt 1
sauce	NotreDame_De_Paris.txt 1
saucy	NotreDame_De_Paris.txt 1
sauntering	NotreDame_De_Paris.txt 1
sauval	NotreDame_De_Paris.txt 5
sauvel	NotreDame_De_Paris.txt 1
sauveur	NotreDame_De_Paris.txt 1
savage	NotreDame_De_Paris.txt 11
savagely	NotreDame_De_Paris.txt 2
savages	NotreDame_De_Paris.txt 1
savant	NotreDame_De_Paris.txt 2
savaterie	NotreDame_De_Paris.txt 2
save	NotreDame_De_Paris.txt 28
saved	NotreDame_De_Paris.txt 22
saves	NotreDame_De_Paris.txt 1
saving	NotreDame_De_Paris.txt 6
saviour	NotreDame_De_Paris.txt 2
savory	NotreDame_De_Paris.txt 1
savoy	NotreDame_De_Paris.txt 3
saw	NotreDame_De_Paris.txt 83
sawed	NotreDame_De_Paris.txt 1
sawing	NotreDame_De_Paris.txt 1
sawn	NotreDame_De_Paris.txt 1
saws	NotreDame_De_Paris.txt 1
saxon	NotreDame_De_Paris.txt 6
say	NotreDame_De_Paris.txt 141
saying	NotreDame_De_Paris.txt 46
says	NotreDame_De_Paris.txt 28
scabbard	NotreDame_De_Paris.txt 1
scabby	NotreDame_De_Paris.txt 1
scaffold	NotreDame_De_Paris.txt 4
scaffolding	NotreDame_De_Paris.txt 3
scaffoldings	NotreDame_De_Paris.txt 2
scale	NotreDame_De_Paris.txt 5
scaled	NotreDame_De_Paris.txt 2
scales	NotreDame_De_Paris.txt 7
scamp	NotreDame_De_Paris.txt 8
scamps	NotreDame_De_Paris.txt 4
scandal	NotreDame_De_Paris.txt 1
scandalized	NotreDame_De_Paris.txt 2
scandalo	NotreDame_De_Paris.txt 1
scandals	NotreDame_De_Paris.txt 1
scantily	NotreDame_De_Paris.txt 1
scanty	NotreDame_De_Paris.txt 1
scapegrace	NotreDame_De_Paris.txt 1
scar	NotreDame_De_Paris.txt 2
scarecrow	NotreDame_De_Paris.txt 1
scarf	NotreDame_De_Paris.txt 1
scarfs	NotreDame_De_Paris.txt 2
scarlet	NotreDame_De_Paris.txt 12
scatter	NotreDame_De_Paris.txt 2
scattered	NotreDame_De_Paris.txt 20
scattering	NotreDame_De_Paris.txt 1
scatters	NotreDame_De_Paris.txt 2
scavengers	NotreDame_De_Paris.txt 1
scene	NotreDame_De_Paris.txt 22
scenes	NotreDame_De_Paris.txt 4
sceptic	NotreDame_De_Paris.txt 1
sceptical	NotreDame_De_Paris.txt 2
sceptics	NotreDame_De_Paris.txt 1
scharnachtal	NotreDame_De_Paris.txt 1
scheme	NotreDame_De_Paris.txt 1
schism	NotreDame_De_Paris.txt 2
scholar	NotreDame_De_Paris.txt 55
scholars	NotreDame_De_Paris.txt 17
scholastic	NotreDame_De_Paris.txt 2
scholastics	NotreDame_De_Paris.txt 1
school	NotreDame_De_Paris.txt 10
schoolboys	NotreDame_De_Paris.txt 1
schoolmaster	NotreDame_De_Paris.txt 1
schools	NotreDame_De_Paris.txt 3
scie	NotreDame_De_Paris.txt 1
science	NotreDame_De_Paris.txt 36
sciences	NotreDame_De_Paris.txt 2
scientific	NotreDame_De_Paris.txt 1
scilicet	NotreDame_De_Paris.txt 1
scoff	NotreDame_De_Paris.txt 1
scoffing	NotreDame_De_Paris.txt 2
scoffs	NotreDame_De_Paris.txt 1
scold	NotreDame_De_Paris.txt 1
scolded	NotreDame_De_Paris.txt 1
scolding	NotreDame_De_Paris.txt 3
score	NotreDame_De_Paris.txt 11
scores	NotreDame_De_Paris.txt 1
scorn	NotreDame_De_Paris.txt 2
scorpions	NotreDame_De_Paris.txt 1
scotch	NotreDame_De_Paris.txt 2
scourable	NotreDame_De_Paris.txt 1
scourging	NotreDame_De_Paris.txt 1
scowl	NotreDame_De_Paris.txt 1
scowled	NotreDame_De_Paris.txt 1
scowling	NotreDame_De_Paris.txt 2
scrambled	NotreDame_De_Paris.txt 1
scraped	NotreDame_De_Paris.txt 3
scrapes	NotreDame_De_Paris.txt 1
scraping	NotreDame_De_Paris.txt 2
scraps	NotreDame_De_Paris.txt 2
scratch	NotreDame_De_Paris.txt 3
scratched	NotreDame_De_Paris.txt 5
scratching	NotreDame_De_Paris.txt 5
scrawled	NotreDame_De_Paris.txt 1
scream	NotreDame_De_Paris.txt 1
screamed	NotreDame_De_Paris.txt 1
screaming	NotreDame_De_Paris.txt 2
screech	NotreDame_De_Paris.txt 5
screen	NotreDame_De_Paris.txt 1
screens	NotreDame_De_Paris.txt 1
screw	NotreDame_De_Paris.txt 2
screwed	NotreDame_De_Paris.txt 1
scribbler	NotreDame_De_Paris.txt 1
scribbling	NotreDame_De_Paris.txt 2
scribes	NotreDame_De_Paris.txt 3
scroll	NotreDame_De_Paris.txt 1
scrutinize	NotreDame_De_Paris.txt 1
scrutinized	NotreDame_De_Paris.txt 1
scrutinizing	NotreDame_De_Paris.txt 3
scullions	NotreDame_De_Paris.txt 1
sculptor	NotreDame_De_Paris.txt 2
sculpture	NotreDame_De_Paris.txt 14
sculptured	NotreDame_De_Paris.txt 9
sculptures	NotreDame_De_Paris.txt 7
scutum	NotreDame_De_Paris.txt 1
scylla	NotreDame_De_Paris.txt 3
scythe	NotreDame_De_Paris.txt 2
scythes	NotreDame_De_Paris.txt 3
se	NotreDame_De_Paris.txt 2
sea	NotreDame_De_Paris.txt 16
seal	NotreDame_De_Paris.txt 2
sealed	NotreDame_De_Paris.txt 3
seals	NotreDame_De_Paris.txt 6
search	NotreDame_De_Paris.txt 24
searched	NotreDame_De_Paris.txt 4
searching	NotreDame_De_Paris.txt 4
sears	NotreDame_De_Paris.txt 1
seas	NotreDame_De_Paris.txt 1
season	NotreDame_De_Paris.txt 4
seasoned	NotreDame_De_Paris.txt 1
seat	NotreDame_De_Paris.txt 12
seated	NotreDame_De_Paris.txt 44
seating	NotreDame_De_Paris.txt 1
seats	NotreDame_De_Paris.txt 1
sec	NotreDame_De_Paris.txt 1
secanoe	NotreDame_De_Paris.txt 1
seclet	NotreDame_De_Paris.txt 1
second	NotreDame_De_Paris.txt 56
secondary	NotreDame_De_Paris.txt 3
seconds	NotreDame_De_Paris.txt 1
secret	NotreDame_De_Paris.txt 24
secretly	NotreDame_De_Paris.txt 1
section	NotreDame_De_Paris.txt 10
sections	NotreDame_De_Paris.txt 2
secundo	NotreDame_De_Paris.txt 2
secure	NotreDame_De_Paris.txt 1
secured	NotreDame_De_Paris.txt 1
securely	NotreDame_De_Paris.txt 2
security	NotreDame_De_Paris.txt 1
sed	NotreDame_De_Paris.txt 1
sede	NotreDame_De_Paris.txt 1
sedere	NotreDame_De_Paris.txt 1
sedition	NotreDame_De_Paris.txt 4
seditionibus	NotreDame_De_Paris.txt 1
seditions	NotreDame_De_Paris.txt 1
seditious	NotreDame_De_Paris.txt 3
see	NotreDame_De_Paris.txt 213
seeing	NotreDame_De_Paris.txt 24
seek	NotreDame_De_Paris.txt 17
seeking	NotreDame_De_Paris.txt 11
seeks	NotreDame_De_Paris.txt 2
seem	NotreDame_De_Paris.txt 10
seemed	NotreDame_De_Paris.txt 113
seemeth	NotreDame_De_Paris.txt 1
seeming	NotreDame_De_Paris.txt 2
seems	NotreDame_De_Paris.txt 15
seen	NotreDame_De_Paris.txt 133
sees	NotreDame_De_Paris.txt 12
seigneur	NotreDame_De_Paris.txt 10
seigneuries	NotreDame_De_Paris.txt 1
seigneurs	NotreDame_De_Paris.txt 2
seigneury	NotreDame_De_Paris.txt 2
seignorial	NotreDame_De_Paris.txt 2
seignories	NotreDame_De_Paris.txt 3
seignory	NotreDame_De_Paris.txt 4
seine	NotreDame_De_Paris.txt 35
seize	NotreDame_De_Paris.txt 5
seized	NotreDame_De_Paris.txt 32
seizes	NotreDame_De_Paris.txt 1
seizing	NotreDame_De_Paris.txt 5
seldom	NotreDame_De_Paris.txt 3
select	NotreDame_De_Paris.txt 1
selected	NotreDame_De_Paris.txt 3
self	NotreDame_De_Paris.txt 14
sell	NotreDame_De_Paris.txt 1
sellers	NotreDame_De_Paris.txt 1
selling	NotreDame_De_Paris.txt 1
semet	NotreDame_De_Paris.txt 1
semez	NotreDame_De_Paris.txt 1
semi	NotreDame_De_Paris.txt 3
semicircle	NotreDame_De_Paris.txt 3
semiramis	NotreDame_De_Paris.txt 1
semper	NotreDame_De_Paris.txt 1
senart	NotreDame_De_Paris.txt 1
senate	NotreDame_De_Paris.txt 1
send	NotreDame_De_Paris.txt 8
sending	NotreDame_De_Paris.txt 2
sends	NotreDame_De_Paris.txt 3
seneca	NotreDame_De_Paris.txt 1
seneschal	NotreDame_De_Paris.txt 1
senex	NotreDame_De_Paris.txt 1
senor	NotreDame_De_Paris.txt 1
sens	NotreDame_De_Paris.txt 3
sensation	NotreDame_De_Paris.txt 2
sensations	NotreDame_De_Paris.txt 1
sense	NotreDame_De_Paris.txt 14
senseless	NotreDame_De_Paris.txt 2
senses	NotreDame_De_Paris.txt 7
sensibility	NotreDame_De_Paris.txt 1
sensible	NotreDame_De_Paris.txt 1
sensibly	NotreDame_De_Paris.txt 1
sensitive	NotreDame_De_Paris.txt 2
sensual	NotreDame_De_Paris.txt 1
sensuality	NotreDame_De_Paris.txt 3
sent	NotreDame_De_Paris.txt 12
sentence	NotreDame_De_Paris.txt 12
sentences	NotreDame_De_Paris.txt 6
sententiani	NotreDame_De_Paris.txt 1
sentiment	NotreDame_De_Paris.txt 5
sentiments	NotreDame_De_Paris.txt 2
sentinels	NotreDame_De_Paris.txt 1
sentry	NotreDame_De_Paris.txt 1
separate	NotreDame_De_Paris.txt 4
separated	NotreDame_De_Paris.txt 8
separately	NotreDame_De_Paris.txt 1
separates	NotreDame_De_Paris.txt 2
separating	NotreDame_De_Paris.txt 1
september	NotreDame_De_Paris.txt 2
sepulchral	NotreDame_De_Paris.txt 6
sepulchre	NotreDame_De_Paris.txt 10
sequins	NotreDame_De_Paris.txt 1
sera	NotreDame_De_Paris.txt 2
seraglio	NotreDame_De_Paris.txt 1
serenade	NotreDame_De_Paris.txt 2
serenades	NotreDame_De_Paris.txt 1
serene	NotreDame_De_Paris.txt 5
serenity	NotreDame_De_Paris.txt 6
serge	NotreDame_De_Paris.txt 1
sergeant	NotreDame_De_Paris.txt 6
sergeants	NotreDame_De_Paris.txt 31
sergents	NotreDame_De_Paris.txt 1
series	NotreDame_De_Paris.txt 10
serious	NotreDame_De_Paris.txt 8
seriously	NotreDame_De_Paris.txt 7
seriousness	NotreDame_De_Paris.txt 2
sermon	NotreDame_De_Paris.txt 4
sermons	NotreDame_De_Paris.txt 1
serpent	NotreDame_De_Paris.txt 9
serpentine	NotreDame_De_Paris.txt 2
servant	NotreDame_De_Paris.txt 3
servants	NotreDame_De_Paris.txt 1
serve	NotreDame_De_Paris.txt 8
served	NotreDame_De_Paris.txt 16
serves	NotreDame_De_Paris.txt 2
service	NotreDame_De_Paris.txt 9
services	NotreDame_De_Paris.txt 1
serving	NotreDame_De_Paris.txt 2
servius	NotreDame_De_Paris.txt 1
ses	NotreDame_De_Paris.txt 1
set	NotreDame_De_Paris.txt 88
sets	NotreDame_De_Paris.txt 4
setting	NotreDame_De_Paris.txt 9
settle	NotreDame_De_Paris.txt 2
settled	NotreDame_De_Paris.txt 7
seu	NotreDame_De_Paris.txt 3
seule	NotreDame_De_Paris.txt 1
seven	NotreDame_De_Paris.txt 41
seventeen	NotreDame_De_Paris.txt 4
seventeenth	NotreDame_De_Paris.txt 3
seventh	NotreDame_De_Paris.txt 6
seventy	NotreDame_De_Paris.txt 2
sever	NotreDame_De_Paris.txt 1
several	NotreDame_De_Paris.txt 52
severe	NotreDame_De_Paris.txt 15
severed	NotreDame_De_Paris.txt 2
severity	NotreDame_De_Paris.txt 7
sewer	NotreDame_De_Paris.txt 1
sewers	NotreDame_De_Paris.txt 1
sex	NotreDame_De_Paris.txt 5
sexes	NotreDame_De_Paris.txt 1
sextiers	NotreDame_De_Paris.txt 1
shade	NotreDame_De_Paris.txt 8
shaded	NotreDame_De_Paris.txt 1
shades	NotreDame_De_Paris.txt 4
shadow	NotreDame_De_Paris.txt 25
shadowing	NotreDame_De_Paris.txt 1
shadows	NotreDame_De_Paris.txt 27
shadowy	NotreDame_De_Paris.txt 2
shaft	NotreDame_De_Paris.txt 1
shagreen	NotreDame_De_Paris.txt 2
shake	NotreDame_De_Paris.txt 5
shaken	NotreDame_De_Paris.txt 4
shakes	NotreDame_De_Paris.txt 1
shakespeare	NotreDame_De_Paris.txt 3
shaking	NotreDame_De_Paris.txt 17
shall	NotreDame_De_Paris.txt 107
shalt	NotreDame_De_Paris.txt 2
sham	NotreDame_De_Paris.txt 3
shame	NotreDame_De_Paris.txt 14
shameful	NotreDame_De_Paris.txt 2
shamelessly	NotreDame_De_Paris.txt 1
shape	NotreDame_De_Paris.txt 4
shaped	NotreDame_De_Paris.txt 4
shapeless	NotreDame_De_Paris.txt 1
shapes	NotreDame_De_Paris.txt 1
share	NotreDame_De_Paris.txt 7
shared	NotreDame_De_Paris.txt 4
sharing	NotreDame_De_Paris.txt 1
shark	NotreDame_De_Paris.txt 1
sharks	NotreDame_De_Paris.txt 1
sharp	NotreDame_De_Paris.txt 9
sharpening	NotreDame_De_Paris.txt 1
sharper	NotreDame_De_Paris.txt 3
sharply	NotreDame_De_Paris.txt 6
sharpness	NotreDame_De_Paris.txt 1
shatter	NotreDame_De_Paris.txt 1
shattered	NotreDame_De_Paris.txt 2
shave	NotreDame_De_Paris.txt 3
shaved	NotreDame_De_Paris.txt 1
shaves	NotreDame_De_Paris.txt 1
shaving	NotreDame_De_Paris.txt 1
she	NotreDame_De_Paris.txt 1042
sheaf	NotreDame_De_Paris.txt 1
sheath	NotreDame_De_Paris.txt 1
sheathing	NotreDame_De_Paris.txt 1
sheaves	NotreDame_De_Paris.txt 3
shed	NotreDame_De_Paris.txt 7
shedding	NotreDame_De_Paris.txt 2
sheds	NotreDame_De_Paris.txt 3
sheep	NotreDame_De_Paris.txt 2
sheet	NotreDame_De_Paris.txt 2
sheets	NotreDame_De_Paris.txt 3
shelf	NotreDame_De_Paris.txt 1
shell	NotreDame_De_Paris.txt 8
shells	NotreDame_De_Paris.txt 3
shelter	NotreDame_De_Paris.txt 4
sheltered	NotreDame_De_Paris.txt 3
shelves	NotreDame_De_Paris.txt 1
shepherd	NotreDame_De_Paris.txt 2
shield	NotreDame_De_Paris.txt 3
shields	NotreDame_De_Paris.txt 1
shift	NotreDame_De_Paris.txt 9
shine	NotreDame_De_Paris.txt 3
shines	NotreDame_De_Paris.txt 1
shining	NotreDame_De_Paris.txt 8
ship	NotreDame_De_Paris.txt 5
shipwreck	NotreDame_De_Paris.txt 2
shipwrecked	NotreDame_De_Paris.txt 1
shirt	NotreDame_De_Paris.txt 9
shirts	NotreDame_De_Paris.txt 1
shiver	NotreDame_De_Paris.txt 8
shivered	NotreDame_De_Paris.txt 1
shivering	NotreDame_De_Paris.txt 2
shock	NotreDame_De_Paris.txt 11
shocked	NotreDame_De_Paris.txt 3
shocks	NotreDame_De_Paris.txt 4
shod	NotreDame_De_Paris.txt 1
shoe	NotreDame_De_Paris.txt 33
shoes	NotreDame_De_Paris.txt 17
shone	NotreDame_De_Paris.txt 6
shook	NotreDame_De_Paris.txt 17
shooting	NotreDame_De_Paris.txt 1
shoots	NotreDame_De_Paris.txt 3
shop	NotreDame_De_Paris.txt 25
shopkeeper	NotreDame_De_Paris.txt 1
shops	NotreDame_De_Paris.txt 5
shore	NotreDame_De_Paris.txt 3
short	NotreDame_De_Paris.txt 44
shortcomings	NotreDame_De_Paris.txt 1
shorter	NotreDame_De_Paris.txt 4
shot	NotreDame_De_Paris.txt 3
shots	NotreDame_De_Paris.txt 2
should	NotreDame_De_Paris.txt 135
shoulder	NotreDame_De_Paris.txt 21
shouldered	NotreDame_De_Paris.txt 3
shoulders	NotreDame_De_Paris.txt 35
shout	NotreDame_De_Paris.txt 8
shouted	NotreDame_De_Paris.txt 26
shouting	NotreDame_De_Paris.txt 9
shouts	NotreDame_De_Paris.txt 4
show	NotreDame_De_Paris.txt 10
showed	NotreDame_De_Paris.txt 3
shower	NotreDame_De_Paris.txt 4
showered	NotreDame_De_Paris.txt 1
showing	NotreDame_De_Paris.txt 5
shown	NotreDame_De_Paris.txt 2
shows	NotreDame_De_Paris.txt 2
shrank	NotreDame_De_Paris.txt 3
shred	NotreDame_De_Paris.txt 1
shriek	NotreDame_De_Paris.txt 2
shrieked	NotreDame_De_Paris.txt 10
shrieking	NotreDame_De_Paris.txt 3
shrieks	NotreDame_De_Paris.txt 4
shrill	NotreDame_De_Paris.txt 8
shrilly	NotreDame_De_Paris.txt 1
shrines	NotreDame_De_Paris.txt 1
shrink	NotreDame_De_Paris.txt 1
shrivelled	NotreDame_De_Paris.txt 1
shroud	NotreDame_De_Paris.txt 2
shrouded	NotreDame_De_Paris.txt 1
shrove	NotreDame_De_Paris.txt 1
shrug	NotreDame_De_Paris.txt 2
shrugged	NotreDame_De_Paris.txt 2
shrugging	NotreDame_De_Paris.txt 1
shrunk	NotreDame_De_Paris.txt 1
shudder	NotreDame_De_Paris.txt 7
shuddered	NotreDame_De_Paris.txt 13
shuddering	NotreDame_De_Paris.txt 2
shudderings	NotreDame_De_Paris.txt 1
shut	NotreDame_De_Paris.txt 16
shutter	NotreDame_De_Paris.txt 1
shutters	NotreDame_De_Paris.txt 1
si	NotreDame_De_Paris.txt 2
siberia	NotreDame_De_Paris.txt 1
sicilian	NotreDame_De_Paris.txt 1
sicily	NotreDame_De_Paris.txt 4
sick	NotreDame_De_Paris.txt 2
sickle	NotreDame_De_Paris.txt 1
sickly	NotreDame_De_Paris.txt 3
side	NotreDame_De_Paris.txt 66
sidelong	NotreDame_De_Paris.txt 2
sides	NotreDame_De_Paris.txt 21
sideways	NotreDame_De_Paris.txt 1
sidragasum	NotreDame_De_Paris.txt 2
siege	NotreDame_De_Paris.txt 10
sieur	NotreDame_De_Paris.txt 7
siffle	NotreDame_De_Paris.txt 1
sifted	NotreDame_De_Paris.txt 1
sig	NotreDame_De_Paris.txt 2
sigh	NotreDame_De_Paris.txt 21
sighed	NotreDame_De_Paris.txt 7
sighing	NotreDame_De_Paris.txt 1
sighs	NotreDame_De_Paris.txt 5
sight	NotreDame_De_Paris.txt 45
sighted	NotreDame_De_Paris.txt 1
sights	NotreDame_De_Paris.txt 1
sigismond	NotreDame_De_Paris.txt 1
sign	NotreDame_De_Paris.txt 43
signal	NotreDame_De_Paris.txt 4
signature	NotreDame_De_Paris.txt 1
signboard	NotreDame_De_Paris.txt 1
signe	NotreDame_De_Paris.txt 1
signed	NotreDame_De_Paris.txt 1
significance	NotreDame_De_Paris.txt 1
significant	NotreDame_De_Paris.txt 2
signification	NotreDame_De_Paris.txt 1
signified	NotreDame_De_Paris.txt 2
signifies	NotreDame_De_Paris.txt 2
signing	NotreDame_De_Paris.txt 1
signor	NotreDame_De_Paris.txt 1
signs	NotreDame_De_Paris.txt 7
sikra	NotreDame_De_Paris.txt 1
silence	NotreDame_De_Paris.txt 85
silent	NotreDame_De_Paris.txt 29
silently	NotreDame_De_Paris.txt 4
sileto	NotreDame_De_Paris.txt 1
silhouette	NotreDame_De_Paris.txt 3
silk	NotreDame_De_Paris.txt 6
silken	NotreDame_De_Paris.txt 4
silky	NotreDame_De_Paris.txt 2
sill	NotreDame_De_Paris.txt 2
sillery	NotreDame_De_Paris.txt 1
sills	NotreDame_De_Paris.txt 2
silly	NotreDame_De_Paris.txt 2
silver	NotreDame_De_Paris.txt 25
silvery	NotreDame_De_Paris.txt 3
similar	NotreDame_De_Paris.txt 12
similarity	NotreDame_De_Paris.txt 1
similes	NotreDame_De_Paris.txt 1
simon	NotreDame_De_Paris.txt 5
simone	NotreDame_De_Paris.txt 2
simple	NotreDame_De_Paris.txt 32
simplest	NotreDame_De_Paris.txt 1
simplicity	NotreDame_De_Paris.txt 3
simply	NotreDame_De_Paris.txt 14
simultaneous	NotreDame_De_Paris.txt 1
simultaneously	NotreDame_De_Paris.txt 10
sin	NotreDame_De_Paris.txt 3
since	NotreDame_De_Paris.txt 76
sincere	NotreDame_De_Paris.txt 3
sine	NotreDame_De_Paris.txt 3
sinful	NotreDame_De_Paris.txt 1
sing	NotreDame_De_Paris.txt 11
singer	NotreDame_De_Paris.txt 2
singers	NotreDame_De_Paris.txt 4
singing	NotreDame_De_Paris.txt 15
single	NotreDame_De_Paris.txt 40
singsong	NotreDame_De_Paris.txt 1
singular	NotreDame_De_Paris.txt 38
singularities	NotreDame_De_Paris.txt 1
singularity	NotreDame_De_Paris.txt 1
singularly	NotreDame_De_Paris.txt 2
sinister	NotreDame_De_Paris.txt 14
sink	NotreDame_De_Paris.txt 2
sinking	NotreDame_De_Paris.txt 4
sinner	NotreDame_De_Paris.txt 1
sint	NotreDame_De_Paris.txt 2
sir	NotreDame_De_Paris.txt 14
sire	NotreDame_De_Paris.txt 75
sirens	NotreDame_De_Paris.txt 1
sirius	NotreDame_De_Paris.txt 1
sister	NotreDame_De_Paris.txt 39
sisterhood	NotreDame_De_Paris.txt 1
sisters	NotreDame_De_Paris.txt 4
sit	NotreDame_De_Paris.txt 6
site	NotreDame_De_Paris.txt 6
sites	NotreDame_De_Paris.txt 1
sits	NotreDame_De_Paris.txt 1
sitting	NotreDame_De_Paris.txt 5
situated	NotreDame_De_Paris.txt 14
situation	NotreDame_De_Paris.txt 6
six	NotreDame_De_Paris.txt 61
sixteen	NotreDame_De_Paris.txt 17
sixteenth	NotreDame_De_Paris.txt 15
sixth	NotreDame_De_Paris.txt 8
sixtieth	NotreDame_De_Paris.txt 1
sixty	NotreDame_De_Paris.txt 11
size	NotreDame_De_Paris.txt 6
sized	NotreDame_De_Paris.txt 1
sizes	NotreDame_De_Paris.txt 1
skein	NotreDame_De_Paris.txt 2
skeleton	NotreDame_De_Paris.txt 6
skeletons	NotreDame_De_Paris.txt 6
sketch	NotreDame_De_Paris.txt 1
sketched	NotreDame_De_Paris.txt 2
skies	NotreDame_De_Paris.txt 3
skin	NotreDame_De_Paris.txt 15
skinned	NotreDame_De_Paris.txt 2
skip	NotreDame_De_Paris.txt 2
skipping	NotreDame_De_Paris.txt 1
skirt	NotreDame_De_Paris.txt 2
skirted	NotreDame_De_Paris.txt 3
skull	NotreDame_De_Paris.txt 5
skulls	NotreDame_De_Paris.txt 5
sky	NotreDame_De_Paris.txt 33
slab	NotreDame_De_Paris.txt 2
slabs	NotreDame_De_Paris.txt 1
slackened	NotreDame_De_Paris.txt 1
slain	NotreDame_De_Paris.txt 6
slang	NotreDame_De_Paris.txt 6
slash	NotreDame_De_Paris.txt 1
slashed	NotreDame_De_Paris.txt 5
slashes	NotreDame_De_Paris.txt 1
slate	NotreDame_De_Paris.txt 9
slated	NotreDame_De_Paris.txt 2
slates	NotreDame_De_Paris.txt 1
slaughter	NotreDame_De_Paris.txt 3
slaughtered	NotreDame_De_Paris.txt 1
slaughterer	NotreDame_De_Paris.txt 3
slave	NotreDame_De_Paris.txt 4
slavery	NotreDame_De_Paris.txt 1
slay	NotreDame_De_Paris.txt 3
sleep	NotreDame_De_Paris.txt 20
sleeping	NotreDame_De_Paris.txt 10
sleeplessness	NotreDame_De_Paris.txt 1
sleepy	NotreDame_De_Paris.txt 1
sleeve	NotreDame_De_Paris.txt 7
sleeveless	NotreDame_De_Paris.txt 3
sleeves	NotreDame_De_Paris.txt 11
slender	NotreDame_De_Paris.txt 16
slept	NotreDame_De_Paris.txt 8
slice	NotreDame_De_Paris.txt 3
slices	NotreDame_De_Paris.txt 1
slid	NotreDame_De_Paris.txt 3
slide	NotreDame_De_Paris.txt 1
slight	NotreDame_De_Paris.txt 5
slightest	NotreDame_De_Paris.txt 5
slightly	NotreDame_De_Paris.txt 3
sling	NotreDame_De_Paris.txt 1
slip	NotreDame_De_Paris.txt 4
slipped	NotreDame_De_Paris.txt 8
slipper	NotreDame_De_Paris.txt 1
slippers	NotreDame_De_Paris.txt 1
slippery	NotreDame_De_Paris.txt 1
slipping	NotreDame_De_Paris.txt 1
slips	NotreDame_De_Paris.txt 1
slit	NotreDame_De_Paris.txt 1
slope	NotreDame_De_Paris.txt 3
sloped	NotreDame_De_Paris.txt 3
slopes	NotreDame_De_Paris.txt 3
sloping	NotreDame_De_Paris.txt 2
slow	NotreDame_De_Paris.txt 10
slowly	NotreDame_De_Paris.txt 33
slowness	NotreDame_De_Paris.txt 3
sluggard	NotreDame_De_Paris.txt 1
sluggish	NotreDame_De_Paris.txt 2
sluice	NotreDame_De_Paris.txt 1
slumber	NotreDame_De_Paris.txt 2
slumbers	NotreDame_De_Paris.txt 2
sly	NotreDame_De_Paris.txt 2
sm	NotreDame_De_Paris.txt 1
smack	NotreDame_De_Paris.txt 1
smacked	NotreDame_De_Paris.txt 1
smacks	NotreDame_De_Paris.txt 2
small	NotreDame_De_Paris.txt 39
smaller	NotreDame_De_Paris.txt 4
smallest	NotreDame_De_Paris.txt 5
smallness	NotreDame_De_Paris.txt 1
smashed	NotreDame_De_Paris.txt 2
smashing	NotreDame_De_Paris.txt 3
smeared	NotreDame_De_Paris.txt 2
smelarda	NotreDame_De_Paris.txt 1
smell	NotreDame_De_Paris.txt 2
smelt	NotreDame_De_Paris.txt 1
smeralda	NotreDame_De_Paris.txt 2
smile	NotreDame_De_Paris.txt 53
smiled	NotreDame_De_Paris.txt 6
smiles	NotreDame_De_Paris.txt 5
smiling	NotreDame_De_Paris.txt 7
smiting	NotreDame_De_Paris.txt 1
smock	NotreDame_De_Paris.txt 1
smoke	NotreDame_De_Paris.txt 12
smokes	NotreDame_De_Paris.txt 1
smoking	NotreDame_De_Paris.txt 1
smooth	NotreDame_De_Paris.txt 2
smoothed	NotreDame_De_Paris.txt 2
smoothly	NotreDame_De_Paris.txt 1
smote	NotreDame_De_Paris.txt 3
snail	NotreDame_De_Paris.txt 1
snails	NotreDame_De_Paris.txt 1
snapped	NotreDame_De_Paris.txt 2
snappings	NotreDame_De_Paris.txt 1
snare	NotreDame_De_Paris.txt 1
snares	NotreDame_De_Paris.txt 1
snarl	NotreDame_De_Paris.txt 1
snatched	NotreDame_De_Paris.txt 3
snatching	NotreDame_De_Paris.txt 1
sneer	NotreDame_De_Paris.txt 6
sneered	NotreDame_De_Paris.txt 1
sneezed	NotreDame_De_Paris.txt 1
snoring	NotreDame_De_Paris.txt 1
snorted	NotreDame_De_Paris.txt 2
snout	NotreDame_De_Paris.txt 1
snow	NotreDame_De_Paris.txt 4
snows	NotreDame_De_Paris.txt 1
snowy	NotreDame_De_Paris.txt 1
snub	NotreDame_De_Paris.txt 1
snuff	NotreDame_De_Paris.txt 1
snuffing	NotreDame_De_Paris.txt 1
so	NotreDame_De_Paris.txt 557
soak	NotreDame_De_Paris.txt 1
soaked	NotreDame_De_Paris.txt 3
soap	NotreDame_De_Paris.txt 1
soaring	NotreDame_De_Paris.txt 2
sob	NotreDame_De_Paris.txt 8
sobbing	NotreDame_De_Paris.txt 3
sobs	NotreDame_De_Paris.txt 8
socerers	NotreDame_De_Paris.txt 1
social	NotreDame_De_Paris.txt 4
society	NotreDame_De_Paris.txt 17
sod	NotreDame_De_Paris.txt 1
soft	NotreDame_De_Paris.txt 5
softened	NotreDame_De_Paris.txt 1
softening	NotreDame_De_Paris.txt 1
softest	NotreDame_De_Paris.txt 1
softly	NotreDame_De_Paris.txt 5
soil	NotreDame_De_Paris.txt 10
soiled	NotreDame_De_Paris.txt 3
soins	NotreDame_De_Paris.txt 1
sola	NotreDame_De_Paris.txt 1
solace	NotreDame_De_Paris.txt 2
solar	NotreDame_De_Paris.txt 2
sold	NotreDame_De_Paris.txt 2
soldered	NotreDame_De_Paris.txt 1
soldering	NotreDame_De_Paris.txt 1
soldier	NotreDame_De_Paris.txt 25
soldierly	NotreDame_De_Paris.txt 1
soldiers	NotreDame_De_Paris.txt 17
sole	NotreDame_De_Paris.txt 17
solely	NotreDame_De_Paris.txt 2
solemn	NotreDame_De_Paris.txt 7
solemneties	NotreDame_De_Paris.txt 1
solemnity	NotreDame_De_Paris.txt 4
solemnly	NotreDame_De_Paris.txt 4
soles	NotreDame_De_Paris.txt 4
soliaco	NotreDame_De_Paris.txt 1
solicit	NotreDame_De_Paris.txt 2
solicitation	NotreDame_De_Paris.txt 1
soliciting	NotreDame_De_Paris.txt 4
solicitude	NotreDame_De_Paris.txt 1
solid	NotreDame_De_Paris.txt 11
solidified	NotreDame_De_Paris.txt 1
solidity	NotreDame_De_Paris.txt 1
solitary	NotreDame_De_Paris.txt 2
solitude	NotreDame_De_Paris.txt 1
solomon	NotreDame_De_Paris.txt 7
sols	NotreDame_De_Paris.txt 23
solus	NotreDame_De_Paris.txt 1
solution	NotreDame_De_Paris.txt 1
solve	NotreDame_De_Paris.txt 1
sombre	NotreDame_De_Paris.txt 29
sombrero	NotreDame_De_Paris.txt 1
some	NotreDame_De_Paris.txt 248
something	NotreDame_De_Paris.txt 99
sometimes	NotreDame_De_Paris.txt 43
somewhat	NotreDame_De_Paris.txt 17
somewhere	NotreDame_De_Paris.txt 6
somni	NotreDame_De_Paris.txt 1
somnolent	NotreDame_De_Paris.txt 1
son	NotreDame_De_Paris.txt 16
sonant	NotreDame_De_Paris.txt 1
song	NotreDame_De_Paris.txt 19
songs	NotreDame_De_Paris.txt 6
sonneurs	NotreDame_De_Paris.txt 1
sono	NotreDame_De_Paris.txt 1
sonorous	NotreDame_De_Paris.txt 9
sons	NotreDame_De_Paris.txt 4
sont	NotreDame_De_Paris.txt 2
soon	NotreDame_De_Paris.txt 32
sooner	NotreDame_De_Paris.txt 3
sooth	NotreDame_De_Paris.txt 7
soothed	NotreDame_De_Paris.txt 1
soothsayers	NotreDame_De_Paris.txt 1
sophia	NotreDame_De_Paris.txt 2
sophism	NotreDame_De_Paris.txt 1
sophisms	NotreDame_De_Paris.txt 2
sophocles	NotreDame_De_Paris.txt 1
soprano	NotreDame_De_Paris.txt 1
sorbonne	NotreDame_De_Paris.txt 6
sorcerer	NotreDame_De_Paris.txt 4
sorcerers	NotreDame_De_Paris.txt 1
sorceress	NotreDame_De_Paris.txt 19
sorceresses	NotreDame_De_Paris.txt 2
sorcery	NotreDame_De_Paris.txt 9
sordid	NotreDame_De_Paris.txt 1
sore	NotreDame_De_Paris.txt 3
sores	NotreDame_De_Paris.txt 2
sorrow	NotreDame_De_Paris.txt 3
sorrowful	NotreDame_De_Paris.txt 1
sorrowfully	NotreDame_De_Paris.txt 2
sorry	NotreDame_De_Paris.txt 6
sort	NotreDame_De_Paris.txt 92
sortir	NotreDame_De_Paris.txt 1
sorts	NotreDame_De_Paris.txt 21
sou	NotreDame_De_Paris.txt 9
soufflot	NotreDame_De_Paris.txt 1
sought	NotreDame_De_Paris.txt 10
soul	NotreDame_De_Paris.txt 84
soulart	NotreDame_De_Paris.txt 1
souls	NotreDame_De_Paris.txt 8
sound	NotreDame_De_Paris.txt 48
sounded	NotreDame_De_Paris.txt 9
sounding	NotreDame_De_Paris.txt 4
soundly	NotreDame_De_Paris.txt 1
sounds	NotreDame_De_Paris.txt 9
soup	NotreDame_De_Paris.txt 3
soups	NotreDame_De_Paris.txt 1
source	NotreDame_De_Paris.txt 2
sous	NotreDame_De_Paris.txt 16
south	NotreDame_De_Paris.txt 7
southern	NotreDame_De_Paris.txt 3
southward	NotreDame_De_Paris.txt 1
souvenirs	NotreDame_De_Paris.txt 1
souvent	NotreDame_De_Paris.txt 1
sovereign	NotreDame_De_Paris.txt 6
sovereigns	NotreDame_De_Paris.txt 1
sow	NotreDame_De_Paris.txt 6
sower	NotreDame_De_Paris.txt 2
sown	NotreDame_De_Paris.txt 5
sows	NotreDame_De_Paris.txt 1
space	NotreDame_De_Paris.txt 22
spaces	NotreDame_De_Paris.txt 2
spacious	NotreDame_De_Paris.txt 5
spade	NotreDame_De_Paris.txt 1
spain	NotreDame_De_Paris.txt 3
spangled	NotreDame_De_Paris.txt 2
spangles	NotreDame_De_Paris.txt 2
spaniards	NotreDame_De_Paris.txt 1
spanish	NotreDame_De_Paris.txt 2
spare	NotreDame_De_Paris.txt 3
spared	NotreDame_De_Paris.txt 1
sparely	NotreDame_De_Paris.txt 1
sparing	NotreDame_De_Paris.txt 1
spark	NotreDame_De_Paris.txt 4
sparkle	NotreDame_De_Paris.txt 2
sparkled	NotreDame_De_Paris.txt 4
sparkles	NotreDame_De_Paris.txt 1
sparkling	NotreDame_De_Paris.txt 8
sparks	NotreDame_De_Paris.txt 6
sparrow	NotreDame_De_Paris.txt 1
sparrows	NotreDame_De_Paris.txt 2
sparsely	NotreDame_De_Paris.txt 1
spat	NotreDame_De_Paris.txt 1
spatula	NotreDame_De_Paris.txt 1
speak	NotreDame_De_Paris.txt 72
speaking	NotreDame_De_Paris.txt 27
speaks	NotreDame_De_Paris.txt 5
spear	NotreDame_De_Paris.txt 1
special	NotreDame_De_Paris.txt 7
specialty	NotreDame_De_Paris.txt 1
species	NotreDame_De_Paris.txt 10
specific	NotreDame_De_Paris.txt 1
specified	NotreDame_De_Paris.txt 2
speciftoe	NotreDame_De_Paris.txt 1
specimen	NotreDame_De_Paris.txt 3
specimens	NotreDame_De_Paris.txt 5
spectacle	NotreDame_De_Paris.txt 32
spectantibus	NotreDame_De_Paris.txt 1
spectator	NotreDame_De_Paris.txt 9
spectators	NotreDame_De_Paris.txt 24
spectre	NotreDame_De_Paris.txt 10
spectres	NotreDame_De_Paris.txt 5
spectrum	NotreDame_De_Paris.txt 2
speculated	NotreDame_De_Paris.txt 1
speculations	NotreDame_De_Paris.txt 1
sped	NotreDame_De_Paris.txt 2
speech	NotreDame_De_Paris.txt 8
speechless	NotreDame_De_Paris.txt 2
speed	NotreDame_De_Paris.txt 3
speedily	NotreDame_De_Paris.txt 5
speedy	NotreDame_De_Paris.txt 1
spell	NotreDame_De_Paris.txt 5
spelled	NotreDame_De_Paris.txt 1
spells	NotreDame_De_Paris.txt 2
spend	NotreDame_De_Paris.txt 1
spending	NotreDame_De_Paris.txt 1
spent	NotreDame_De_Paris.txt 1
spera	NotreDame_De_Paris.txt 2
speranza	NotreDame_De_Paris.txt 3
spewed	NotreDame_De_Paris.txt 1
spheres	NotreDame_De_Paris.txt 1
sphinx	NotreDame_De_Paris.txt 1
sphinxes	NotreDame_De_Paris.txt 1
spicali	NotreDame_De_Paris.txt 3
spice	NotreDame_De_Paris.txt 2
spiced	NotreDame_De_Paris.txt 1
spices	NotreDame_De_Paris.txt 2
spider	NotreDame_De_Paris.txt 16
spiders	NotreDame_De_Paris.txt 6
spin	NotreDame_De_Paris.txt 4
spinal	NotreDame_De_Paris.txt 2
spindle	NotreDame_De_Paris.txt 1
spine	NotreDame_De_Paris.txt 1
spinning	NotreDame_De_Paris.txt 4
spira	NotreDame_De_Paris.txt 1
spiral	NotreDame_De_Paris.txt 8
spirals	NotreDame_De_Paris.txt 1
spire	NotreDame_De_Paris.txt 20
spires	NotreDame_De_Paris.txt 13
spirit	NotreDame_De_Paris.txt 23
spirits	NotreDame_De_Paris.txt 1
spiritual	NotreDame_De_Paris.txt 2
spit	NotreDame_De_Paris.txt 7
spite	NotreDame_De_Paris.txt 16
spiteful	NotreDame_De_Paris.txt 2
spits	NotreDame_De_Paris.txt 1
spitting	NotreDame_De_Paris.txt 2
spittle	NotreDame_De_Paris.txt 1
spittoons	NotreDame_De_Paris.txt 1
splash	NotreDame_De_Paris.txt 2
splashed	NotreDame_De_Paris.txt 1
splashing	NotreDame_De_Paris.txt 2
spleen	NotreDame_De_Paris.txt 1
splendid	NotreDame_De_Paris.txt 10
splendidly	NotreDame_De_Paris.txt 1
splendor	NotreDame_De_Paris.txt 1
splendors	NotreDame_De_Paris.txt 2
splinters	NotreDame_De_Paris.txt 1
split	NotreDame_De_Paris.txt 3
spluttering	NotreDame_De_Paris.txt 1
spoiled	NotreDame_De_Paris.txt 4
spoke	NotreDame_De_Paris.txt 24
spoken	NotreDame_De_Paris.txt 3
spokes	NotreDame_De_Paris.txt 1
spondee	NotreDame_De_Paris.txt 1
sponge	NotreDame_De_Paris.txt 4
spoonful	NotreDame_De_Paris.txt 1
sport	NotreDame_De_Paris.txt 1
sportive	NotreDame_De_Paris.txt 1
spot	NotreDame_De_Paris.txt 10
spots	NotreDame_De_Paris.txt 3
spotted	NotreDame_De_Paris.txt 2
spout	NotreDame_De_Paris.txt 10
spouted	NotreDame_De_Paris.txt 1
spouts	NotreDame_De_Paris.txt 2
sprains	NotreDame_De_Paris.txt 1
sprang	NotreDame_De_Paris.txt 7
spread	NotreDame_De_Paris.txt 41
spreading	NotreDame_De_Paris.txt 5
spreads	NotreDame_De_Paris.txt 2
spring	NotreDame_De_Paris.txt 10
springing	NotreDame_De_Paris.txt 1
sprinkled	NotreDame_De_Paris.txt 2
sprouts	NotreDame_De_Paris.txt 1
sprung	NotreDame_De_Paris.txt 1
spur	NotreDame_De_Paris.txt 1
spurred	NotreDame_De_Paris.txt 4
spurring	NotreDame_De_Paris.txt 1
spurs	NotreDame_De_Paris.txt 6
sputter	NotreDame_De_Paris.txt 1
sputtered	NotreDame_De_Paris.txt 1
sputtering	NotreDame_De_Paris.txt 2
spy	NotreDame_De_Paris.txt 1
squad	NotreDame_De_Paris.txt 3
squalid	NotreDame_De_Paris.txt 1
squall	NotreDame_De_Paris.txt 2
squalling	NotreDame_De_Paris.txt 1
square	NotreDame_De_Paris.txt 51
squared	NotreDame_De_Paris.txt 1
squarely	NotreDame_De_Paris.txt 2
squares	NotreDame_De_Paris.txt 15
squat	NotreDame_De_Paris.txt 4
squatting	NotreDame_De_Paris.txt 4
squeezing	NotreDame_De_Paris.txt 1
squibs	NotreDame_De_Paris.txt 1
squires	NotreDame_De_Paris.txt 3
sre	NotreDame_De_Paris.txt 3
st	NotreDame_De_Paris.txt 4
stab	NotreDame_De_Paris.txt 2
stabbed	NotreDame_De_Paris.txt 2
stable	NotreDame_De_Paris.txt 3
stables	NotreDame_De_Paris.txt 2
stacks	NotreDame_De_Paris.txt 1
staff	NotreDame_De_Paris.txt 3
stag	NotreDame_De_Paris.txt 2
stage	NotreDame_De_Paris.txt 10
stages	NotreDame_De_Paris.txt 4
staggered	NotreDame_De_Paris.txt 2
staggering	NotreDame_De_Paris.txt 5
stagnant	NotreDame_De_Paris.txt 2
stain	NotreDame_De_Paris.txt 2
stained	NotreDame_De_Paris.txt 3
staircase	NotreDame_De_Paris.txt 40
staircases	NotreDame_De_Paris.txt 4
stairs	NotreDame_De_Paris.txt 11
stairway	NotreDame_De_Paris.txt 3
stake	NotreDame_De_Paris.txt 3
stale	NotreDame_De_Paris.txt 1
stall	NotreDame_De_Paris.txt 2
stalls	NotreDame_De_Paris.txt 5
stammer	NotreDame_De_Paris.txt 1
stammered	NotreDame_De_Paris.txt 13
stammering	NotreDame_De_Paris.txt 1
stamp	NotreDame_De_Paris.txt 2
stamped	NotreDame_De_Paris.txt 11
stamping	NotreDame_De_Paris.txt 2
stand	NotreDame_De_Paris.txt 15
standards	NotreDame_De_Paris.txt 1
standing	NotreDame_De_Paris.txt 28
stands	NotreDame_De_Paris.txt 7
standstill	NotreDame_De_Paris.txt 1
stanza	NotreDame_De_Paris.txt 1
star	NotreDame_De_Paris.txt 9
stare	NotreDame_De_Paris.txt 5
stared	NotreDame_De_Paris.txt 7
staring	NotreDame_De_Paris.txt 13
stark	NotreDame_De_Paris.txt 2
starry	NotreDame_De_Paris.txt 3
stars	NotreDame_De_Paris.txt 15
start	NotreDame_De_Paris.txt 16
started	NotreDame_De_Paris.txt 8
starting	NotreDame_De_Paris.txt 4
startled	NotreDame_De_Paris.txt 2
startling	NotreDame_De_Paris.txt 1
starts	NotreDame_De_Paris.txt 2
state	NotreDame_De_Paris.txt 35
stated	NotreDame_De_Paris.txt 2
statement	NotreDame_De_Paris.txt 1
statements	NotreDame_De_Paris.txt 1
states	NotreDame_De_Paris.txt 15
station	NotreDame_De_Paris.txt 1
stationed	NotreDame_De_Paris.txt 4
statistics	NotreDame_De_Paris.txt 1
statuary	NotreDame_De_Paris.txt 3
statue	NotreDame_De_Paris.txt 19
statues	NotreDame_De_Paris.txt 22
stature	NotreDame_De_Paris.txt 6
status	NotreDame_De_Paris.txt 4
statute	NotreDame_De_Paris.txt 1
statutes	NotreDame_De_Paris.txt 2
staves	NotreDame_De_Paris.txt 1
stay	NotreDame_De_Paris.txt 15
stayed	NotreDame_De_Paris.txt 1
stead	NotreDame_De_Paris.txt 1
steadfastly	NotreDame_De_Paris.txt 1
steadily	NotreDame_De_Paris.txt 1
steal	NotreDame_De_Paris.txt 3
stealer	NotreDame_De_Paris.txt 1
stealers	NotreDame_De_Paris.txt 1
stealing	NotreDame_De_Paris.txt 2
stealthily	NotreDame_De_Paris.txt 1
stealthy	NotreDame_De_Paris.txt 1
steed	NotreDame_De_Paris.txt 3
steel	NotreDame_De_Paris.txt 3
steep	NotreDame_De_Paris.txt 5
steeped	NotreDame_De_Paris.txt 1
stella	NotreDame_De_Paris.txt 1
stem	NotreDame_De_Paris.txt 1
stentorian	NotreDame_De_Paris.txt 1
step	NotreDame_De_Paris.txt 23
stepped	NotreDame_De_Paris.txt 7
stepping	NotreDame_De_Paris.txt 3
steps	NotreDame_De_Paris.txt 42
sterile	NotreDame_De_Paris.txt 1
stern	NotreDame_De_Paris.txt 3
stick	NotreDame_De_Paris.txt 1
stiff	NotreDame_De_Paris.txt 5
stiffen	NotreDame_De_Paris.txt 1
stiffened	NotreDame_De_Paris.txt 2
stiffening	NotreDame_De_Paris.txt 1
stiffly	NotreDame_De_Paris.txt 1
stiffness	NotreDame_De_Paris.txt 1
stifle	NotreDame_De_Paris.txt 2
stifled	NotreDame_De_Paris.txt 7
stifling	NotreDame_De_Paris.txt 2
stigma	NotreDame_De_Paris.txt 1
still	NotreDame_De_Paris.txt 218
stilled	NotreDame_De_Paris.txt 1
stimulos	NotreDame_De_Paris.txt 1
sting	NotreDame_De_Paris.txt 3
stinging	NotreDame_De_Paris.txt 2
stings	NotreDame_De_Paris.txt 1
stinking	NotreDame_De_Paris.txt 2
stir	NotreDame_De_Paris.txt 7
stirred	NotreDame_De_Paris.txt 7
stirring	NotreDame_De_Paris.txt 2
stirrups	NotreDame_De_Paris.txt 1
stirs	NotreDame_De_Paris.txt 1
stitched	NotreDame_De_Paris.txt 1
stock	NotreDame_De_Paris.txt 2
stockings	NotreDame_De_Paris.txt 1
stoical	NotreDame_De_Paris.txt 1
stoically	NotreDame_De_Paris.txt 2
stole	NotreDame_De_Paris.txt 6
stolen	NotreDame_De_Paris.txt 10
stomach	NotreDame_De_Paris.txt 4
stone	NotreDame_De_Paris.txt 140
stoned	NotreDame_De_Paris.txt 2
stones	NotreDame_De_Paris.txt 37
stoning	NotreDame_De_Paris.txt 1
stood	NotreDame_De_Paris.txt 45
stool	NotreDame_De_Paris.txt 12
stools	NotreDame_De_Paris.txt 5
stoop	NotreDame_De_Paris.txt 2
stooped	NotreDame_De_Paris.txt 5
stop	NotreDame_De_Paris.txt 8
stopped	NotreDame_De_Paris.txt 21
stopping	NotreDame_De_Paris.txt 5
stops	NotreDame_De_Paris.txt 1
store	NotreDame_De_Paris.txt 1
stored	NotreDame_De_Paris.txt 2
storehouse	NotreDame_De_Paris.txt 1
stories	NotreDame_De_Paris.txt 10
storm	NotreDame_De_Paris.txt 2
storms	NotreDame_De_Paris.txt 1
stormy	NotreDame_De_Paris.txt 1
story	NotreDame_De_Paris.txt 25
stout	NotreDame_De_Paris.txt 7
stoutly	NotreDame_De_Paris.txt 2
stove	NotreDame_De_Paris.txt 1
stovepipes	NotreDame_De_Paris.txt 1
stradivarius	NotreDame_De_Paris.txt 1
straight	NotreDame_De_Paris.txt 16
straighten	NotreDame_De_Paris.txt 2
straightened	NotreDame_De_Paris.txt 3
strained	NotreDame_De_Paris.txt 1
strand	NotreDame_De_Paris.txt 5
stranded	NotreDame_De_Paris.txt 1
strange	NotreDame_De_Paris.txt 44
strangely	NotreDame_De_Paris.txt 3
stranger	NotreDame_De_Paris.txt 18
strangle	NotreDame_De_Paris.txt 2
strangled	NotreDame_De_Paris.txt 3
strap	NotreDame_De_Paris.txt 3
strappado	NotreDame_De_Paris.txt 1
straps	NotreDame_De_Paris.txt 4
strasbourg	NotreDame_De_Paris.txt 3
strasburg	NotreDame_De_Paris.txt 2
stratagem	NotreDame_De_Paris.txt 1
stratum	NotreDame_De_Paris.txt 1
straw	NotreDame_De_Paris.txt 15
stray	NotreDame_De_Paris.txt 2
strayed	NotreDame_De_Paris.txt 1
straying	NotreDame_De_Paris.txt 1
streak	NotreDame_De_Paris.txt 2
streaked	NotreDame_De_Paris.txt 1
stream	NotreDame_De_Paris.txt 9
streaming	NotreDame_De_Paris.txt 1
streams	NotreDame_De_Paris.txt 4
street	NotreDame_De_Paris.txt 52
streets	NotreDame_De_Paris.txt 58
strength	NotreDame_De_Paris.txt 22
stretch	NotreDame_De_Paris.txt 4
stretched	NotreDame_De_Paris.txt 12
stretches	NotreDame_De_Paris.txt 2
stretching	NotreDame_De_Paris.txt 4
strette	NotreDame_De_Paris.txt 1
strewing	NotreDame_De_Paris.txt 1
strewn	NotreDame_De_Paris.txt 2
stricken	NotreDame_De_Paris.txt 3
strict	NotreDame_De_Paris.txt 1
stride	NotreDame_De_Paris.txt 2
strides	NotreDame_De_Paris.txt 11
strife	NotreDame_De_Paris.txt 1
strike	NotreDame_De_Paris.txt 7
strikes	NotreDame_De_Paris.txt 4
striking	NotreDame_De_Paris.txt 5
string	NotreDame_De_Paris.txt 3
strip	NotreDame_De_Paris.txt 2
striped	NotreDame_De_Paris.txt 2
stripes	NotreDame_De_Paris.txt 1
stripped	NotreDame_De_Paris.txt 5
stripping	NotreDame_De_Paris.txt 1
strips	NotreDame_De_Paris.txt 2
strode	NotreDame_De_Paris.txt 2
stroke	NotreDame_De_Paris.txt 5
strokes	NotreDame_De_Paris.txt 3
stroller	NotreDame_De_Paris.txt 1
strong	NotreDame_De_Paris.txt 14
stronger	NotreDame_De_Paris.txt 3
stronghold	NotreDame_De_Paris.txt 1
strongly	NotreDame_De_Paris.txt 4
strove	NotreDame_De_Paris.txt 4
struck	NotreDame_De_Paris.txt 33
structure	NotreDame_De_Paris.txt 5
structures	NotreDame_De_Paris.txt 1
struggle	NotreDame_De_Paris.txt 4
struggled	NotreDame_De_Paris.txt 3
struggles	NotreDame_De_Paris.txt 1
struggling	NotreDame_De_Paris.txt 3
strutting	NotreDame_De_Paris.txt 1
stryga	NotreDame_De_Paris.txt 2
stuck	NotreDame_De_Paris.txt 1
studded	NotreDame_De_Paris.txt 4
student	NotreDame_De_Paris.txt 9
students	NotreDame_De_Paris.txt 8
studied	NotreDame_De_Paris.txt 6
studies	NotreDame_De_Paris.txt 2
studios	NotreDame_De_Paris.txt 1
study	NotreDame_De_Paris.txt 7
studying	NotreDame_De_Paris.txt 2
stuff	NotreDame_De_Paris.txt 2
stuffed	NotreDame_De_Paris.txt 2
stuffs	NotreDame_De_Paris.txt 2
stumble	NotreDame_De_Paris.txt 1
stumbled	NotreDame_De_Paris.txt 3
stumbling	NotreDame_De_Paris.txt 1
stumps	NotreDame_De_Paris.txt 3
stung	NotreDame_De_Paris.txt 3
stunned	NotreDame_De_Paris.txt 3
stunted	NotreDame_De_Paris.txt 1
stupefaction	NotreDame_De_Paris.txt 3
stupefied	NotreDame_De_Paris.txt 10
stupenda	NotreDame_De_Paris.txt 1
stupendous	NotreDame_De_Paris.txt 1
stupid	NotreDame_De_Paris.txt 9
stupidity	NotreDame_De_Paris.txt 2
stupidly	NotreDame_De_Paris.txt 4
stupor	NotreDame_De_Paris.txt 5
sturdy	NotreDame_De_Paris.txt 1
stutterers	NotreDame_De_Paris.txt 1
stuttering	NotreDame_De_Paris.txt 1
style	NotreDame_De_Paris.txt 7
styled	NotreDame_De_Paris.txt 1
styles	NotreDame_De_Paris.txt 1
styrga	NotreDame_De_Paris.txt 1
styx	NotreDame_De_Paris.txt 1
sua	NotreDame_De_Paris.txt 2
suavissima	NotreDame_De_Paris.txt 1
sub	NotreDame_De_Paris.txt 8
subdeacon	NotreDame_De_Paris.txt 1
subject	NotreDame_De_Paris.txt 9
subjection	NotreDame_De_Paris.txt 1
subjects	NotreDame_De_Paris.txt 1
sublime	NotreDame_De_Paris.txt 9
submerged	NotreDame_De_Paris.txt 3
submission	NotreDame_De_Paris.txt 1
submissive	NotreDame_De_Paris.txt 3
submit	NotreDame_De_Paris.txt 1
submitted	NotreDame_De_Paris.txt 1
submitting	NotreDame_De_Paris.txt 1
subscribe	NotreDame_De_Paris.txt 1
subservient	NotreDame_De_Paris.txt 1
subsisting	NotreDame_De_Paris.txt 1
substance	NotreDame_De_Paris.txt 4
substantia	NotreDame_De_Paris.txt 1
substituted	NotreDame_De_Paris.txt 1
substituting	NotreDame_De_Paris.txt 1
subterfuge	NotreDame_De_Paris.txt 1
subterranean	NotreDame_De_Paris.txt 5
subtle	NotreDame_De_Paris.txt 5
suburb	NotreDame_De_Paris.txt 2
suburban	NotreDame_De_Paris.txt 2
suburbs	NotreDame_De_Paris.txt 2
succeed	NotreDame_De_Paris.txt 5
succeeded	NotreDame_De_Paris.txt 17
succeeding	NotreDame_De_Paris.txt 3
succeeds	NotreDame_De_Paris.txt 2
success	NotreDame_De_Paris.txt 5
successes	NotreDame_De_Paris.txt 2
successful	NotreDame_De_Paris.txt 1
successfully	NotreDame_De_Paris.txt 4
succession	NotreDame_De_Paris.txt 11
successive	NotreDame_De_Paris.txt 5
successively	NotreDame_De_Paris.txt 6
successor	NotreDame_De_Paris.txt 1
succinctly	NotreDame_De_Paris.txt 1
succor	NotreDame_De_Paris.txt 5
succoured	NotreDame_De_Paris.txt 1
such	NotreDame_De_Paris.txt 126
suck	NotreDame_De_Paris.txt 4
sucking	NotreDame_De_Paris.txt 1
suckle	NotreDame_De_Paris.txt 1
suckled	NotreDame_De_Paris.txt 1
sucks	NotreDame_De_Paris.txt 1
sudden	NotreDame_De_Paris.txt 10
suddenly	NotreDame_De_Paris.txt 78
suffer	NotreDame_De_Paris.txt 9
suffered	NotreDame_De_Paris.txt 11
sufferer	NotreDame_De_Paris.txt 2
sufferers	NotreDame_De_Paris.txt 1
suffering	NotreDame_De_Paris.txt 5
sufferings	NotreDame_De_Paris.txt 1
suffers	NotreDame_De_Paris.txt 1
suffice	NotreDame_De_Paris.txt 5
sufficed	NotreDame_De_Paris.txt 13
suffices	NotreDame_De_Paris.txt 4
sufficient	NotreDame_De_Paris.txt 15
sufficiently	NotreDame_De_Paris.txt 16
suffocate	NotreDame_De_Paris.txt 1
suffocated	NotreDame_De_Paris.txt 1
suffrages	NotreDame_De_Paris.txt 1
sugar	NotreDame_De_Paris.txt 1
suggested	NotreDame_De_Paris.txt 2
suggestion	NotreDame_De_Paris.txt 1
suggestions	NotreDame_De_Paris.txt 1
sui	NotreDame_De_Paris.txt 1
suilly	NotreDame_De_Paris.txt 1
suit	NotreDame_De_Paris.txt 9
suitable	NotreDame_De_Paris.txt 4
suitably	NotreDame_De_Paris.txt 1
suite	NotreDame_De_Paris.txt 3
suites	NotreDame_De_Paris.txt 1
suits	NotreDame_De_Paris.txt 4
sulking	NotreDame_De_Paris.txt 1
sullen	NotreDame_De_Paris.txt 1
sulphurous	NotreDame_De_Paris.txt 1
sulpice	NotreDame_De_Paris.txt 4
sum	NotreDame_De_Paris.txt 8
summarily	NotreDame_De_Paris.txt 1
summary	NotreDame_De_Paris.txt 1
summed	NotreDame_De_Paris.txt 3
summer	NotreDame_De_Paris.txt 7
summit	NotreDame_De_Paris.txt 21
summits	NotreDame_De_Paris.txt 4
summon	NotreDame_De_Paris.txt 3
summoned	NotreDame_De_Paris.txt 3
summons	NotreDame_De_Paris.txt 1
sumpter	NotreDame_De_Paris.txt 1
sumptuary	NotreDame_De_Paris.txt 1
sumptuous	NotreDame_De_Paris.txt 1
sumptuousness	NotreDame_De_Paris.txt 1
sun	NotreDame_De_Paris.txt 64
sunburned	NotreDame_De_Paris.txt 1
sunday	NotreDame_De_Paris.txt 6
sundays	NotreDame_De_Paris.txt 1
sung	NotreDame_De_Paris.txt 1
sunk	NotreDame_De_Paris.txt 2
sunlight	NotreDame_De_Paris.txt 7
sunny	NotreDame_De_Paris.txt 2
sunrise	NotreDame_De_Paris.txt 1
sunset	NotreDame_De_Paris.txt 2
sunshine	NotreDame_De_Paris.txt 3
sup	NotreDame_De_Paris.txt 2
super	NotreDame_De_Paris.txt 1
superabundance	NotreDame_De_Paris.txt 1
superb	NotreDame_De_Paris.txt 7
superbly	NotreDame_De_Paris.txt 2
superciliary	NotreDame_De_Paris.txt 1
superfluous	NotreDame_De_Paris.txt 1
superhuman	NotreDame_De_Paris.txt 5
superintendent	NotreDame_De_Paris.txt 1
superintending	NotreDame_De_Paris.txt 1
superior	NotreDame_De_Paris.txt 3
superiority	NotreDame_De_Paris.txt 2
supernatural	NotreDame_De_Paris.txt 5
superposed	NotreDame_De_Paris.txt 3
superposes	NotreDame_De_Paris.txt 1
supersede	NotreDame_De_Paris.txt 1
superspecula	NotreDame_De_Paris.txt 1
superstition	NotreDame_De_Paris.txt 2
superstitions	NotreDame_De_Paris.txt 3
superstitious	NotreDame_De_Paris.txt 2
supped	NotreDame_De_Paris.txt 5
supper	NotreDame_De_Paris.txt 10
suppers	NotreDame_De_Paris.txt 1
supplanted	NotreDame_De_Paris.txt 2
supple	NotreDame_De_Paris.txt 3
suppliant	NotreDame_De_Paris.txt 6
supplicants	NotreDame_De_Paris.txt 1
supplicate	NotreDame_De_Paris.txt 1
supplicating	NotreDame_De_Paris.txt 2
supplicatingly	NotreDame_De_Paris.txt 1
supply	NotreDame_De_Paris.txt 3
support	NotreDame_De_Paris.txt 15
supported	NotreDame_De_Paris.txt 4
supporting	NotreDame_De_Paris.txt 2
supports	NotreDame_De_Paris.txt 4
suppose	NotreDame_De_Paris.txt 9
supposed	NotreDame_De_Paris.txt 13
supposing	NotreDame_De_Paris.txt 4
supposition	NotreDame_De_Paris.txt 1
suppressed	NotreDame_De_Paris.txt 3
supremacy	NotreDame_De_Paris.txt 1
supreme	NotreDame_De_Paris.txt 6
sur	NotreDame_De_Paris.txt 4
surcharged	NotreDame_De_Paris.txt 1
surcoat	NotreDame_De_Paris.txt 3
surcoats	NotreDame_De_Paris.txt 2
surdus	NotreDame_De_Paris.txt 1
sure	NotreDame_De_Paris.txt 18
surely	NotreDame_De_Paris.txt 3
surface	NotreDame_De_Paris.txt 14
surfaces	NotreDame_De_Paris.txt 2
surfeited	NotreDame_De_Paris.txt 1
surged	NotreDame_De_Paris.txt 1
surgeon	NotreDame_De_Paris.txt 1
surging	NotreDame_De_Paris.txt 1
surly	NotreDame_De_Paris.txt 20
surmise	NotreDame_De_Paris.txt 3
surmount	NotreDame_De_Paris.txt 2
surmounted	NotreDame_De_Paris.txt 2
surname	NotreDame_De_Paris.txt 2
surnamed	NotreDame_De_Paris.txt 1
surnames	NotreDame_De_Paris.txt 1
surplice	NotreDame_De_Paris.txt 2
surplices	NotreDame_De_Paris.txt 1
surprise	NotreDame_De_Paris.txt 18
surprised	NotreDame_De_Paris.txt 9
surprising	NotreDame_De_Paris.txt 1
surprisingly	NotreDame_De_Paris.txt 1
surrendered	NotreDame_De_Paris.txt 1
surround	NotreDame_De_Paris.txt 2
surrounded	NotreDame_De_Paris.txt 25
surrounding	NotreDame_De_Paris.txt 3
surrounds	NotreDame_De_Paris.txt 3
surtout	NotreDame_De_Paris.txt 3
survey	NotreDame_De_Paris.txt 2
surveyed	NotreDame_De_Paris.txt 3
surveying	NotreDame_De_Paris.txt 1
surveyor	NotreDame_De_Paris.txt 1
survive	NotreDame_De_Paris.txt 1
survived	NotreDame_De_Paris.txt 1
survives	NotreDame_De_Paris.txt 1
suscitantibus	NotreDame_De_Paris.txt 1
suspect	NotreDame_De_Paris.txt 1
suspected	NotreDame_De_Paris.txt 3
suspecting	NotreDame_De_Paris.txt 1
suspects	NotreDame_De_Paris.txt 1
suspended	NotreDame_De_Paris.txt 15
suspending	NotreDame_De_Paris.txt 1
suspense	NotreDame_De_Paris.txt 4
suspicion	NotreDame_De_Paris.txt 4
suspicions	NotreDame_De_Paris.txt 2
suspicious	NotreDame_De_Paris.txt 1
sustain	NotreDame_De_Paris.txt 1
sustained	NotreDame_De_Paris.txt 4
sustaining	NotreDame_De_Paris.txt 1
suzerain	NotreDame_De_Paris.txt 4
swaddling	NotreDame_De_Paris.txt 3
swallowed	NotreDame_De_Paris.txt 2
swallowing	NotreDame_De_Paris.txt 1
swallows	NotreDame_De_Paris.txt 3
swam	NotreDame_De_Paris.txt 2
swamp	NotreDame_De_Paris.txt 1
swan	NotreDame_De_Paris.txt 4
swans	NotreDame_De_Paris.txt 1
swarm	NotreDame_De_Paris.txt 5
swarmed	NotreDame_De_Paris.txt 3
swarming	NotreDame_De_Paris.txt 4
swarms	NotreDame_De_Paris.txt 1
swarthy	NotreDame_De_Paris.txt 1
swathed	NotreDame_De_Paris.txt 3
sway	NotreDame_De_Paris.txt 2
swayed	NotreDame_De_Paris.txt 2
swear	NotreDame_De_Paris.txt 19
swearing	NotreDame_De_Paris.txt 6
sweat	NotreDame_De_Paris.txt 3
sweaters	NotreDame_De_Paris.txt 1
sweating	NotreDame_De_Paris.txt 2
sweep	NotreDame_De_Paris.txt 1
sweeping	NotreDame_De_Paris.txt 2
sweeps	NotreDame_De_Paris.txt 2
sweet	NotreDame_De_Paris.txt 23
sweeter	NotreDame_De_Paris.txt 4
sweetly	NotreDame_De_Paris.txt 1
sweetness	NotreDame_De_Paris.txt 10
swell	NotreDame_De_Paris.txt 5
swelled	NotreDame_De_Paris.txt 2
swelleth	NotreDame_De_Paris.txt 1
swelling	NotreDame_De_Paris.txt 2
swells	NotreDame_De_Paris.txt 2
swept	NotreDame_De_Paris.txt 2
swiftness	NotreDame_De_Paris.txt 5
swim	NotreDame_De_Paris.txt 1
swimming	NotreDame_De_Paris.txt 5
swims	NotreDame_De_Paris.txt 1
swine	NotreDame_De_Paris.txt 4
swinging	NotreDame_De_Paris.txt 3
swiss	NotreDame_De_Paris.txt 2
swollen	NotreDame_De_Paris.txt 3
swoon	NotreDame_De_Paris.txt 2
swooped	NotreDame_De_Paris.txt 1
sword	NotreDame_De_Paris.txt 31
swordfish	NotreDame_De_Paris.txt 1
swordhilt	NotreDame_De_Paris.txt 1
swords	NotreDame_De_Paris.txt 7
swore	NotreDame_De_Paris.txt 8
sworn	NotreDame_De_Paris.txt 8
swung	NotreDame_De_Paris.txt 4
syllable	NotreDame_De_Paris.txt 4
syllables	NotreDame_De_Paris.txt 1
symbol	NotreDame_De_Paris.txt 16
symbolical	NotreDame_De_Paris.txt 5
symbolism	NotreDame_De_Paris.txt 5
symbols	NotreDame_De_Paris.txt 4
symmetrical	NotreDame_De_Paris.txt 1
sympathetic	NotreDame_De_Paris.txt 1
sympathy	NotreDame_De_Paris.txt 5
symphony	NotreDame_De_Paris.txt 4
symptoms	NotreDame_De_Paris.txt 1
synagogue	NotreDame_De_Paris.txt 1
synonymous	NotreDame_De_Paris.txt 1
syriac	NotreDame_De_Paris.txt 1
system	NotreDame_De_Paris.txt 4
systems	NotreDame_De_Paris.txt 3
