o	NotreDame_De_Paris.txt 17
oak	NotreDame_De_Paris.txt 7
oaken	NotreDame_De_Paris.txt 2
oaks	NotreDame_De_Paris.txt 1
oars	NotreDame_De_Paris.txt 3
oath	NotreDame_De_Paris.txt 7
oaths	NotreDame_De_Paris.txt 5
obedience	NotreDame_De_Paris.txt 3
obedient	NotreDame_De_Paris.txt 1
obelisk	NotreDame_De_Paris.txt 4
obelisks	NotreDame_De_Paris.txt 2
obey	NotreDame_De_Paris.txt 2
obeyed	NotreDame_De_Paris.txt 4
object	NotreDame_De_Paris.txt 14
objected	NotreDame_De_Paris.txt 1
objecting	NotreDame_De_Paris.txt 1
objection	NotreDame_De_Paris.txt 1
objections	NotreDame_De_Paris.txt 1
objects	NotreDame_De_Paris.txt 10
obliged	NotreDame_De_Paris.txt 28
oblique	NotreDame_De_Paris.txt 2
obliterated	NotreDame_De_Paris.txt 2
oblivion	NotreDame_De_Paris.txt 2
oblong	NotreDame_De_Paris.txt 3
obscene	NotreDame_De_Paris.txt 1
obscure	NotreDame_De_Paris.txt 9
obscured	NotreDame_De_Paris.txt 1
obscurity	NotreDame_De_Paris.txt 1
obsequies	NotreDame_De_Paris.txt 1
observation	NotreDame_De_Paris.txt 1
observations	NotreDame_De_Paris.txt 1
observatory	NotreDame_De_Paris.txt 1
observe	NotreDame_De_Paris.txt 8
observed	NotreDame_De_Paris.txt 17
observes	NotreDame_De_Paris.txt 1
observing	NotreDame_De_Paris.txt 2
obsessor	NotreDame_De_Paris.txt 1
obsessus	NotreDame_De_Paris.txt 1
obsolete	NotreDame_De_Paris.txt 1
obstacle	NotreDame_De_Paris.txt 2
obstinacy	NotreDame_De_Paris.txt 1
obstinate	NotreDame_De_Paris.txt 1
obstinately	NotreDame_De_Paris.txt 3
obstructed	NotreDame_De_Paris.txt 2
obstructing	NotreDame_De_Paris.txt 1
obtain	NotreDame_De_Paris.txt 6
obtained	NotreDame_De_Paris.txt 3
obtaining	NotreDame_De_Paris.txt 3
obtains	NotreDame_De_Paris.txt 1
occasion	NotreDame_De_Paris.txt 13
occasionally	NotreDame_De_Paris.txt 4
occasions	NotreDame_De_Paris.txt 1
occult	NotreDame_De_Paris.txt 1
occupant	NotreDame_De_Paris.txt 1
occupations	NotreDame_De_Paris.txt 1
occupied	NotreDame_De_Paris.txt 20
occupies	NotreDame_De_Paris.txt 3
occur	NotreDame_De_Paris.txt 3
occurred	NotreDame_De_Paris.txt 13
occurrence	NotreDame_De_Paris.txt 2
occurrences	NotreDame_De_Paris.txt 1
ocean	NotreDame_De_Paris.txt 2
och	NotreDame_De_Paris.txt 4
octagonal	NotreDame_De_Paris.txt 3
octave	NotreDame_De_Paris.txt 1
octaves	NotreDame_De_Paris.txt 2
october	NotreDame_De_Paris.txt 1
odd	NotreDame_De_Paris.txt 1
odious	NotreDame_De_Paris.txt 4
odo	NotreDame_De_Paris.txt 1
odor	NotreDame_De_Paris.txt 3
oeternam	NotreDame_De_Paris.txt 1
of	NotreDame_De_Paris.txt 7359
off	NotreDame_De_Paris.txt 57
offence	NotreDame_De_Paris.txt 4
offences	NotreDame_De_Paris.txt 1
offended	NotreDame_De_Paris.txt 2
offending	NotreDame_De_Paris.txt 1
offensive	NotreDame_De_Paris.txt 1
offer	NotreDame_De_Paris.txt 3
offered	NotreDame_De_Paris.txt 10
offers	NotreDame_De_Paris.txt 2
offertory	NotreDame_De_Paris.txt 1
office	NotreDame_De_Paris.txt 18
officer	NotreDame_De_Paris.txt 40
officers	NotreDame_De_Paris.txt 6
offices	NotreDame_De_Paris.txt 2
official	NotreDame_De_Paris.txt 20
officiality	NotreDame_De_Paris.txt 3
officialty	NotreDame_De_Paris.txt 3
officiis	NotreDame_De_Paris.txt 1
offspring	NotreDame_De_Paris.txt 1
often	NotreDame_De_Paris.txt 29
ogive	NotreDame_De_Paris.txt 3
ogni	NotreDame_De_Paris.txt 3
oh	NotreDame_De_Paris.txt 179
oil	NotreDame_De_Paris.txt 4
oily	NotreDame_De_Paris.txt 1
ois	NotreDame_De_Paris.txt 5
oiseau	NotreDame_De_Paris.txt 2
oiselle	NotreDame_De_Paris.txt 2
oison	NotreDame_De_Paris.txt 2
ol	NotreDame_De_Paris.txt 1
old	NotreDame_De_Paris.txt 168
older	NotreDame_De_Paris.txt 2
olfactory	NotreDame_De_Paris.txt 1
olim	NotreDame_De_Paris.txt 1
olive	NotreDame_De_Paris.txt 2
olivier	NotreDame_De_Paris.txt 43
olympian	NotreDame_De_Paris.txt 1
olympus	NotreDame_De_Paris.txt 2
omelette	NotreDame_De_Paris.txt 1
omelettes	NotreDame_De_Paris.txt 2
omer	NotreDame_De_Paris.txt 1
omit	NotreDame_De_Paris.txt 1
omitted	NotreDame_De_Paris.txt 1
omnem	NotreDame_De_Paris.txt 1
omnes	NotreDame_De_Paris.txt 2
omnia	NotreDame_De_Paris.txt 2
omnibus	NotreDame_De_Paris.txt 1
omnimodam	NotreDame_De_Paris.txt 1
omnipotentem	NotreDame_De_Paris.txt 1
on	NotreDame_De_Paris.txt 1273
once	NotreDame_De_Paris.txt 176
onde	NotreDame_De_Paris.txt 1
one	NotreDame_De_Paris.txt 939
ones	NotreDame_De_Paris.txt 6
onion	NotreDame_De_Paris.txt 1
online	NotreDame_De_Paris.txt 4
only	NotreDame_De_Paris.txt 280
onward	NotreDame_De_Paris.txt 2
opaque	NotreDame_De_Paris.txt 1
open	NotreDame_De_Paris.txt 72
opened	NotreDame_De_Paris.txt 59
opening	NotreDame_De_Paris.txt 25
openings	NotreDame_De_Paris.txt 1
opens	NotreDame_De_Paris.txt 7
openwork	NotreDame_De_Paris.txt 1
opera	NotreDame_De_Paris.txt 3
operate	NotreDame_De_Paris.txt 2
operated	NotreDame_De_Paris.txt 1
operation	NotreDame_De_Paris.txt 6
operatione	NotreDame_De_Paris.txt 1
ophile	NotreDame_De_Paris.txt 1
opinion	NotreDame_De_Paris.txt 9
opistathonos	NotreDame_De_Paris.txt 1
opportune	NotreDame_De_Paris.txt 1
opportunities	NotreDame_De_Paris.txt 1
opportunity	NotreDame_De_Paris.txt 7
opposed	NotreDame_De_Paris.txt 1
opposite	NotreDame_De_Paris.txt 20
opposition	NotreDame_De_Paris.txt 1
oppressions	NotreDame_De_Paris.txt 1
opprobrium	NotreDame_De_Paris.txt 1
optical	NotreDame_De_Paris.txt 2
optimum	NotreDame_De_Paris.txt 1
opulence	NotreDame_De_Paris.txt 3
opulent	NotreDame_De_Paris.txt 2
or	NotreDame_De_Paris.txt 337
ora	NotreDame_De_Paris.txt 1
orange	NotreDame_De_Paris.txt 2
orare	NotreDame_De_Paris.txt 1
oration	NotreDame_De_Paris.txt 1
orator	NotreDame_De_Paris.txt 1
oratory	NotreDame_De_Paris.txt 2
orbis	NotreDame_De_Paris.txt 1
orchard	NotreDame_De_Paris.txt 1
orchestra	NotreDame_De_Paris.txt 4
ordain	NotreDame_De_Paris.txt 1
ordained	NotreDame_De_Paris.txt 2
order	NotreDame_De_Paris.txt 102
ordered	NotreDame_De_Paris.txt 4
orders	NotreDame_De_Paris.txt 6
ordinance	NotreDame_De_Paris.txt 3
ordinances	NotreDame_De_Paris.txt 2
ordinarily	NotreDame_De_Paris.txt 2
ordinary	NotreDame_De_Paris.txt 5
oreille	NotreDame_De_Paris.txt 2
org	NotreDame_De_Paris.txt 13
organ	NotreDame_De_Paris.txt 4
organa	NotreDame_De_Paris.txt 2
organism	NotreDame_De_Paris.txt 1
organization	NotreDame_De_Paris.txt 2
organized	NotreDame_De_Paris.txt 4
organizing	NotreDame_De_Paris.txt 1
organs	NotreDame_De_Paris.txt 5
orgy	NotreDame_De_Paris.txt 6
orient	NotreDame_De_Paris.txt 5
oriental	NotreDame_De_Paris.txt 3
orifice	NotreDame_De_Paris.txt 1
oriflammes	NotreDame_De_Paris.txt 1
origin	NotreDame_De_Paris.txt 3
original	NotreDame_De_Paris.txt 3
originalities	NotreDame_De_Paris.txt 1
originality	NotreDame_De_Paris.txt 5
originator	NotreDame_De_Paris.txt 1
oriole	NotreDame_De_Paris.txt 1
orison	NotreDame_De_Paris.txt 1
orleans	NotreDame_De_Paris.txt 2
ornament	NotreDame_De_Paris.txt 2
ornamented	NotreDame_De_Paris.txt 10
ornaments	NotreDame_De_Paris.txt 2
orororororoi	NotreDame_De_Paris.txt 1
orphan	NotreDame_De_Paris.txt 4
orphaned	NotreDame_De_Paris.txt 1
orpheus	NotreDame_De_Paris.txt 4
orpiment	NotreDame_De_Paris.txt 1
orthography	NotreDame_De_Paris.txt 1
oscillations	NotreDame_De_Paris.txt 4
other	NotreDame_De_Paris.txt 307
others	NotreDame_De_Paris.txt 46
otherwise	NotreDame_De_Paris.txt 7
ottoman	NotreDame_De_Paris.txt 1
ou	NotreDame_De_Paris.txt 1
ouais	NotreDame_De_Paris.txt 1
oubliettes	NotreDame_De_Paris.txt 1
oudard	NotreDame_De_Paris.txt 1
oudarde	NotreDame_De_Paris.txt 47
ouf	NotreDame_De_Paris.txt 1
ought	NotreDame_De_Paris.txt 17
ounces	NotreDame_De_Paris.txt 1
our	NotreDame_De_Paris.txt 198
ours	NotreDame_De_Paris.txt 3
ourselves	NotreDame_De_Paris.txt 10
ousted	NotreDame_De_Paris.txt 1
out	NotreDame_De_Paris.txt 234
outbreak	NotreDame_De_Paris.txt 1
outbreaks	NotreDame_De_Paris.txt 1
outburst	NotreDame_De_Paris.txt 2
outbursts	NotreDame_De_Paris.txt 1
outcast	NotreDame_De_Paris.txt 9
outcasts	NotreDame_De_Paris.txt 21
outcry	NotreDame_De_Paris.txt 1
outdated	NotreDame_De_Paris.txt 1
outfit	NotreDame_De_Paris.txt 5
outgrown	NotreDame_De_Paris.txt 1
outline	NotreDame_De_Paris.txt 5
outlined	NotreDame_De_Paris.txt 6
outlines	NotreDame_De_Paris.txt 4
outlining	NotreDame_De_Paris.txt 1
outrageous	NotreDame_De_Paris.txt 2
outrageously	NotreDame_De_Paris.txt 1
outright	NotreDame_De_Paris.txt 1
outside	NotreDame_De_Paris.txt 29
outspread	NotreDame_De_Paris.txt 2
outstretched	NotreDame_De_Paris.txt 6
outward	NotreDame_De_Paris.txt 1
outwards	NotreDame_De_Paris.txt 2
oven	NotreDame_De_Paris.txt 1
over	NotreDame_De_Paris.txt 199
overcome	NotreDame_De_Paris.txt 3
overdress	NotreDame_De_Paris.txt 1
overflow	NotreDame_De_Paris.txt 3
overflowed	NotreDame_De_Paris.txt 3
overflowing	NotreDame_De_Paris.txt 2
overflows	NotreDame_De_Paris.txt 3
overhead	NotreDame_De_Paris.txt 1
overleaped	NotreDame_De_Paris.txt 1
overloaded	NotreDame_De_Paris.txt 3
overloading	NotreDame_De_Paris.txt 1
overmuch	NotreDame_De_Paris.txt 1
overshadowed	NotreDame_De_Paris.txt 1
overshot	NotreDame_De_Paris.txt 1
overstepped	NotreDame_De_Paris.txt 1
overthrow	NotreDame_De_Paris.txt 1
overthrown	NotreDame_De_Paris.txt 3
overtook	NotreDame_De_Paris.txt 2
overturned	NotreDame_De_Paris.txt 4
overwhelm	NotreDame_De_Paris.txt 1
overwhelmed	NotreDame_De_Paris.txt 7
overwhelming	NotreDame_De_Paris.txt 2
owe	NotreDame_De_Paris.txt 7
owed	NotreDame_De_Paris.txt 3
owes	NotreDame_De_Paris.txt 1
owing	NotreDame_De_Paris.txt 2
owl	NotreDame_De_Paris.txt 6
owls	NotreDame_De_Paris.txt 5
own	NotreDame_De_Paris.txt 54
owned	NotreDame_De_Paris.txt 1
owner	NotreDame_De_Paris.txt 6
owns	NotreDame_De_Paris.txt 4
ox	NotreDame_De_Paris.txt 1
oxen	NotreDame_De_Paris.txt 1
oyster	NotreDame_De_Paris.txt 1
