h	Miserables.txt 1
ha	Miserables.txt 3
habana	Miserables.txt 1
habemus	Miserables.txt 1
habiliments	Miserables.txt 2
habilitation	Miserables.txt 1
habilles	Miserables.txt 1
habit	Miserables.txt 60
habitation	Miserables.txt 1
habitations	Miserables.txt 1
habite	Miserables.txt 1
habits	Miserables.txt 22
habitual	Miserables.txt 13
habitually	Miserables.txt 11
habituated	Miserables.txt 5
hacke	Miserables.txt 2
hacked	Miserables.txt 2
hackney	Miserables.txt 19
had	Miserables.txt 6181
hadn	Miserables.txt 3
hadot	Miserables.txt 1
haggard	Miserables.txt 19
haggled	Miserables.txt 1
hags	Miserables.txt 1
haie	Miserables.txt 17
hail	Miserables.txt 5
hailed	Miserables.txt 3
hair	Miserables.txt 156
hairdresser	Miserables.txt 2
hairdressers	Miserables.txt 2
haired	Miserables.txt 16
hairs	Miserables.txt 3
hairy	Miserables.txt 7
hal	Miserables.txt 2
halberd	Miserables.txt 1
halberds	Miserables.txt 1
half	Miserables.txt 229
halkett	Miserables.txt 1
hall	Miserables.txt 58
halle	Miserables.txt 1
halles	Miserables.txt 26
halls	Miserables.txt 2
hallucination	Miserables.txt 10
hallucinations	Miserables.txt 1
halma	Miserables.txt 1
halo	Miserables.txt 4
halos	Miserables.txt 1
halt	Miserables.txt 44
halted	Miserables.txt 82
halter	Miserables.txt 1
halting	Miserables.txt 7
halts	Miserables.txt 7
ham	Miserables.txt 1
hamburg	Miserables.txt 1
hamilton	Miserables.txt 1
hamlet	Miserables.txt 2
hamlets	Miserables.txt 1
hammal	Miserables.txt 1
hammer	Miserables.txt 14
hammering	Miserables.txt 1
hammers	Miserables.txt 2
hanc	Miserables.txt 2
hand	Miserables.txt 543
handcuff	Miserables.txt 1
handcuffs	Miserables.txt 3
handed	Miserables.txt 48
handful	Miserables.txt 17
handfuls	Miserables.txt 4
handicraft	Miserables.txt 1
handing	Miserables.txt 5
handiwork	Miserables.txt 2
handkerchief	Miserables.txt 26
handkerchiefs	Miserables.txt 1
handle	Miserables.txt 28
handled	Miserables.txt 8
handles	Miserables.txt 2
handling	Miserables.txt 6
handmaidens	Miserables.txt 1
handmarks	Miserables.txt 1
hands	Miserables.txt 227
handsome	Miserables.txt 48
handsomest	Miserables.txt 1
handwriting	Miserables.txt 9
handy	Miserables.txt 2
hang	Miserables.txt 13
hanged	Miserables.txt 1
hanging	Miserables.txt 27
hangings	Miserables.txt 1
hangman	Miserables.txt 2
hangs	Miserables.txt 3
hannibal	Miserables.txt 6
hannibals	Miserables.txt 1
hanoverian	Miserables.txt 5
hanoverians	Miserables.txt 2
hap	Miserables.txt 9
hapgood	Miserables.txt 2
haphazard	Miserables.txt 2
happen	Miserables.txt 26
happened	Miserables.txt 58
happens	Miserables.txt 18
happier	Miserables.txt 2
happily	Miserables.txt 3
happiness	Miserables.txt 108
happinesses	Miserables.txt 1
happy	Miserables.txt 150
hapsburgs	Miserables.txt 1
harangue	Miserables.txt 8
harangued	Miserables.txt 2
harangues	Miserables.txt 3
haranguing	Miserables.txt 2
harass	Miserables.txt 1
harassed	Miserables.txt 4
harassing	Miserables.txt 2
hard	Miserables.txt 50
hardened	Miserables.txt 2
hardens	Miserables.txt 2
harder	Miserables.txt 1
hardest	Miserables.txt 1
hardihood	Miserables.txt 2
hardly	Miserables.txt 114
hardness	Miserables.txt 4
hardship	Miserables.txt 1
hardships	Miserables.txt 1
hare	Miserables.txt 2
harem	Miserables.txt 1
hares	Miserables.txt 1
harlequin	Miserables.txt 2
harlequinade	Miserables.txt 1
harlequins	Miserables.txt 1
harlet	Miserables.txt 1
harley	Miserables.txt 1
harm	Miserables.txt 22
harmed	Miserables.txt 1
harmless	Miserables.txt 1
harmodius	Miserables.txt 2
harmonies	Miserables.txt 1
harmonious	Miserables.txt 3
harmony	Miserables.txt 9
harness	Miserables.txt 7
harnessed	Miserables.txt 15
harp	Miserables.txt 1
harpe	Miserables.txt 1
harper	Miserables.txt 1
harping	Miserables.txt 1
harrassed	Miserables.txt 1
harrows	Miserables.txt 1
harsh	Miserables.txt 28
harsher	Miserables.txt 1
harshest	Miserables.txt 2
harshly	Miserables.txt 12
harshness	Miserables.txt 11
hart	Miserables.txt 2
hartwell	Miserables.txt 1
harvest	Miserables.txt 5
harvester	Miserables.txt 1
harvesting	Miserables.txt 1
has	Miserables.txt 1080
hasardeux	Miserables.txt 1
hashish	Miserables.txt 1
hasn	Miserables.txt 5
hast	Miserables.txt 8
haste	Miserables.txt 72
hasten	Miserables.txt 7
hastened	Miserables.txt 20
hastening	Miserables.txt 5
hastens	Miserables.txt 2
hastily	Miserables.txt 41
hasty	Miserables.txt 4
hat	Miserables.txt 92
hatchers	Miserables.txt 1
hatchway	Miserables.txt 2
hate	Miserables.txt 18
hated	Miserables.txt 15
hating	Miserables.txt 5
hatless	Miserables.txt 2
hatred	Miserables.txt 45
hatreds	Miserables.txt 5
hats	Miserables.txt 18
haudriettes	Miserables.txt 3
haughtily	Miserables.txt 2
haughty	Miserables.txt 22
haunches	Miserables.txt 3
haunt	Miserables.txt 4
haunted	Miserables.txt 6
haunts	Miserables.txt 1
haut	Miserables.txt 8
hautes	Miserables.txt 3
hauteville	Miserables.txt 2
hautpoul	Miserables.txt 1
have	Miserables.txt 2796
haveing	Miserables.txt 1
haven	Miserables.txt 12
haversack	Miserables.txt 1
having	Miserables.txt 318
havre	Miserables.txt 2
hawked	Miserables.txt 1
hawthorn	Miserables.txt 5
hawthorns	Miserables.txt 1
haxo	Miserables.txt 2
hay	Miserables.txt 7
haydn	Miserables.txt 1
haye	Miserables.txt 1
haystack	Miserables.txt 1
hazard	Miserables.txt 10
hazarded	Miserables.txt 1
hazardous	Miserables.txt 2
hazards	Miserables.txt 2
haze	Miserables.txt 1
he	Miserables.txt 9647
head	Miserables.txt 468
headache	Miserables.txt 2
headdress	Miserables.txt 1
headed	Miserables.txt 4
headgear	Miserables.txt 1
heading	Miserables.txt 1
headless	Miserables.txt 1
headlong	Miserables.txt 12
headquarters	Miserables.txt 2
heads	Miserables.txt 79
headsman	Miserables.txt 1
headstrong	Miserables.txt 2
headway	Miserables.txt 2
heady	Miserables.txt 1
heal	Miserables.txt 1
healed	Miserables.txt 2
healing	Miserables.txt 4
health	Miserables.txt 35
healthful	Miserables.txt 3
healthy	Miserables.txt 15
heap	Miserables.txt 51
heaped	Miserables.txt 9
heaping	Miserables.txt 2
heaps	Miserables.txt 13
hear	Miserables.txt 106
heard	Miserables.txt 278
hearing	Miserables.txt 27
hears	Miserables.txt 14
hearsay	Miserables.txt 2
hearse	Miserables.txt 29
heart	Miserables.txt 265
heartbroken	Miserables.txt 1
hearted	Miserables.txt 4
hearth	Miserables.txt 22
hearths	Miserables.txt 1
heartily	Miserables.txt 2
heartless	Miserables.txt 2
heartrending	Miserables.txt 8
hearts	Miserables.txt 38
hearty	Miserables.txt 4
heat	Miserables.txt 12
heated	Miserables.txt 3
heath	Miserables.txt 2
heather	Miserables.txt 4
heaths	Miserables.txt 1
heaved	Miserables.txt 3
heaven	Miserables.txt 99
heavenly	Miserables.txt 1
heavens	Miserables.txt 25
heavenward	Miserables.txt 7
heaviest	Miserables.txt 1
heavily	Miserables.txt 10
heaviness	Miserables.txt 2
heaving	Miserables.txt 1
heavy	Miserables.txt 66
hebert	Miserables.txt 2
hebertist	Miserables.txt 1
hebraic	Miserables.txt 1
hebrew	Miserables.txt 4
hebrews	Miserables.txt 1
hectares	Miserables.txt 1
hector	Miserables.txt 1
hecuba	Miserables.txt 1
hedge	Miserables.txt 24
hedged	Miserables.txt 2
hedgehog	Miserables.txt 1
hedgerow	Miserables.txt 1
hedges	Miserables.txt 7
heed	Miserables.txt 22
heeded	Miserables.txt 1
heeding	Miserables.txt 1
heedless	Miserables.txt 8
heedlessness	Miserables.txt 3
heee	Miserables.txt 1
heel	Miserables.txt 10
heels	Miserables.txt 22
heidelberg	Miserables.txt 2
heifer	Miserables.txt 1
height	Miserables.txt 38
heightened	Miserables.txt 1
heights	Miserables.txt 15
heir	Miserables.txt 4
heirs	Miserables.txt 2
held	Miserables.txt 171
helen	Miserables.txt 2
helena	Miserables.txt 4
helene	Miserables.txt 2
heliogabalus	Miserables.txt 1
hell	Miserables.txt 30
hello	Miserables.txt 4
hells	Miserables.txt 2
helmet	Miserables.txt 5
helmeted	Miserables.txt 1
helmets	Miserables.txt 2
help	Miserables.txt 36
helped	Miserables.txt 18
helpful	Miserables.txt 1
helping	Miserables.txt 4
helps	Miserables.txt 2
hem	Miserables.txt 1
hemlock	Miserables.txt 2
hemmed	Miserables.txt 6
hemming	Miserables.txt 1
hemorrhage	Miserables.txt 2
hemp	Miserables.txt 2
hempseed	Miserables.txt 1
hen	Miserables.txt 2
hence	Miserables.txt 72
henceforth	Miserables.txt 37
henquinez	Miserables.txt 1
henri	Miserables.txt 13
henry	Miserables.txt 10
hens	Miserables.txt 2
her	Miserables.txt 2636
heralded	Miserables.txt 1
heraldic	Miserables.txt 2
heralds	Miserables.txt 2
herb	Miserables.txt 2
herbalists	Miserables.txt 1
herbariums	Miserables.txt 4
herbaut	Miserables.txt 1
herbs	Miserables.txt 2
hercle	Miserables.txt 3
herculean	Miserables.txt 2
hercules	Miserables.txt 8
herd	Miserables.txt 7
here	Miserables.txt 602
hereabouts	Miserables.txt 1
hereafter	Miserables.txt 4
hereditary	Miserables.txt 2
heredity	Miserables.txt 2
heresy	Miserables.txt 1
heretics	Miserables.txt 3
heretofore	Miserables.txt 5
herewith	Miserables.txt 1
heritier	Miserables.txt 1
hermetically	Miserables.txt 2
hermit	Miserables.txt 3
hermits	Miserables.txt 1
hermogenus	Miserables.txt 1
hernani	Miserables.txt 2
hero	Miserables.txt 20
herod	Miserables.txt 1
heroes	Miserables.txt 20
heroic	Miserables.txt 26
heroically	Miserables.txt 2
heroism	Miserables.txt 15
hers	Miserables.txt 15
herself	Miserables.txt 213
herzog	Miserables.txt 1
hesdin	Miserables.txt 7
hesitate	Miserables.txt 17
hesitated	Miserables.txt 17
hesitating	Miserables.txt 10
hesitation	Miserables.txt 25
hesitations	Miserables.txt 4
hesse	Miserables.txt 1
hessian	Miserables.txt 1
heureux	Miserables.txt 1
hew	Miserables.txt 1
hewed	Miserables.txt 2
hewn	Miserables.txt 3
hews	Miserables.txt 1
hey	Miserables.txt 15
hi	Miserables.txt 1
hiatus	Miserables.txt 2
hic	Miserables.txt 1
hiccough	Miserables.txt 2
hiccoughs	Miserables.txt 2
hiccup	Miserables.txt 1
hid	Miserables.txt 17
hidden	Miserables.txt 31
hide	Miserables.txt 24
hideous	Miserables.txt 100
hideously	Miserables.txt 5
hideousness	Miserables.txt 3
hider	Miserables.txt 1
hides	Miserables.txt 9
hiding	Miserables.txt 20
hier	Miserables.txt 1
hierarchy	Miserables.txt 3
hieratic	Miserables.txt 1
hieratical	Miserables.txt 1
hieroglyphics	Miserables.txt 1
high	Miserables.txt 84
higher	Miserables.txt 11
highest	Miserables.txt 16
highland	Miserables.txt 1
highlanders	Miserables.txt 3
highly	Miserables.txt 8
highness	Miserables.txt 3
highway	Miserables.txt 22
highways	Miserables.txt 5
hilaire	Miserables.txt 1
hilariter	Miserables.txt 1
hill	Miserables.txt 22
hiller	Miserables.txt 1
hillock	Miserables.txt 5
hills	Miserables.txt 11
hilly	Miserables.txt 1
hilt	Miserables.txt 1
him	Miserables.txt 2942
himself	Miserables.txt 1087
hind	Miserables.txt 3
hinder	Miserables.txt 6
hindered	Miserables.txt 2
hindrance	Miserables.txt 1
hindrances	Miserables.txt 2
hinge	Miserables.txt 6
hinges	Miserables.txt 17
hint	Miserables.txt 2
hinted	Miserables.txt 6
hints	Miserables.txt 1
hip	Miserables.txt 2
hippanthropes	Miserables.txt 1
hippo	Miserables.txt 1
hippocrates	Miserables.txt 1
hippodromes	Miserables.txt 1
hippopotamus	Miserables.txt 1
hips	Miserables.txt 7
hire	Miserables.txt 3
hired	Miserables.txt 16
his	Miserables.txt 6470
hiss	Miserables.txt 1
hissed	Miserables.txt 2
histoire	Miserables.txt 1
historian	Miserables.txt 15
historians	Miserables.txt 7
historic	Miserables.txt 6
historical	Miserables.txt 9
historically	Miserables.txt 3
histories	Miserables.txt 2
historiques	Miserables.txt 1
history	Miserables.txt 123
hit	Miserables.txt 8
hitch	Miserables.txt 3
hitched	Miserables.txt 2
hither	Miserables.txt 15
hitherto	Miserables.txt 9
hive	Miserables.txt 6
hived	Miserables.txt 1
hiver	Miserables.txt 1
hives	Miserables.txt 2
ho	Miserables.txt 2
hoar	Miserables.txt 1
hoard	Miserables.txt 3
hoards	Miserables.txt 1
hoarse	Miserables.txt 17
hoarsely	Miserables.txt 2
hoary	Miserables.txt 1
hobbes	Miserables.txt 1
hobbled	Miserables.txt 1
hobbles	Miserables.txt 1
hoc	Miserables.txt 1
hoche	Miserables.txt 3
hod	Miserables.txt 2
hodman	Miserables.txt 1
hoe	Miserables.txt 3
hoeing	Miserables.txt 2
hoffmann	Miserables.txt 1
hog	Miserables.txt 2
hogsheads	Miserables.txt 1
hogu	Miserables.txt 1
hohee	Miserables.txt 1
hohenzollerns	Miserables.txt 1
hoist	Miserables.txt 1
hoisted	Miserables.txt 4
hoisting	Miserables.txt 1
hoists	Miserables.txt 1
hola	Miserables.txt 1
hold	Miserables.txt 103
holder	Miserables.txt 5
holding	Miserables.txt 56
holds	Miserables.txt 13
hole	Miserables.txt 105
holes	Miserables.txt 48
holiday	Miserables.txt 1
holiness	Miserables.txt 4
holland	Miserables.txt 2
hollando	Miserables.txt 1
hollow	Miserables.txt 36
hollowed	Miserables.txt 5
hollowing	Miserables.txt 1
hollows	Miserables.txt 6
holly	Miserables.txt 2
holofernes	Miserables.txt 1
holster	Miserables.txt 3
holsters	Miserables.txt 2
holy	Miserables.txt 68
homage	Miserables.txt 1
hombre	Miserables.txt 1
home	Miserables.txt 78
homeless	Miserables.txt 2
homelier	Miserables.txt 1
homeliness	Miserables.txt 2
homely	Miserables.txt 16
homer	Miserables.txt 10
homere	Miserables.txt 1
homes	Miserables.txt 1
homesickness	Miserables.txt 1
homicide	Miserables.txt 1
homme	Miserables.txt 40
homo	Miserables.txt 3
homuncio	Miserables.txt 2
honest	Miserables.txt 73
honestly	Miserables.txt 6
honesty	Miserables.txt 10
honey	Miserables.txt 2
honeysuckles	Miserables.txt 2
hongrais	Miserables.txt 1
honor	Miserables.txt 72
honorabel	Miserables.txt 1
honorable	Miserables.txt 11
honore	Miserables.txt 7
honored	Miserables.txt 6
honorine	Miserables.txt 1
honors	Miserables.txt 5
hood	Miserables.txt 4
hooded	Miserables.txt 1
hoofs	Miserables.txt 3
hook	Miserables.txt 7
hooks	Miserables.txt 3
hooping	Miserables.txt 1
hoops	Miserables.txt 2
hoot	Miserables.txt 1
hooting	Miserables.txt 1
hop	Miserables.txt 1
hope	Miserables.txt 73
hoped	Miserables.txt 12
hopeful	Miserables.txt 1
hopeless	Miserables.txt 1
hopes	Miserables.txt 9
hoping	Miserables.txt 11
hopital	Miserables.txt 12
hopping	Miserables.txt 1
hopscotch	Miserables.txt 1
horace	Miserables.txt 7
horas	Miserables.txt 1
horizon	Miserables.txt 58
horizons	Miserables.txt 4
horizontal	Miserables.txt 10
horn	Miserables.txt 4
horned	Miserables.txt 2
horns	Miserables.txt 7
horologe	Miserables.txt 1
horrible	Miserables.txt 78
horribly	Miserables.txt 5
horrid	Miserables.txt 1
horrified	Miserables.txt 5
horror	Miserables.txt 59
horrors	Miserables.txt 6
horse	Miserables.txt 102
horseback	Miserables.txt 13
horseguard	Miserables.txt 1
horseless	Miserables.txt 1
horseman	Miserables.txt 3
horsemen	Miserables.txt 1
horses	Miserables.txt 69
horstius	Miserables.txt 2
horticultural	Miserables.txt 1
hortus	Miserables.txt 1
hos	Miserables.txt 1
hosanna	Miserables.txt 1
hose	Miserables.txt 1
hosier	Miserables.txt 1
hospitable	Miserables.txt 2
hospital	Miserables.txt 27
hospitality	Miserables.txt 5
hospitallers	Miserables.txt 1
hospitals	Miserables.txt 3
host	Miserables.txt 21
hostelry	Miserables.txt 11
hostess	Miserables.txt 3
hostile	Miserables.txt 14
hostility	Miserables.txt 3
hosts	Miserables.txt 1
hot	Miserables.txt 24
hotel	Miserables.txt 20
hotels	Miserables.txt 3
hotman	Miserables.txt 1
hottentot	Miserables.txt 1
hottest	Miserables.txt 1
hou	Miserables.txt 1
houchard	Miserables.txt 1
houdancourt	Miserables.txt 1
hougomont	Miserables.txt 31
hound	Miserables.txt 2
hounds	Miserables.txt 2
hour	Miserables.txt 284
houris	Miserables.txt 2
hours	Miserables.txt 142
house	Miserables.txt 449
housebreaking	Miserables.txt 1
household	Miserables.txt 20
householder	Miserables.txt 1
households	Miserables.txt 2
housekeeper	Miserables.txt 5
housekeeping	Miserables.txt 5
houses	Miserables.txt 99
hovel	Miserables.txt 52
hovels	Miserables.txt 4
hover	Miserables.txt 1
hovered	Miserables.txt 3
hovering	Miserables.txt 1
hovers	Miserables.txt 1
how	Miserables.txt 472
however	Miserables.txt 178
howl	Miserables.txt 3
howled	Miserables.txt 1
howling	Miserables.txt 6
howls	Miserables.txt 3
http	Miserables.txt 8
hu	Miserables.txt 1
hub	Miserables.txt 5
hubbub	Miserables.txt 8
hubs	Miserables.txt 1
hucheloup	Miserables.txt 37
huddle	Miserables.txt 1
huddled	Miserables.txt 4
hudson	Miserables.txt 2
hue	Miserables.txt 14
hued	Miserables.txt 2
hug	Miserables.txt 2
huge	Miserables.txt 35
hugged	Miserables.txt 2
hugo	Miserables.txt 8
hugomons	Miserables.txt 1
huguenot	Miserables.txt 4
huguenots	Miserables.txt 1
huit	Miserables.txt 1
hull	Miserables.txt 1
hullo	Miserables.txt 11
hulpe	Miserables.txt 2
hum	Miserables.txt 3
human	Miserables.txt 210
humane	Miserables.txt 6
humanity	Miserables.txt 43
humann	Miserables.txt 1
humans	Miserables.txt 1
humble	Miserables.txt 28
humbled	Miserables.txt 1
humbles	Miserables.txt 1
humblot	Miserables.txt 1
humbly	Miserables.txt 3
humid	Miserables.txt 2
humiliated	Miserables.txt 7
humiliates	Miserables.txt 2
humiliating	Miserables.txt 2
humiliation	Miserables.txt 4
humiliations	Miserables.txt 1
humilies	Miserables.txt 1
humility	Miserables.txt 6
hummed	Miserables.txt 7
humming	Miserables.txt 11
humor	Miserables.txt 15
humored	Miserables.txt 1
hunchback	Miserables.txt 1
hunchbacked	Miserables.txt 1
hundred	Miserables.txt 306
hundreds	Miserables.txt 1
hundredths	Miserables.txt 1
hung	Miserables.txt 56
hungary	Miserables.txt 2
hunger	Miserables.txt 26
hungry	Miserables.txt 31
hunt	Miserables.txt 15
hunted	Miserables.txt 15
hunter	Miserables.txt 1
hunters	Miserables.txt 1
hunting	Miserables.txt 9
hunts	Miserables.txt 1
huntsman	Miserables.txt 4
huntsmen	Miserables.txt 4
hurdles	Miserables.txt 2
hurdy	Miserables.txt 2
hurepoix	Miserables.txt 1
hurl	Miserables.txt 9
hurled	Miserables.txt 29
hurleur	Miserables.txt 1
hurling	Miserables.txt 3
hurls	Miserables.txt 4
hurrah	Miserables.txt 1
hurricane	Miserables.txt 13
hurried	Miserables.txt 2
hurriedly	Miserables.txt 1
hurries	Miserables.txt 1
hurry	Miserables.txt 11
hurrying	Miserables.txt 2
hurt	Miserables.txt 17
hurtful	Miserables.txt 1
hurting	Miserables.txt 1
husband	Miserables.txt 87
husbands	Miserables.txt 6
huseful	Miserables.txt 1
hush	Miserables.txt 7
huss	Miserables.txt 1
hussar	Miserables.txt 4
hussars	Miserables.txt 4
hussies	Miserables.txt 1
hussy	Miserables.txt 6
hut	Miserables.txt 19
hutch	Miserables.txt 4
huts	Miserables.txt 1
huzzar	Miserables.txt 1
hyacinthe	Miserables.txt 2
hybrid	Miserables.txt 1
hydra	Miserables.txt 8
hydras	Miserables.txt 3
hydraulic	Miserables.txt 3
hydrogen	Miserables.txt 1
hyena	Miserables.txt 1
hygiene	Miserables.txt 5
hygienic	Miserables.txt 1
hymn	Miserables.txt 4
hyperboles	Miserables.txt 1
hypertext	Miserables.txt 1
hyphen	Miserables.txt 1
hypochondria	Miserables.txt 2
hypocrisies	Miserables.txt 1
hypocrisy	Miserables.txt 5
hypocritical	Miserables.txt 2
hypothesis	Miserables.txt 2
