l	Miserables.txt 155
la	Miserables.txt 291
labarre	Miserables.txt 10
labatut	Miserables.txt 1
label	Miserables.txt 1
labor	Miserables.txt 39
laboratories	Miserables.txt 1
laboratory	Miserables.txt 3
labored	Miserables.txt 4
laborer	Miserables.txt 10
laborers	Miserables.txt 6
laboring	Miserables.txt 3
laborious	Miserables.txt 5
laboriously	Miserables.txt 3
labors	Miserables.txt 5
labouisse	Miserables.txt 1
laburnum	Miserables.txt 1
labyrinth	Miserables.txt 14
labyrinthine	Miserables.txt 2
labyrinths	Miserables.txt 2
lac	Miserables.txt 1
lace	Miserables.txt 15
laced	Miserables.txt 1
lacedaemonian	Miserables.txt 1
lacenaire	Miserables.txt 6
lacer	Miserables.txt 1
lacerated	Miserables.txt 5
lacerates	Miserables.txt 1
laceration	Miserables.txt 1
laces	Miserables.txt 3
lacets	Miserables.txt 1
lachaise	Miserables.txt 6
lacing	Miserables.txt 1
lack	Miserables.txt 29
lacked	Miserables.txt 13
lackey	Miserables.txt 5
lackeys	Miserables.txt 5
lacking	Miserables.txt 35
lacks	Miserables.txt 5
laconic	Miserables.txt 4
laconically	Miserables.txt 1
laconicism	Miserables.txt 1
lacoste	Miserables.txt 5
lacquer	Miserables.txt 3
lad	Miserables.txt 26
ladder	Miserables.txt 27
ladders	Miserables.txt 10
laden	Miserables.txt 8
ladies	Miserables.txt 36
ladle	Miserables.txt 4
lads	Miserables.txt 1
lady	Miserables.txt 47
ladyfinger	Miserables.txt 1
laennec	Miserables.txt 1
laensberg	Miserables.txt 1
laertius	Miserables.txt 4
lafayette	Miserables.txt 20
lafayettes	Miserables.txt 1
laffitte	Miserables.txt 16
lafitte	Miserables.txt 1
lafon	Miserables.txt 1
laggard	Miserables.txt 1
lagging	Miserables.txt 1
lagny	Miserables.txt 9
lagrange	Miserables.txt 1
lahautiere	Miserables.txt 1
laid	Miserables.txt 113
laigle	Miserables.txt 43
lain	Miserables.txt 1
laine	Miserables.txt 1
lair	Miserables.txt 19
lairs	Miserables.txt 1
laiter	Miserables.txt 1
lake	Miserables.txt 9
lakes	Miserables.txt 1
lallemand	Miserables.txt 1
lama	Miserables.txt 1
lamarque	Miserables.txt 14
lamartine	Miserables.txt 1
lamb	Miserables.txt 7
lamballe	Miserables.txt 1
lambert	Miserables.txt 4
lambs	Miserables.txt 2
lame	Miserables.txt 7
lamennais	Miserables.txt 3
lamentable	Miserables.txt 19
lamentations	Miserables.txt 2
lamenting	Miserables.txt 1
lamoignon	Miserables.txt 4
lamothe	Miserables.txt 4
lamotte	Miserables.txt 1
lamp	Miserables.txt 28
lampas	Miserables.txt 1
lampblack	Miserables.txt 2
lamps	Miserables.txt 4
lancait	Miserables.txt 1
lance	Miserables.txt 3
lancer	Miserables.txt 20
lancers	Miserables.txt 7
lances	Miserables.txt 3
lancet	Miserables.txt 1
lancret	Miserables.txt 1
land	Miserables.txt 37
landau	Miserables.txt 1
landed	Miserables.txt 5
landing	Miserables.txt 9
landlady	Miserables.txt 3
landlord	Miserables.txt 16
lands	Miserables.txt 5
landscape	Miserables.txt 5
landslip	Miserables.txt 1
lane	Miserables.txt 37
lanes	Miserables.txt 4
langevin	Miserables.txt 1
langleviel	Miserables.txt 1
langres	Miserables.txt 1
language	Miserables.txt 50
languages	Miserables.txt 4
languedoc	Miserables.txt 1
languid	Miserables.txt 2
languidly	Miserables.txt 1
languished	Miserables.txt 2
languishing	Miserables.txt 2
languor	Miserables.txt 2
lannes	Miserables.txt 1
lanoire	Miserables.txt 1
lansquine	Miserables.txt 1
lantern	Miserables.txt 46
lanterne	Miserables.txt 1
lanterns	Miserables.txt 25
laon	Miserables.txt 1
lap	Miserables.txt 1
lapides	Miserables.txt 3
laplace	Miserables.txt 1
lappe	Miserables.txt 1
lapped	Miserables.txt 1
lapping	Miserables.txt 1
laps	Miserables.txt 1
lapse	Miserables.txt 11
lapsed	Miserables.txt 1
larbin	Miserables.txt 1
larboard	Miserables.txt 1
larded	Miserables.txt 1
large	Miserables.txt 212
largely	Miserables.txt 1
larger	Miserables.txt 14
largest	Miserables.txt 5
larifla	Miserables.txt 1
lark	Miserables.txt 38
larmes	Miserables.txt 1
laroche	Miserables.txt 1
larose	Miserables.txt 1
lartif	Miserables.txt 1
larton	Miserables.txt 3
larva	Miserables.txt 1
larvae	Miserables.txt 1
larynx	Miserables.txt 1
lash	Miserables.txt 1
lashed	Miserables.txt 2
lashes	Miserables.txt 9
lashings	Miserables.txt 1
lass	Miserables.txt 4
lasses	Miserables.txt 3
lassitude	Miserables.txt 7
last	Miserables.txt 340
lasted	Miserables.txt 26
lasting	Miserables.txt 2
lastly	Miserables.txt 8
lasts	Miserables.txt 3
latch	Miserables.txt 16
late	Miserables.txt 33
lately	Miserables.txt 4
latent	Miserables.txt 10
later	Miserables.txt 173
lateral	Miserables.txt 2
latest	Miserables.txt 3
lath	Miserables.txt 1
lathes	Miserables.txt 2
latil	Miserables.txt 1
latin	Miserables.txt 27
latinist	Miserables.txt 1
latitudes	Miserables.txt 1
latour	Miserables.txt 1
latter	Miserables.txt 71
lattice	Miserables.txt 5
lattices	Miserables.txt 2
laubespine	Miserables.txt 1
laudiniere	Miserables.txt 1
laugh	Miserables.txt 83
laughable	Miserables.txt 2
laughed	Miserables.txt 35
laughing	Miserables.txt 51
laughingly	Miserables.txt 2
laughs	Miserables.txt 13
laughter	Miserables.txt 47
launch	Miserables.txt 1
launched	Miserables.txt 8
launching	Miserables.txt 1
laundress	Miserables.txt 3
laundresses	Miserables.txt 4
laundry	Miserables.txt 1
laurel	Miserables.txt 3
laurels	Miserables.txt 2
laurium	Miserables.txt 1
lauzet	Miserables.txt 1
lava	Miserables.txt 1
lavater	Miserables.txt 1
lavatory	Miserables.txt 1
lavbesp	Miserables.txt 1
laved	Miserables.txt 1
laveuve	Miserables.txt 1
lavish	Miserables.txt 4
lavished	Miserables.txt 4
lavishes	Miserables.txt 2
lavishing	Miserables.txt 3
lavishly	Miserables.txt 1
law	Miserables.txt 137
lawgiver	Miserables.txt 1
lawn	Miserables.txt 3
laws	Miserables.txt 28
lawsuit	Miserables.txt 1
lawsuits	Miserables.txt 3
lawyer	Miserables.txt 42
lawyers	Miserables.txt 9
lay	Miserables.txt 129
layer	Miserables.txt 11
layers	Miserables.txt 6
laying	Miserables.txt 7
lays	Miserables.txt 5
lazare	Miserables.txt 3
lazaretto	Miserables.txt 1
lazariste	Miserables.txt 1
lazarists	Miserables.txt 2
laziness	Miserables.txt 2
lazy	Miserables.txt 6
lazybones	Miserables.txt 1
lazzarone	Miserables.txt 2
le	Miserables.txt 238
lead	Miserables.txt 42
leaden	Miserables.txt 7
leader	Miserables.txt 15
leaders	Miserables.txt 15
leading	Miserables.txt 27
leads	Miserables.txt 17
leadsman	Miserables.txt 1
leaf	Miserables.txt 8
leafless	Miserables.txt 3
leaflets	Miserables.txt 1
league	Miserables.txt 13
leagues	Miserables.txt 43
leak	Miserables.txt 2
leakage	Miserables.txt 2
lean	Miserables.txt 10
leander	Miserables.txt 1
leaned	Miserables.txt 28
leaning	Miserables.txt 22
leanness	Miserables.txt 1
leans	Miserables.txt 2
leap	Miserables.txt 3
leaped	Miserables.txt 9
leaping	Miserables.txt 3
leaps	Miserables.txt 6
learn	Miserables.txt 16
learned	Miserables.txt 39
learning	Miserables.txt 7
learns	Miserables.txt 1
lease	Miserables.txt 2
leased	Miserables.txt 2
leases	Miserables.txt 2
least	Miserables.txt 109
leather	Miserables.txt 18
leave	Miserables.txt 86
leaved	Miserables.txt 2
leaven	Miserables.txt 1
leaves	Miserables.txt 48
leaving	Miserables.txt 44
lebel	Miserables.txt 1
lebeuf	Miserables.txt 1
leblanc	Miserables.txt 112
lebras	Miserables.txt 1
lebrun	Miserables.txt 2
lecouffe	Miserables.txt 1
lecture	Miserables.txt 1
lecturers	Miserables.txt 1
lectures	Miserables.txt 3
led	Miserables.txt 45
leech	Miserables.txt 1
leeches	Miserables.txt 1
lefebvre	Miserables.txt 2
left	Miserables.txt 356
leg	Miserables.txt 37
legacy	Miserables.txt 3
legal	Miserables.txt 16
legally	Miserables.txt 3
legend	Miserables.txt 5
legendary	Miserables.txt 2
legends	Miserables.txt 5
legere	Miserables.txt 1
legged	Miserables.txt 1
legible	Miserables.txt 2
legibly	Miserables.txt 1
legion	Miserables.txt 17
legionaries	Miserables.txt 1
legions	Miserables.txt 11
legislation	Miserables.txt 1
legislative	Miserables.txt 2
legislator	Miserables.txt 1
legist	Miserables.txt 2
legists	Miserables.txt 1
legitimacy	Miserables.txt 5
legitimate	Miserables.txt 14
legitimist	Miserables.txt 3
legitimists	Miserables.txt 1
legle	Miserables.txt 2
legless	Miserables.txt 1
legros	Miserables.txt 1
legs	Miserables.txt 38
leibnitz	Miserables.txt 1
leipzig	Miserables.txt 2
leisure	Miserables.txt 9
lemaitre	Miserables.txt 1
lemarchant	Miserables.txt 1
lemarin	Miserables.txt 1
lemblin	Miserables.txt 2
lemonade	Miserables.txt 1
lend	Miserables.txt 15
lending	Miserables.txt 6
lends	Miserables.txt 4
length	Miserables.txt 45
lengthened	Miserables.txt 1
lengthening	Miserables.txt 1
lengths	Miserables.txt 1
lengthwise	Miserables.txt 1
lengthy	Miserables.txt 2
lenoir	Miserables.txt 4
lenormand	Miserables.txt 1
lenotre	Miserables.txt 1
lent	Miserables.txt 18
lenten	Miserables.txt 1
leo	Miserables.txt 3
leon	Miserables.txt 4
leonidas	Miserables.txt 5
leonine	Miserables.txt 2
leprosy	Miserables.txt 4
leprous	Miserables.txt 2
lerida	Miserables.txt 1
lerins	Miserables.txt 1
les	Miserables.txt 60
lescaut	Miserables.txt 1
lesdiguieres	Miserables.txt 1
lesgle	Miserables.txt 5
lesgueules	Miserables.txt 2
lesions	Miserables.txt 1
less	Miserables.txt 167
lessen	Miserables.txt 1
lessened	Miserables.txt 1
lessens	Miserables.txt 4
lesser	Miserables.txt 4
lesson	Miserables.txt 11
lessons	Miserables.txt 9
lest	Miserables.txt 10
let	Miserables.txt 458
letellier	Miserables.txt 2
lethargic	Miserables.txt 1
lethargies	Miserables.txt 1
lethargy	Miserables.txt 3
lethe	Miserables.txt 1
letourneur	Miserables.txt 1
lets	Miserables.txt 7
letter	Miserables.txt 140
lettered	Miserables.txt 2
letters	Miserables.txt 71
letting	Miserables.txt 8
lettuce	Miserables.txt 1
leu	Miserables.txt 2
leur	Miserables.txt 3
levant	Miserables.txt 1
levantin	Miserables.txt 1
levantine	Miserables.txt 3
levee	Miserables.txt 2
level	Miserables.txt 44
levelled	Miserables.txt 7
leveller	Miserables.txt 1
levellers	Miserables.txt 1
levelling	Miserables.txt 2
levels	Miserables.txt 2
leven	Miserables.txt 1
lever	Miserables.txt 8
levi	Miserables.txt 1
leviathan	Miserables.txt 2
levied	Miserables.txt 3
levies	Miserables.txt 2
levis	Miserables.txt 1
leviticus	Miserables.txt 1
levities	Miserables.txt 1
levity	Miserables.txt 1
levre	Miserables.txt 1
lex	Miserables.txt 1
leyden	Miserables.txt 1
liability	Miserables.txt 3
liable	Miserables.txt 6
liaison	Miserables.txt 1
liar	Miserables.txt 3
liard	Miserables.txt 7
liars	Miserables.txt 1
liberal	Miserables.txt 8
liberalism	Miserables.txt 6
liberals	Miserables.txt 6
liberate	Miserables.txt 1
liberated	Miserables.txt 6
liberating	Miserables.txt 1
liberation	Miserables.txt 4
liberator	Miserables.txt 4
liberators	Miserables.txt 1
liberavit	Miserables.txt 2
liberian	Miserables.txt 1
liberties	Miserables.txt 2
libertine	Miserables.txt 1
libertise	Miserables.txt 1
libertize	Miserables.txt 1
liberty	Miserables.txt 98
library	Miserables.txt 17
libras	Miserables.txt 2
librations	Miserables.txt 1
libretto	Miserables.txt 1
lice	Miserables.txt 5
license	Miserables.txt 18
licensed	Miserables.txt 3
licentia	Miserables.txt 1
licentiate	Miserables.txt 1
licentiates	Miserables.txt 1
licet	Miserables.txt 1
lichens	Miserables.txt 1
lick	Miserables.txt 2
licked	Miserables.txt 1
lid	Miserables.txt 5
lids	Miserables.txt 5
lie	Miserables.txt 48
liebig	Miserables.txt 1
lied	Miserables.txt 14
liege	Miserables.txt 2
lies	Miserables.txt 57
lieu	Miserables.txt 7
lieutenant	Miserables.txt 28
lieutenants	Miserables.txt 4
life	Miserables.txt 424
lifeless	Miserables.txt 2
lifetime	Miserables.txt 4
lift	Miserables.txt 14
lifted	Miserables.txt 27
lifting	Miserables.txt 4
lifts	Miserables.txt 2
ligature	Miserables.txt 1
ligatures	Miserables.txt 1
light	Miserables.txt 436
lighted	Miserables.txt 107
lighten	Miserables.txt 1
lightened	Miserables.txt 2
lightening	Miserables.txt 1
lightens	Miserables.txt 1
lighter	Miserables.txt 5
lighterman	Miserables.txt 1
lightest	Miserables.txt 2
lighting	Miserables.txt 4
lightly	Miserables.txt 10
lightning	Miserables.txt 62
lightnings	Miserables.txt 6
lights	Miserables.txt 20
ligniville	Miserables.txt 1
ligny	Miserables.txt 1
like	Miserables.txt 985
liked	Miserables.txt 32
likely	Miserables.txt 2
likeness	Miserables.txt 5
likes	Miserables.txt 2
likewise	Miserables.txt 4
lilac	Miserables.txt 1
lilacs	Miserables.txt 7
lilies	Miserables.txt 4
lille	Miserables.txt 2
lillois	Miserables.txt 1
lilting	Miserables.txt 1
lily	Miserables.txt 7
limam	Miserables.txt 1
limb	Miserables.txt 14
limbo	Miserables.txt 2
limbos	Miserables.txt 2
limbs	Miserables.txt 20
lime	Miserables.txt 8
limit	Miserables.txt 16
limitation	Miserables.txt 4
limited	Miserables.txt 8
limitless	Miserables.txt 1
limits	Miserables.txt 9
limoges	Miserables.txt 3
limosin	Miserables.txt 1
limousin	Miserables.txt 1
limp	Miserables.txt 5
limped	Miserables.txt 4
limpers	Miserables.txt 1
limpid	Miserables.txt 5
limps	Miserables.txt 1
linden	Miserables.txt 5
line	Miserables.txt 87
lineaments	Miserables.txt 1
lined	Miserables.txt 7
linen	Miserables.txt 61
lines	Miserables.txt 68
linger	Miserables.txt 3
lingered	Miserables.txt 9
lingerie	Miserables.txt 1
lingering	Miserables.txt 2
lingers	Miserables.txt 4
lingre	Miserables.txt 1
linguist	Miserables.txt 1
lining	Miserables.txt 3
link	Miserables.txt 2
linked	Miserables.txt 2
links	Miserables.txt 5
linnaeus	Miserables.txt 1
linnet	Miserables.txt 1
linnets	Miserables.txt 3
linseed	Miserables.txt 1
lint	Miserables.txt 14
lintstocks	Miserables.txt 1
lion	Miserables.txt 27
lions	Miserables.txt 6
lip	Miserables.txt 10
lips	Miserables.txt 57
liquid	Miserables.txt 8
liquidation	Miserables.txt 1
liquids	Miserables.txt 1
liquor	Miserables.txt 2
lirlonfa	Miserables.txt 1
lisa	Miserables.txt 1
lise	Miserables.txt 2
lisette	Miserables.txt 1
lisp	Miserables.txt 1
lisping	Miserables.txt 1
lisps	Miserables.txt 1
list	Miserables.txt 13
listen	Miserables.txt 64
listened	Miserables.txt 69
listeners	Miserables.txt 1
listening	Miserables.txt 32
listens	Miserables.txt 3
listing	Miserables.txt 1
listlessness	Miserables.txt 1
listolier	Miserables.txt 12
literally	Miserables.txt 8
literary	Miserables.txt 22
literature	Miserables.txt 9
litres	Miserables.txt 2
litter	Miserables.txt 5
littered	Miserables.txt 1
litters	Miserables.txt 2
little	Miserables.txt 983
live	Miserables.txt 136
lived	Miserables.txt 102
livelihood	Miserables.txt 2
lively	Miserables.txt 15
liver	Miserables.txt 4
liveries	Miserables.txt 3
livery	Miserables.txt 2
lives	Miserables.txt 47
livid	Miserables.txt 34
lividly	Miserables.txt 2
lividness	Miserables.txt 2
living	Miserables.txt 108
livres	Miserables.txt 16
livry	Miserables.txt 5
lizard	Miserables.txt 2
lizards	Miserables.txt 2
ll	Miserables.txt 87
llama	Miserables.txt 1
lo	Miserables.txt 2
load	Miserables.txt 18
loaded	Miserables.txt 24
loading	Miserables.txt 2
loads	Miserables.txt 5
loadstone	Miserables.txt 1
loaf	Miserables.txt 18
loam	Miserables.txt 1
loan	Miserables.txt 2
lobau	Miserables.txt 11
lobby	Miserables.txt 1
lobe	Miserables.txt 1
local	Miserables.txt 14
localities	Miserables.txt 3
locality	Miserables.txt 8
located	Miserables.txt 7
locations	Miserables.txt 2
locher	Miserables.txt 1
lock	Miserables.txt 27
locked	Miserables.txt 14
locking	Miserables.txt 2
locks	Miserables.txt 21
locksmith	Miserables.txt 4
loco	Miserables.txt 2
locomotive	Miserables.txt 2
locomotives	Miserables.txt 2
locution	Miserables.txt 1
locutions	Miserables.txt 1
lodge	Miserables.txt 20
lodged	Miserables.txt 12
lodgement	Miserables.txt 1
lodger	Miserables.txt 6
lodgers	Miserables.txt 3
lodges	Miserables.txt 3
lodging	Miserables.txt 19
lodgings	Miserables.txt 17
lodi	Miserables.txt 3
lodoiska	Miserables.txt 1
lods	Miserables.txt 1
loft	Miserables.txt 2
loftier	Miserables.txt 1
loftiest	Miserables.txt 2
loftiness	Miserables.txt 1
lofty	Miserables.txt 63
log	Miserables.txt 2
loggerheads	Miserables.txt 2
logic	Miserables.txt 16
logical	Miserables.txt 8
logs	Miserables.txt 1
loins	Miserables.txt 11
loire	Miserables.txt 8
loiterers	Miserables.txt 1
loizerolles	Miserables.txt 1
lola	Miserables.txt 2
lolotte	Miserables.txt 2
lombard	Miserables.txt 2
lombards	Miserables.txt 1
lombier	Miserables.txt 2
lon	Miserables.txt 14
london	Miserables.txt 11
londrin	Miserables.txt 1
lone	Miserables.txt 3
lonely	Miserables.txt 2
long	Miserables.txt 416
longchamps	Miserables.txt 3
longed	Miserables.txt 3
longer	Miserables.txt 432
longest	Miserables.txt 4
longevity	Miserables.txt 2
longshoreman	Miserables.txt 1
longshoremen	Miserables.txt 2
longueville	Miserables.txt 1
longwood	Miserables.txt 1
lonjumeau	Miserables.txt 1
look	Miserables.txt 164
looked	Miserables.txt 132
looking	Miserables.txt 49
lookout	Miserables.txt 1
looks	Miserables.txt 12
loomed	Miserables.txt 1
loop	Miserables.txt 4
loophole	Miserables.txt 1
loopholes	Miserables.txt 7
loose	Miserables.txt 15
loosed	Miserables.txt 3
loosely	Miserables.txt 1
loosened	Miserables.txt 3
looses	Miserables.txt 1
loosing	Miserables.txt 2
lopez	Miserables.txt 1
loquacious	Miserables.txt 2
loquacity	Miserables.txt 2
loques	Miserables.txt 1
lord	Miserables.txt 24
lordly	Miserables.txt 1
lords	Miserables.txt 3
lordship	Miserables.txt 1
lorette	Miserables.txt 1
lormian	Miserables.txt 1
lorn	Miserables.txt 1
lorraine	Miserables.txt 1
lorsqu	Miserables.txt 1
lorsque	Miserables.txt 2
lose	Miserables.txt 44
loses	Miserables.txt 4
losing	Miserables.txt 17
loss	Miserables.txt 16
losses	Miserables.txt 2
lost	Miserables.txt 159
losthin	Miserables.txt 1
losvel	Miserables.txt 1
lot	Miserables.txt 9
lothian	Miserables.txt 1
lotions	Miserables.txt 2
lots	Miserables.txt 4
lottery	Miserables.txt 7
loud	Miserables.txt 27
louder	Miserables.txt 2
loudest	Miserables.txt 1
loudly	Miserables.txt 8
louis	Miserables.txt 176
louise	Miserables.txt 1
louison	Miserables.txt 2
lounge	Miserables.txt 3
lounged	Miserables.txt 1
lounger	Miserables.txt 3
loungers	Miserables.txt 4
lounges	Miserables.txt 2
lounging	Miserables.txt 3
loup	Miserables.txt 3
loups	Miserables.txt 3
lourdes	Miserables.txt 1
louse	Miserables.txt 5
lout	Miserables.txt 2
louvel	Miserables.txt 1
louviers	Miserables.txt 2
louvois	Miserables.txt 2
louvre	Miserables.txt 12
love	Miserables.txt 369
loved	Miserables.txt 89
loveliest	Miserables.txt 1
loveliness	Miserables.txt 1
lovely	Miserables.txt 12
lover	Miserables.txt 21
lovers	Miserables.txt 26
loves	Miserables.txt 33
lovest	Miserables.txt 1
loving	Miserables.txt 16
lovingly	Miserables.txt 2
low	Miserables.txt 160
lowe	Miserables.txt 2
lower	Miserables.txt 71
lowered	Miserables.txt 25
lowering	Miserables.txt 10
lowers	Miserables.txt 1
lowest	Miserables.txt 12
lowliness	Miserables.txt 1
lowly	Miserables.txt 7
loyal	Miserables.txt 1
loyally	Miserables.txt 1
loyalty	Miserables.txt 6
loyson	Miserables.txt 2
lt	Miserables.txt 2
lu	Miserables.txt 1
lub	Miserables.txt 1
luc	Miserables.txt 5
luceat	Miserables.txt 1
lucenet	Miserables.txt 1
lucid	Miserables.txt 2
lucidity	Miserables.txt 3
lucifer	Miserables.txt 1
luck	Miserables.txt 16
luckily	Miserables.txt 2
lucky	Miserables.txt 16
lucrative	Miserables.txt 3
lucre	Miserables.txt 2
lucretius	Miserables.txt 1
ludwig	Miserables.txt 1
lugubrious	Miserables.txt 32
lugubriously	Miserables.txt 1
lui	Miserables.txt 4
luise	Miserables.txt 1
luiserne	Miserables.txt 1
lukewarm	Miserables.txt 2
lull	Miserables.txt 3
lullaby	Miserables.txt 1
lulled	Miserables.txt 3
lulls	Miserables.txt 1
lumiere	Miserables.txt 1
luminary	Miserables.txt 1
luminous	Miserables.txt 24
luminously	Miserables.txt 1
lump	Miserables.txt 4
lumps	Miserables.txt 1
lune	Miserables.txt 3
lunenburg	Miserables.txt 3
luneville	Miserables.txt 1
lungs	Miserables.txt 10
luniere	Miserables.txt 1
lurched	Miserables.txt 1
lured	Miserables.txt 1
lurette	Miserables.txt 1
lurked	Miserables.txt 4
lurks	Miserables.txt 2
lustily	Miserables.txt 1
lustre	Miserables.txt 1
lustrous	Miserables.txt 4
lusts	Miserables.txt 2
lutetia	Miserables.txt 1
luther	Miserables.txt 2
lutzen	Miserables.txt 2
lux	Miserables.txt 5
luxembourg	Miserables.txt 56
luxuries	Miserables.txt 2
luxurious	Miserables.txt 1
luxuriously	Miserables.txt 1
luxury	Miserables.txt 14
luzerne	Miserables.txt 2
lyceum	Miserables.txt 1
lyceums	Miserables.txt 1
lycia	Miserables.txt 1
lying	Miserables.txt 37
lymph	Miserables.txt 1
lymphatic	Miserables.txt 3
lynch	Miserables.txt 4
lynx	Miserables.txt 1
lyons	Miserables.txt 6
lyre	Miserables.txt 1
lyric	Miserables.txt 1
lyrical	Miserables.txt 3
lyrically	Miserables.txt 1
lys	Miserables.txt 13
