z	Miserables.txt 1
zaatcha	Miserables.txt 1
zag	Miserables.txt 4
zeal	Miserables.txt 12
zealous	Miserables.txt 3
zeila	Miserables.txt 2
zelma	Miserables.txt 4
zenith	Miserables.txt 8
zephine	Miserables.txt 16
zephyr	Miserables.txt 1
zero	Miserables.txt 4
zetulbe	Miserables.txt 2
zi	Miserables.txt 3
zieten	Miserables.txt 2
zig	Miserables.txt 4
zigzags	Miserables.txt 3
zinc	Miserables.txt 7
zip	Miserables.txt 1
zodiac	Miserables.txt 2
zoilus	Miserables.txt 2
zone	Miserables.txt 3
zouave	Miserables.txt 1
zs	Miserables.txt 1
zuyderzee	Miserables.txt 1
