i	NotreDame_De_Paris.txt 1376
ice	NotreDame_De_Paris.txt 10
iconoclasts	NotreDame_De_Paris.txt 1
icy	NotreDame_De_Paris.txt 3
id	NotreDame_De_Paris.txt 1
idea	NotreDame_De_Paris.txt 69
ideal	NotreDame_De_Paris.txt 4
ideas	NotreDame_De_Paris.txt 23
idem	NotreDame_De_Paris.txt 1
identification	NotreDame_De_Paris.txt 1
identified	NotreDame_De_Paris.txt 1
identify	NotreDame_De_Paris.txt 2
ideo	NotreDame_De_Paris.txt 1
idiot	NotreDame_De_Paris.txt 2
idiotic	NotreDame_De_Paris.txt 4
idle	NotreDame_De_Paris.txt 2
idleness	NotreDame_De_Paris.txt 1
idolater	NotreDame_De_Paris.txt 1
idolaters	NotreDame_De_Paris.txt 1
idolized	NotreDame_De_Paris.txt 1
idols	NotreDame_De_Paris.txt 1
if	NotreDame_De_Paris.txt 248
ignited	NotreDame_De_Paris.txt 1
ignoble	NotreDame_De_Paris.txt 1
ignominious	NotreDame_De_Paris.txt 1
ignominy	NotreDame_De_Paris.txt 1
ignoramus	NotreDame_De_Paris.txt 1
ignorance	NotreDame_De_Paris.txt 4
ignorant	NotreDame_De_Paris.txt 7
ii	NotreDame_De_Paris.txt 28
iii	NotreDame_De_Paris.txt 21
il	NotreDame_De_Paris.txt 4
ile	NotreDame_De_Paris.txt 4
iliad	NotreDame_De_Paris.txt 3
iliads	NotreDame_De_Paris.txt 3
ill	NotreDame_De_Paris.txt 22
illa	NotreDame_De_Paris.txt 1
illitteratus	NotreDame_De_Paris.txt 1
illness	NotreDame_De_Paris.txt 1
illuminated	NotreDame_De_Paris.txt 16
illumination	NotreDame_De_Paris.txt 1
illuminations	NotreDame_De_Paris.txt 1
illusion	NotreDame_De_Paris.txt 4
illusions	NotreDame_De_Paris.txt 5
illustrations	NotreDame_De_Paris.txt 1
illustrious	NotreDame_De_Paris.txt 8
im	NotreDame_De_Paris.txt 1
image	NotreDame_De_Paris.txt 11
images	NotreDame_De_Paris.txt 6
imaginary	NotreDame_De_Paris.txt 2
imagination	NotreDame_De_Paris.txt 11
imaginations	NotreDame_De_Paris.txt 2
imagine	NotreDame_De_Paris.txt 13
imagined	NotreDame_De_Paris.txt 7
imagining	NotreDame_De_Paris.txt 2
imaginings	NotreDame_De_Paris.txt 1
imbecile	NotreDame_De_Paris.txt 4
imbecility	NotreDame_De_Paris.txt 1
imbedded	NotreDame_De_Paris.txt 2
imbued	NotreDame_De_Paris.txt 1
imitating	NotreDame_De_Paris.txt 1
imitation	NotreDame_De_Paris.txt 1
immanior	NotreDame_De_Paris.txt 2
immanis	NotreDame_De_Paris.txt 2
immeasurable	NotreDame_De_Paris.txt 1
immediate	NotreDame_De_Paris.txt 4
immediately	NotreDame_De_Paris.txt 17
immemorial	NotreDame_De_Paris.txt 4
immense	NotreDame_De_Paris.txt 41
immensity	NotreDame_De_Paris.txt 1
immobility	NotreDame_De_Paris.txt 10
immortality	NotreDame_De_Paris.txt 3
immortalized	NotreDame_De_Paris.txt 1
immovable	NotreDame_De_Paris.txt 3
immovably	NotreDame_De_Paris.txt 1
immure	NotreDame_De_Paris.txt 1
immured	NotreDame_De_Paris.txt 3
immutability	NotreDame_De_Paris.txt 1
imp	NotreDame_De_Paris.txt 2
impalpable	NotreDame_De_Paris.txt 1
imparted	NotreDame_De_Paris.txt 9
impartial	NotreDame_De_Paris.txt 3
impartiality	NotreDame_De_Paris.txt 2
imparting	NotreDame_De_Paris.txt 1
impassable	NotreDame_De_Paris.txt 1
impassible	NotreDame_De_Paris.txt 1
impassioned	NotreDame_De_Paris.txt 2
impassive	NotreDame_De_Paris.txt 2
impassiveness	NotreDame_De_Paris.txt 1
impatience	NotreDame_De_Paris.txt 9
impatient	NotreDame_De_Paris.txt 3
impatiently	NotreDame_De_Paris.txt 1
impelled	NotreDame_De_Paris.txt 2
impenetrable	NotreDame_De_Paris.txt 2
imperceptible	NotreDame_De_Paris.txt 5
imperceptibly	NotreDame_De_Paris.txt 1
imperfect	NotreDame_De_Paris.txt 2
imperfectly	NotreDame_De_Paris.txt 1
imperial	NotreDame_De_Paris.txt 2
imperious	NotreDame_De_Paris.txt 3
imperiously	NotreDame_De_Paris.txt 2
imperishable	NotreDame_De_Paris.txt 1
impertinence	NotreDame_De_Paris.txt 1
impertinent	NotreDame_De_Paris.txt 2
imperturbability	NotreDame_De_Paris.txt 1
imperturbable	NotreDame_De_Paris.txt 4
imperturbably	NotreDame_De_Paris.txt 2
impetuosity	NotreDame_De_Paris.txt 1
impetuous	NotreDame_De_Paris.txt 2
impetuously	NotreDame_De_Paris.txt 1
impieties	NotreDame_De_Paris.txt 1
impiety	NotreDame_De_Paris.txt 3
impious	NotreDame_De_Paris.txt 1
implacable	NotreDame_De_Paris.txt 2
implements	NotreDame_De_Paris.txt 2
implicated	NotreDame_De_Paris.txt 1
implicitly	NotreDame_De_Paris.txt 2
implied	NotreDame_De_Paris.txt 3
implore	NotreDame_De_Paris.txt 1
importance	NotreDame_De_Paris.txt 5
important	NotreDame_De_Paris.txt 6
imports	NotreDame_De_Paris.txt 1
impose	NotreDame_De_Paris.txt 2
imposed	NotreDame_De_Paris.txt 6
imposing	NotreDame_De_Paris.txt 3
impossible	NotreDame_De_Paris.txt 19
impost	NotreDame_De_Paris.txt 1
impotent	NotreDame_De_Paris.txt 1
imprecation	NotreDame_De_Paris.txt 2
imprecations	NotreDame_De_Paris.txt 5
impress	NotreDame_De_Paris.txt 2
impressed	NotreDame_De_Paris.txt 1
impression	NotreDame_De_Paris.txt 9
impressions	NotreDame_De_Paris.txt 2
impressive	NotreDame_De_Paris.txt 1
imprint	NotreDame_De_Paris.txt 2
imprinted	NotreDame_De_Paris.txt 4
imprisoned	NotreDame_De_Paris.txt 3
imprisons	NotreDame_De_Paris.txt 1
improve	NotreDame_De_Paris.txt 1
improvised	NotreDame_De_Paris.txt 1
imprudent	NotreDame_De_Paris.txt 3
imps	NotreDame_De_Paris.txt 1
impudence	NotreDame_De_Paris.txt 1
impudent	NotreDame_De_Paris.txt 3
impugn	NotreDame_De_Paris.txt 1
impulse	NotreDame_De_Paris.txt 4
impunity	NotreDame_De_Paris.txt 2
impure	NotreDame_De_Paris.txt 4
impurity	NotreDame_De_Paris.txt 2
in	NotreDame_De_Paris.txt 3467
inaccessible	NotreDame_De_Paris.txt 1
inaccurate	NotreDame_De_Paris.txt 1
inalterable	NotreDame_De_Paris.txt 1
inanimate	NotreDame_De_Paris.txt 2
inarticulate	NotreDame_De_Paris.txt 1
incalculable	NotreDame_De_Paris.txt 1
incendiaries	NotreDame_De_Paris.txt 1
incessa	NotreDame_De_Paris.txt 1
incessant	NotreDame_De_Paris.txt 1
incessantly	NotreDame_De_Paris.txt 28
inches	NotreDame_De_Paris.txt 3
incident	NotreDame_De_Paris.txt 6
incidental	NotreDame_De_Paris.txt 1
incidents	NotreDame_De_Paris.txt 1
incisions	NotreDame_De_Paris.txt 1
inclination	NotreDame_De_Paris.txt 2
inclinations	NotreDame_De_Paris.txt 1
inclined	NotreDame_De_Paris.txt 5
inclining	NotreDame_De_Paris.txt 1
include	NotreDame_De_Paris.txt 1
included	NotreDame_De_Paris.txt 4
includes	NotreDame_De_Paris.txt 1
including	NotreDame_De_Paris.txt 9
inclusive	NotreDame_De_Paris.txt 1
incoherent	NotreDame_De_Paris.txt 4
income	NotreDame_De_Paris.txt 1
incommensurable	NotreDame_De_Paris.txt 1
incommoded	NotreDame_De_Paris.txt 1
incomparably	NotreDame_De_Paris.txt 1
incompatible	NotreDame_De_Paris.txt 1
incomplete	NotreDame_De_Paris.txt 7
incomprehensible	NotreDame_De_Paris.txt 2
inconceivable	NotreDame_De_Paris.txt 1
incongruous	NotreDame_De_Paris.txt 1
inconsiderately	NotreDame_De_Paris.txt 1
incontinently	NotreDame_De_Paris.txt 1
inconveniences	NotreDame_De_Paris.txt 3
inconvenient	NotreDame_De_Paris.txt 2
incorporated	NotreDame_De_Paris.txt 1
increase	NotreDame_De_Paris.txt 5
increased	NotreDame_De_Paris.txt 8
increases	NotreDame_De_Paris.txt 2
increasing	NotreDame_De_Paris.txt 9
incredible	NotreDame_De_Paris.txt 4
incredulous	NotreDame_De_Paris.txt 1
incrustations	NotreDame_De_Paris.txt 1
incrusted	NotreDame_De_Paris.txt 2
incrusts	NotreDame_De_Paris.txt 1
incumbent	NotreDame_De_Paris.txt 1
incurable	NotreDame_De_Paris.txt 1
incutit	NotreDame_De_Paris.txt 1
inde	NotreDame_De_Paris.txt 1
indebted	NotreDame_De_Paris.txt 1
indecision	NotreDame_De_Paris.txt 3
indeed	NotreDame_De_Paris.txt 21
indefatigable	NotreDame_De_Paris.txt 3
indefinable	NotreDame_De_Paris.txt 2
indefinite	NotreDame_De_Paris.txt 3
indelible	NotreDame_De_Paris.txt 1
indemnify	NotreDame_De_Paris.txt 1
indemnitatem	NotreDame_De_Paris.txt 1
indemnity	NotreDame_De_Paris.txt 2
indentation	NotreDame_De_Paris.txt 1
indentations	NotreDame_De_Paris.txt 1
independence	NotreDame_De_Paris.txt 2
independent	NotreDame_De_Paris.txt 1
independently	NotreDame_De_Paris.txt 4
indescribable	NotreDame_De_Paris.txt 5
indescribably	NotreDame_De_Paris.txt 1
indestructible	NotreDame_De_Paris.txt 1
indeterminate	NotreDame_De_Paris.txt 1
india	NotreDame_De_Paris.txt 3
indian	NotreDame_De_Paris.txt 1
indicate	NotreDame_De_Paris.txt 4
indicated	NotreDame_De_Paris.txt 5
indicating	NotreDame_De_Paris.txt 2
indicative	NotreDame_De_Paris.txt 1
indifferent	NotreDame_De_Paris.txt 6
indifferently	NotreDame_De_Paris.txt 3
indigenous	NotreDame_De_Paris.txt 1
indignant	NotreDame_De_Paris.txt 2
indignantly	NotreDame_De_Paris.txt 1
indignation	NotreDame_De_Paris.txt 6
indignus	NotreDame_De_Paris.txt 1
indigo	NotreDame_De_Paris.txt 1
indirect	NotreDame_De_Paris.txt 1
indirectly	NotreDame_De_Paris.txt 1
indispensable	NotreDame_De_Paris.txt 1
indistinct	NotreDame_De_Paris.txt 4
individual	NotreDame_De_Paris.txt 13
individuals	NotreDame_De_Paris.txt 2
indolence	NotreDame_De_Paris.txt 1
indolently	NotreDame_De_Paris.txt 1
indubitably	NotreDame_De_Paris.txt 2
induce	NotreDame_De_Paris.txt 1
induced	NotreDame_De_Paris.txt 1
indueret	NotreDame_De_Paris.txt 1
indulged	NotreDame_De_Paris.txt 2
indulgence	NotreDame_De_Paris.txt 1
industrious	NotreDame_De_Paris.txt 1
industry	NotreDame_De_Paris.txt 2
ineffable	NotreDame_De_Paris.txt 6
inert	NotreDame_De_Paris.txt 2
inevitable	NotreDame_De_Paris.txt 2
inexhaustible	NotreDame_De_Paris.txt 1
inexorable	NotreDame_De_Paris.txt 2
inexperienced	NotreDame_De_Paris.txt 2
inexplicable	NotreDame_De_Paris.txt 4
inexpressible	NotreDame_De_Paris.txt 2
inextinguishable	NotreDame_De_Paris.txt 2
inextricable	NotreDame_De_Paris.txt 2
infamous	NotreDame_De_Paris.txt 4
infamy	NotreDame_De_Paris.txt 2
infancy	NotreDame_De_Paris.txt 7
infant	NotreDame_De_Paris.txt 7
infatuated	NotreDame_De_Paris.txt 1
infatuation	NotreDame_De_Paris.txt 1
inferi	NotreDame_De_Paris.txt 1
inferior	NotreDame_De_Paris.txt 1
infernal	NotreDame_De_Paris.txt 3
infinite	NotreDame_De_Paris.txt 8
infinity	NotreDame_De_Paris.txt 1
infirm	NotreDame_De_Paris.txt 1
infirmity	NotreDame_De_Paris.txt 2
infixus	NotreDame_De_Paris.txt 1
inflamed	NotreDame_De_Paris.txt 4
inflated	NotreDame_De_Paris.txt 2
inflexible	NotreDame_De_Paris.txt 1
inflict	NotreDame_De_Paris.txt 3
inflicting	NotreDame_De_Paris.txt 1
influence	NotreDame_De_Paris.txt 3
inform	NotreDame_De_Paris.txt 3
information	NotreDame_De_Paris.txt 8
informed	NotreDame_De_Paris.txt 2
infrequent	NotreDame_De_Paris.txt 2
infrequently	NotreDame_De_Paris.txt 1
infringe	NotreDame_De_Paris.txt 1
infringement	NotreDame_De_Paris.txt 1
infused	NotreDame_De_Paris.txt 1
ingenious	NotreDame_De_Paris.txt 3
ingenuous	NotreDame_De_Paris.txt 1
ingenuously	NotreDame_De_Paris.txt 1
ingots	NotreDame_De_Paris.txt 1
ingrate	NotreDame_De_Paris.txt 1
ingredient	NotreDame_De_Paris.txt 1
inhabitant	NotreDame_De_Paris.txt 1
inhabitants	NotreDame_De_Paris.txt 5
inhabited	NotreDame_De_Paris.txt 5
inherent	NotreDame_De_Paris.txt 1
inherited	NotreDame_De_Paris.txt 4
inhumanly	NotreDame_De_Paris.txt 1
inimical	NotreDame_De_Paris.txt 1
initiate	NotreDame_De_Paris.txt 1
initiated	NotreDame_De_Paris.txt 2
injected	NotreDame_De_Paris.txt 1
injunction	NotreDame_De_Paris.txt 1
injure	NotreDame_De_Paris.txt 2
injury	NotreDame_De_Paris.txt 1
injustice	NotreDame_De_Paris.txt 2
ink	NotreDame_De_Paris.txt 8
inkhorn	NotreDame_De_Paris.txt 2
innate	NotreDame_De_Paris.txt 1
inner	NotreDame_De_Paris.txt 2
innkeeper	NotreDame_De_Paris.txt 1
innocent	NotreDame_De_Paris.txt 19
innocently	NotreDame_De_Paris.txt 3
innocents	NotreDame_De_Paris.txt 5
innumerable	NotreDame_De_Paris.txt 13
inoffensive	NotreDame_De_Paris.txt 1
inopportunely	NotreDame_De_Paris.txt 2
inpace	NotreDame_De_Paris.txt 2
inquests	NotreDame_De_Paris.txt 1
inquire	NotreDame_De_Paris.txt 1
inquired	NotreDame_De_Paris.txt 13
inquiring	NotreDame_De_Paris.txt 1
inquiry	NotreDame_De_Paris.txt 1
inquisitive	NotreDame_De_Paris.txt 1
inquisitor	NotreDame_De_Paris.txt 2
inquisitorial	NotreDame_De_Paris.txt 1
inquisitors	NotreDame_De_Paris.txt 1
insatiable	NotreDame_De_Paris.txt 1
inscribed	NotreDame_De_Paris.txt 7
inscribing	NotreDame_De_Paris.txt 1
inscription	NotreDame_De_Paris.txt 7
inscriptions	NotreDame_De_Paris.txt 3
insect	NotreDame_De_Paris.txt 1
insects	NotreDame_De_Paris.txt 3
insensible	NotreDame_De_Paris.txt 1
insensibly	NotreDame_De_Paris.txt 1
inside	NotreDame_De_Paris.txt 5
insignia	NotreDame_De_Paris.txt 2
insignificant	NotreDame_De_Paris.txt 1
insipid	NotreDame_De_Paris.txt 2
insist	NotreDame_De_Paris.txt 4
insisted	NotreDame_De_Paris.txt 1
insists	NotreDame_De_Paris.txt 1
insolence	NotreDame_De_Paris.txt 2
inspected	NotreDame_De_Paris.txt 1
inspection	NotreDame_De_Paris.txt 2
inspiration	NotreDame_De_Paris.txt 2
inspire	NotreDame_De_Paris.txt 5
inspired	NotreDame_De_Paris.txt 7
inspires	NotreDame_De_Paris.txt 1
installed	NotreDame_De_Paris.txt 1
instance	NotreDame_De_Paris.txt 1
instant	NotreDame_De_Paris.txt 25
instantia	NotreDame_De_Paris.txt 1
instantly	NotreDame_De_Paris.txt 6
instead	NotreDame_De_Paris.txt 6
instinct	NotreDame_De_Paris.txt 4
instinctive	NotreDame_De_Paris.txt 2
instinctively	NotreDame_De_Paris.txt 1
instincts	NotreDame_De_Paris.txt 1
instituted	NotreDame_De_Paris.txt 3
instituting	NotreDame_De_Paris.txt 1
institution	NotreDame_De_Paris.txt 1
instruct	NotreDame_De_Paris.txt 2
instructing	NotreDame_De_Paris.txt 1
instructions	NotreDame_De_Paris.txt 1
instructors	NotreDame_De_Paris.txt 1
instrument	NotreDame_De_Paris.txt 1
instruments	NotreDame_De_Paris.txt 7
insula	NotreDame_De_Paris.txt 2
insult	NotreDame_De_Paris.txt 4
insulting	NotreDame_De_Paris.txt 1
insults	NotreDame_De_Paris.txt 3
insupportable	NotreDame_De_Paris.txt 1
intact	NotreDame_De_Paris.txt 1
integral	NotreDame_De_Paris.txt 1
integrity	NotreDame_De_Paris.txt 1
intellect	NotreDame_De_Paris.txt 3
intellectual	NotreDame_De_Paris.txt 7
intelligence	NotreDame_De_Paris.txt 19
intelligences	NotreDame_De_Paris.txt 1
intelligent	NotreDame_De_Paris.txt 9
intemerata	NotreDame_De_Paris.txt 1
intended	NotreDame_De_Paris.txt 3
intensity	NotreDame_De_Paris.txt 3
intent	NotreDame_De_Paris.txt 1
intention	NotreDame_De_Paris.txt 4
intentionally	NotreDame_De_Paris.txt 1
intentione	NotreDame_De_Paris.txt 1
intentions	NotreDame_De_Paris.txt 1
intently	NotreDame_De_Paris.txt 11
inter	NotreDame_De_Paris.txt 2
intercepted	NotreDame_De_Paris.txt 2
interdicting	NotreDame_De_Paris.txt 1
interdicts	NotreDame_De_Paris.txt 1
interest	NotreDame_De_Paris.txt 11
interested	NotreDame_De_Paris.txt 4
interesting	NotreDame_De_Paris.txt 3
interests	NotreDame_De_Paris.txt 1
interfered	NotreDame_De_Paris.txt 4
interfering	NotreDame_De_Paris.txt 1
interior	NotreDame_De_Paris.txt 26
interjection	NotreDame_De_Paris.txt 1
interjoists	NotreDame_De_Paris.txt 1
interlaced	NotreDame_De_Paris.txt 2
interlined	NotreDame_De_Paris.txt 1
interlocked	NotreDame_De_Paris.txt 1
interlocutor	NotreDame_De_Paris.txt 2
interlocutors	NotreDame_De_Paris.txt 1
interlude	NotreDame_De_Paris.txt 1
intermediary	NotreDame_De_Paris.txt 1
intermediate	NotreDame_De_Paris.txt 3
interminable	NotreDame_De_Paris.txt 4
intermingled	NotreDame_De_Paris.txt 2
intermission	NotreDame_De_Paris.txt 1
intermittent	NotreDame_De_Paris.txt 3
intermixed	NotreDame_De_Paris.txt 1
internal	NotreDame_De_Paris.txt 10
international	NotreDame_De_Paris.txt 1
interpolated	NotreDame_De_Paris.txt 2
interposed	NotreDame_De_Paris.txt 10
interpreted	NotreDame_De_Paris.txt 1
interred	NotreDame_De_Paris.txt 2
interrogate	NotreDame_De_Paris.txt 1
interrogating	NotreDame_De_Paris.txt 2
interrogation	NotreDame_De_Paris.txt 1
interrogations	NotreDame_De_Paris.txt 1
interrogatory	NotreDame_De_Paris.txt 1
interrupt	NotreDame_De_Paris.txt 1
interrupta	NotreDame_De_Paris.txt 1
interrupted	NotreDame_De_Paris.txt 29
interrupters	NotreDame_De_Paris.txt 1
interrupting	NotreDame_De_Paris.txt 1
interruption	NotreDame_De_Paris.txt 2
interruptions	NotreDame_De_Paris.txt 1
interrypta	NotreDame_De_Paris.txt 1
intersect	NotreDame_De_Paris.txt 3
intersected	NotreDame_De_Paris.txt 3
intersecting	NotreDame_De_Paris.txt 1
intersection	NotreDame_De_Paris.txt 5
intersections	NotreDame_De_Paris.txt 1
intersit	NotreDame_De_Paris.txt 1
interspacing	NotreDame_De_Paris.txt 1
interspersing	NotreDame_De_Paris.txt 1
intertwining	NotreDame_De_Paris.txt 1
interval	NotreDame_De_Paris.txt 2
intervals	NotreDame_De_Paris.txt 19
intervene	NotreDame_De_Paris.txt 2
intervened	NotreDame_De_Paris.txt 3
intervention	NotreDame_De_Paris.txt 1
interview	NotreDame_De_Paris.txt 1
intestinal	NotreDame_De_Paris.txt 1
intimate	NotreDame_De_Paris.txt 3
into	NotreDame_De_Paris.txt 278
intolerable	NotreDame_De_Paris.txt 1
intonation	NotreDame_De_Paris.txt 4
intone	NotreDame_De_Paris.txt 1
intoned	NotreDame_De_Paris.txt 2
intoning	NotreDame_De_Paris.txt 2
intoxicated	NotreDame_De_Paris.txt 7
intoxicating	NotreDame_De_Paris.txt 1
intoxication	NotreDame_De_Paris.txt 2
intraverunt	NotreDame_De_Paris.txt 1
intrepid	NotreDame_De_Paris.txt 2
intrepidly	NotreDame_De_Paris.txt 2
intrigues	NotreDame_De_Paris.txt 1
intriguing	NotreDame_De_Paris.txt 1
introduced	NotreDame_De_Paris.txt 1
introduction	NotreDame_De_Paris.txt 1
inundated	NotreDame_De_Paris.txt 5
inundates	NotreDame_De_Paris.txt 1
inundation	NotreDame_De_Paris.txt 1
invaded	NotreDame_De_Paris.txt 3
invalid	NotreDame_De_Paris.txt 3
invalides	NotreDame_De_Paris.txt 2
invalidity	NotreDame_De_Paris.txt 1
invalids	NotreDame_De_Paris.txt 1
invariably	NotreDame_De_Paris.txt 1
invented	NotreDame_De_Paris.txt 2
invention	NotreDame_De_Paris.txt 2
inventions	NotreDame_De_Paris.txt 1
inverted	NotreDame_De_Paris.txt 1
invested	NotreDame_De_Paris.txt 1
investment	NotreDame_De_Paris.txt 2
inviolable	NotreDame_De_Paris.txt 1
invisibility	NotreDame_De_Paris.txt 1
invisible	NotreDame_De_Paris.txt 8
invitation	NotreDame_De_Paris.txt 1
invited	NotreDame_De_Paris.txt 1
invoked	NotreDame_De_Paris.txt 2
involuntarily	NotreDame_De_Paris.txt 1
involuntary	NotreDame_De_Paris.txt 3
involved	NotreDame_De_Paris.txt 1
involves	NotreDame_De_Paris.txt 1
inward	NotreDame_De_Paris.txt 3
inwards	NotreDame_De_Paris.txt 1
ipsam	NotreDame_De_Paris.txt 1
ipse	NotreDame_De_Paris.txt 3
ipso	NotreDame_De_Paris.txt 2
ipsum	NotreDame_De_Paris.txt 1
ireland	NotreDame_De_Paris.txt 1
irish	NotreDame_De_Paris.txt 1
irksome	NotreDame_De_Paris.txt 1
iron	NotreDame_De_Paris.txt 71
ironical	NotreDame_De_Paris.txt 6
ironmongery	NotreDame_De_Paris.txt 1
irons	NotreDame_De_Paris.txt 5
ironwork	NotreDame_De_Paris.txt 1
irony	NotreDame_De_Paris.txt 1
irregular	NotreDame_De_Paris.txt 4
irregularibus	NotreDame_De_Paris.txt 1
irregularis	NotreDame_De_Paris.txt 1
irresistible	NotreDame_De_Paris.txt 6
irresistibly	NotreDame_De_Paris.txt 1
irretrievably	NotreDame_De_Paris.txt 1
irreverent	NotreDame_De_Paris.txt 1
irritated	NotreDame_De_Paris.txt 9
irritation	NotreDame_De_Paris.txt 2
irs	NotreDame_De_Paris.txt 1
is	NotreDame_De_Paris.txt 1459
isabeau	NotreDame_De_Paris.txt 5
isabel	NotreDame_De_Paris.txt 2
island	NotreDame_De_Paris.txt 19
islands	NotreDame_De_Paris.txt 5
isle	NotreDame_De_Paris.txt 3
islet	NotreDame_De_Paris.txt 3
isliers	NotreDame_De_Paris.txt 1
isn	NotreDame_De_Paris.txt 4
isolated	NotreDame_De_Paris.txt 11
isolation	NotreDame_De_Paris.txt 3
israel	NotreDame_De_Paris.txt 1
issue	NotreDame_De_Paris.txt 7
issued	NotreDame_De_Paris.txt 3
issues	NotreDame_De_Paris.txt 2
issuing	NotreDame_De_Paris.txt 1
issy	NotreDame_De_Paris.txt 3
ista	NotreDame_De_Paris.txt 1
it	NotreDame_De_Paris.txt 1916
italian	NotreDame_De_Paris.txt 4
italians	NotreDame_De_Paris.txt 1
italy	NotreDame_De_Paris.txt 1
itinerant	NotreDame_De_Paris.txt 1
its	NotreDame_De_Paris.txt 478
itself	NotreDame_De_Paris.txt 80
iusula	NotreDame_De_Paris.txt 1
iv	NotreDame_De_Paris.txt 24
ivory	NotreDame_De_Paris.txt 1
ivry	NotreDame_De_Paris.txt 1
ivy	NotreDame_De_Paris.txt 1
ix	NotreDame_De_Paris.txt 2
