b	NotreDame_De_Paris.txt 20
babblings	NotreDame_De_Paris.txt 1
babe	NotreDame_De_Paris.txt 2
babel	NotreDame_De_Paris.txt 4
babes	NotreDame_De_Paris.txt 1
baby	NotreDame_De_Paris.txt 1
babylon	NotreDame_De_Paris.txt 2
bacchanal	NotreDame_De_Paris.txt 2
bacchanalian	NotreDame_De_Paris.txt 1
bacchanals	NotreDame_De_Paris.txt 1
bacchante	NotreDame_De_Paris.txt 1
bacchic	NotreDame_De_Paris.txt 2
bachelor	NotreDame_De_Paris.txt 1
back	NotreDame_De_Paris.txt 124
backed	NotreDame_De_Paris.txt 4
background	NotreDame_De_Paris.txt 7
backgrounds	NotreDame_De_Paris.txt 1
backs	NotreDame_De_Paris.txt 3
backward	NotreDame_De_Paris.txt 4
backwards	NotreDame_De_Paris.txt 7
bacon	NotreDame_De_Paris.txt 2
bacqueville	NotreDame_De_Paris.txt 1
bad	NotreDame_De_Paris.txt 26
badly	NotreDame_De_Paris.txt 17
baeust	NotreDame_De_Paris.txt 1
bag	NotreDame_De_Paris.txt 10
bagauda	NotreDame_De_Paris.txt 1
baggage	NotreDame_De_Paris.txt 1
bah	NotreDame_De_Paris.txt 10
bailiff	NotreDame_De_Paris.txt 41
bailiffs	NotreDame_De_Paris.txt 4
bailiwick	NotreDame_De_Paris.txt 3
bailiwicks	NotreDame_De_Paris.txt 2
baillet	NotreDame_De_Paris.txt 1
baked	NotreDame_De_Paris.txt 1
bakehouse	NotreDame_De_Paris.txt 1
bakehouses	NotreDame_De_Paris.txt 1
baker	NotreDame_De_Paris.txt 4
bakery	NotreDame_De_Paris.txt 1
balance	NotreDame_De_Paris.txt 4
balanced	NotreDame_De_Paris.txt 1
balancing	NotreDame_De_Paris.txt 1
balcony	NotreDame_De_Paris.txt 19
bald	NotreDame_De_Paris.txt 13
baldrick	NotreDame_De_Paris.txt 1
bali	NotreDame_De_Paris.txt 1
baliffre	NotreDame_De_Paris.txt 1
balked	NotreDame_De_Paris.txt 1
ball	NotreDame_De_Paris.txt 3
ballad	NotreDame_De_Paris.txt 1
ballast	NotreDame_De_Paris.txt 1
ballestas	NotreDame_De_Paris.txt 1
ballet	NotreDame_De_Paris.txt 1
balloon	NotreDame_De_Paris.txt 1
balls	NotreDame_De_Paris.txt 3
balue	NotreDame_De_Paris.txt 4
balustrade	NotreDame_De_Paris.txt 25
balustrades	NotreDame_De_Paris.txt 3
band	NotreDame_De_Paris.txt 14
bandages	NotreDame_De_Paris.txt 1
banded	NotreDame_De_Paris.txt 2
banderas	NotreDame_De_Paris.txt 1
banderilleras	NotreDame_De_Paris.txt 1
bandit	NotreDame_De_Paris.txt 2
bandits	NotreDame_De_Paris.txt 1
bands	NotreDame_De_Paris.txt 3
bandy	NotreDame_De_Paris.txt 3
banished	NotreDame_De_Paris.txt 1
bank	NotreDame_De_Paris.txt 21
banks	NotreDame_De_Paris.txt 5
banlieue	NotreDame_De_Paris.txt 1
banner	NotreDame_De_Paris.txt 5
banneret	NotreDame_De_Paris.txt 1
bannerets	NotreDame_De_Paris.txt 2
banners	NotreDame_De_Paris.txt 5
bantering	NotreDame_De_Paris.txt 2
baptism	NotreDame_De_Paris.txt 1
baptismal	NotreDame_De_Paris.txt 2
baptist	NotreDame_De_Paris.txt 2
baptiste	NotreDame_De_Paris.txt 2
baptized	NotreDame_De_Paris.txt 2
bar	NotreDame_De_Paris.txt 4
barbarian	NotreDame_De_Paris.txt 2
barbarians	NotreDame_De_Paris.txt 3
barbarisms	NotreDame_De_Paris.txt 1
barbarous	NotreDame_De_Paris.txt 3
barbeau	NotreDame_De_Paris.txt 3
barbedienne	NotreDame_De_Paris.txt 7
barber	NotreDame_De_Paris.txt 7
barbette	NotreDame_De_Paris.txt 1
bare	NotreDame_De_Paris.txt 29
bared	NotreDame_De_Paris.txt 2
barefoot	NotreDame_De_Paris.txt 1
bareheaded	NotreDame_De_Paris.txt 1
barely	NotreDame_De_Paris.txt 13
bareness	NotreDame_De_Paris.txt 1
barge	NotreDame_De_Paris.txt 1
barges	NotreDame_De_Paris.txt 1
barilleri	NotreDame_De_Paris.txt 1
barillerie	NotreDame_De_Paris.txt 2
bark	NotreDame_De_Paris.txt 4
barked	NotreDame_De_Paris.txt 2
barking	NotreDame_De_Paris.txt 1
barley	NotreDame_De_Paris.txt 2
barmne	NotreDame_De_Paris.txt 1
barns	NotreDame_De_Paris.txt 1
baron	NotreDame_De_Paris.txt 1
baronial	NotreDame_De_Paris.txt 1
barque	NotreDame_De_Paris.txt 1
barracks	NotreDame_De_Paris.txt 2
barred	NotreDame_De_Paris.txt 4
barrels	NotreDame_De_Paris.txt 1
barricaded	NotreDame_De_Paris.txt 2
barricading	NotreDame_De_Paris.txt 1
barrier	NotreDame_De_Paris.txt 2
barring	NotreDame_De_Paris.txt 1
bars	NotreDame_De_Paris.txt 21
barth	NotreDame_De_Paris.txt 1
bas	NotreDame_De_Paris.txt 6
base	NotreDame_De_Paris.txt 11
based	NotreDame_De_Paris.txt 2
basement	NotreDame_De_Paris.txt 1
bases	NotreDame_De_Paris.txt 2
basilica	NotreDame_De_Paris.txt 2
basin	NotreDame_De_Paris.txt 5
basis	NotreDame_De_Paris.txt 1
basket	NotreDame_De_Paris.txt 8
basque	NotreDame_De_Paris.txt 1
bass	NotreDame_De_Paris.txt 4
bassa	NotreDame_De_Paris.txt 1
bassam	NotreDame_De_Paris.txt 1
bassinets	NotreDame_De_Paris.txt 1
bastard	NotreDame_De_Paris.txt 6
bastille	NotreDame_De_Paris.txt 19
bat	NotreDame_De_Paris.txt 4
bateau	NotreDame_De_Paris.txt 1
bateli	NotreDame_De_Paris.txt 1
bath	NotreDame_De_Paris.txt 1
bathe	NotreDame_De_Paris.txt 1
bathed	NotreDame_De_Paris.txt 4
baths	NotreDame_De_Paris.txt 5
bats	NotreDame_De_Paris.txt 2
batter	NotreDame_De_Paris.txt 2
battered	NotreDame_De_Paris.txt 2
battering	NotreDame_De_Paris.txt 4
battle	NotreDame_De_Paris.txt 11
battlemented	NotreDame_De_Paris.txt 2
battlements	NotreDame_De_Paris.txt 6
bauble	NotreDame_De_Paris.txt 1
baudets	NotreDame_De_Paris.txt 3
baudoyer	NotreDame_De_Paris.txt 2
baudry	NotreDame_De_Paris.txt 1
bavaria	NotreDame_De_Paris.txt 1
bawler	NotreDame_De_Paris.txt 1
bay	NotreDame_De_Paris.txt 2
be	NotreDame_De_Paris.txt 604
beach	NotreDame_De_Paris.txt 1
beacon	NotreDame_De_Paris.txt 1
bead	NotreDame_De_Paris.txt 3
beadle	NotreDame_De_Paris.txt 5
beadles	NotreDame_De_Paris.txt 6
beads	NotreDame_De_Paris.txt 2
beak	NotreDame_De_Paris.txt 3
beaks	NotreDame_De_Paris.txt 3
beam	NotreDame_De_Paris.txt 25
beamed	NotreDame_De_Paris.txt 3
beaming	NotreDame_De_Paris.txt 5
beams	NotreDame_De_Paris.txt 12
bear	NotreDame_De_Paris.txt 11
beard	NotreDame_De_Paris.txt 7
bearded	NotreDame_De_Paris.txt 6
bearer	NotreDame_De_Paris.txt 2
bearers	NotreDame_De_Paris.txt 1
beareth	NotreDame_De_Paris.txt 1
bearing	NotreDame_De_Paris.txt 17
bearings	NotreDame_De_Paris.txt 12
bears	NotreDame_De_Paris.txt 6
beast	NotreDame_De_Paris.txt 19
beastly	NotreDame_De_Paris.txt 1
beasts	NotreDame_De_Paris.txt 7
beat	NotreDame_De_Paris.txt 15
beaten	NotreDame_De_Paris.txt 2
beati	NotreDame_De_Paris.txt 3
beating	NotreDame_De_Paris.txt 5
beatitude	NotreDame_De_Paris.txt 1
beats	NotreDame_De_Paris.txt 1
beau	NotreDame_De_Paris.txt 4
beaujeu	NotreDame_De_Paris.txt 5
beaulion	NotreDame_De_Paris.txt 1
beaumont	NotreDame_De_Paris.txt 2
beaune	NotreDame_De_Paris.txt 2
beaut	NotreDame_De_Paris.txt 5
beauties	NotreDame_De_Paris.txt 5
beautiful	NotreDame_De_Paris.txt 88
beauty	NotreDame_De_Paris.txt 49
beauvais	NotreDame_De_Paris.txt 1
beavers	NotreDame_De_Paris.txt 1
became	NotreDame_De_Paris.txt 60
because	NotreDame_De_Paris.txt 81
bechaigne	NotreDame_De_Paris.txt 1
beckoned	NotreDame_De_Paris.txt 1
become	NotreDame_De_Paris.txt 53
becomes	NotreDame_De_Paris.txt 18
becoming	NotreDame_De_Paris.txt 8
bed	NotreDame_De_Paris.txt 55
bedizened	NotreDame_De_Paris.txt 1
bedroom	NotreDame_De_Paris.txt 1
beds	NotreDame_De_Paris.txt 1
bedside	NotreDame_De_Paris.txt 2
bedstead	NotreDame_De_Paris.txt 1
bee	NotreDame_De_Paris.txt 2
beef	NotreDame_De_Paris.txt 1
beehive	NotreDame_De_Paris.txt 1
beelzebub	NotreDame_De_Paris.txt 5
been	NotreDame_De_Paris.txt 374
beer	NotreDame_De_Paris.txt 6
bees	NotreDame_De_Paris.txt 3
beetles	NotreDame_De_Paris.txt 2
befits	NotreDame_De_Paris.txt 2
before	NotreDame_De_Paris.txt 174
beforehand	NotreDame_De_Paris.txt 1
beg	NotreDame_De_Paris.txt 1
began	NotreDame_De_Paris.txt 120
beggar	NotreDame_De_Paris.txt 9
beggars	NotreDame_De_Paris.txt 13
beggary	NotreDame_De_Paris.txt 1
begged	NotreDame_De_Paris.txt 1
begin	NotreDame_De_Paris.txt 25
beginning	NotreDame_De_Paris.txt 36
begins	NotreDame_De_Paris.txt 5
begone	NotreDame_De_Paris.txt 11
begrudge	NotreDame_De_Paris.txt 1
beguiled	NotreDame_De_Paris.txt 1
begun	NotreDame_De_Paris.txt 16
behalf	NotreDame_De_Paris.txt 5
behaved	NotreDame_De_Paris.txt 1
behavior	NotreDame_De_Paris.txt 1
beheld	NotreDame_De_Paris.txt 110
behind	NotreDame_De_Paris.txt 58
behindhand	NotreDame_De_Paris.txt 1
behold	NotreDame_De_Paris.txt 41
beholding	NotreDame_De_Paris.txt 4
beholds	NotreDame_De_Paris.txt 5
being	NotreDame_De_Paris.txt 111
beings	NotreDame_De_Paris.txt 5
bejaune	NotreDame_De_Paris.txt 1
belabor	NotreDame_De_Paris.txt 1
belched	NotreDame_De_Paris.txt 1
belches	NotreDame_De_Paris.txt 1
belfries	NotreDame_De_Paris.txt 6
belfry	NotreDame_De_Paris.txt 8
belief	NotreDame_De_Paris.txt 1
believe	NotreDame_De_Paris.txt 41
believed	NotreDame_De_Paris.txt 22
believers	NotreDame_De_Paris.txt 1
believes	NotreDame_De_Paris.txt 3
believest	NotreDame_De_Paris.txt 1
believeth	NotreDame_De_Paris.txt 1
believing	NotreDame_De_Paris.txt 5
bell	NotreDame_De_Paris.txt 74
belle	NotreDame_De_Paris.txt 2
belleforet	NotreDame_De_Paris.txt 1
bellevigne	NotreDame_De_Paris.txt 5
bellied	NotreDame_De_Paris.txt 1
bellies	NotreDame_De_Paris.txt 2
bellowing	NotreDame_De_Paris.txt 1
bellows	NotreDame_De_Paris.txt 3
bellringer	NotreDame_De_Paris.txt 42
bells	NotreDame_De_Paris.txt 44
belly	NotreDame_De_Paris.txt 11
belong	NotreDame_De_Paris.txt 13
belonged	NotreDame_De_Paris.txt 13
belonging	NotreDame_De_Paris.txt 5
belongs	NotreDame_De_Paris.txt 9
beloved	NotreDame_De_Paris.txt 7
below	NotreDame_De_Paris.txt 31
belt	NotreDame_De_Paris.txt 4
belts	NotreDame_De_Paris.txt 1
belzebuth	NotreDame_De_Paris.txt 1
bench	NotreDame_De_Paris.txt 5
benches	NotreDame_De_Paris.txt 5
bend	NotreDame_De_Paris.txt 3
bending	NotreDame_De_Paris.txt 7
beneath	NotreDame_De_Paris.txt 118
benedict	NotreDame_De_Paris.txt 2
benediction	NotreDame_De_Paris.txt 2
benedictions	NotreDame_De_Paris.txt 1
beneficed	NotreDame_De_Paris.txt 1
benefit	NotreDame_De_Paris.txt 2
benign	NotreDame_De_Paris.txt 1
benignity	NotreDame_De_Paris.txt 1
benoit	NotreDame_De_Paris.txt 2
benserade	NotreDame_De_Paris.txt 1
bent	NotreDame_De_Paris.txt 35
benumbed	NotreDame_De_Paris.txt 2
bequeathed	NotreDame_De_Paris.txt 2
bergerettes	NotreDame_De_Paris.txt 1
bern	NotreDame_De_Paris.txt 2
bernardins	NotreDame_De_Paris.txt 6
berry	NotreDame_De_Paris.txt 1
bertin	NotreDame_De_Paris.txt 1
bertrand	NotreDame_De_Paris.txt 2
besan	NotreDame_De_Paris.txt 1
beseech	NotreDame_De_Paris.txt 2
beside	NotreDame_De_Paris.txt 51
besides	NotreDame_De_Paris.txt 11
besiege	NotreDame_De_Paris.txt 1
besieged	NotreDame_De_Paris.txt 4
besiegers	NotreDame_De_Paris.txt 2
besieging	NotreDame_De_Paris.txt 2
besought	NotreDame_De_Paris.txt 1
bespoke	NotreDame_De_Paris.txt 1
best	NotreDame_De_Paris.txt 22
bestial	NotreDame_De_Paris.txt 2
bestirred	NotreDame_De_Paris.txt 1
bestow	NotreDame_De_Paris.txt 3
bestowed	NotreDame_De_Paris.txt 6
bestowing	NotreDame_De_Paris.txt 4
betake	NotreDame_De_Paris.txt 1
betakes	NotreDame_De_Paris.txt 1
betoken	NotreDame_De_Paris.txt 1
betook	NotreDame_De_Paris.txt 3
betray	NotreDame_De_Paris.txt 2
betrayed	NotreDame_De_Paris.txt 4
betrothal	NotreDame_De_Paris.txt 1
betrothed	NotreDame_De_Paris.txt 9
better	NotreDame_De_Paris.txt 52
between	NotreDame_De_Paris.txt 156
betweens	NotreDame_De_Paris.txt 1
betwixt	NotreDame_De_Paris.txt 2
beuvrai	NotreDame_De_Paris.txt 1
bevelled	NotreDame_De_Paris.txt 1
beverage	NotreDame_De_Paris.txt 2
bewailing	NotreDame_De_Paris.txt 1
beware	NotreDame_De_Paris.txt 3
bewildered	NotreDame_De_Paris.txt 4
bewilderment	NotreDame_De_Paris.txt 1
bewitched	NotreDame_De_Paris.txt 2
beyne	NotreDame_De_Paris.txt 1
beyond	NotreDame_De_Paris.txt 22
bi	NotreDame_De_Paris.txt 1
bibamus	NotreDame_De_Paris.txt 1
bibklov	NotreDame_De_Paris.txt 1
bible	NotreDame_De_Paris.txt 4
bibles	NotreDame_De_Paris.txt 1
bibs	NotreDame_De_Paris.txt 1
bic	NotreDame_De_Paris.txt 4
bien	NotreDame_De_Paris.txt 1
bierbecque	NotreDame_De_Paris.txt 1
big	NotreDame_De_Paris.txt 49
biggest	NotreDame_De_Paris.txt 1
bigoted	NotreDame_De_Paris.txt 1
bigwigs	NotreDame_De_Paris.txt 1
billhook	NotreDame_De_Paris.txt 2
billhooks	NotreDame_De_Paris.txt 1
billows	NotreDame_De_Paris.txt 1
billy	NotreDame_De_Paris.txt 5
binary	NotreDame_De_Paris.txt 1
bind	NotreDame_De_Paris.txt 3
binding	NotreDame_De_Paris.txt 2
biot	NotreDame_De_Paris.txt 1
birch	NotreDame_De_Paris.txt 1
bird	NotreDame_De_Paris.txt 24
birds	NotreDame_De_Paris.txt 13
birth	NotreDame_De_Paris.txt 7
biscornette	NotreDame_De_Paris.txt 2
bishop	NotreDame_De_Paris.txt 52
bishopric	NotreDame_De_Paris.txt 3
bishoprics	NotreDame_De_Paris.txt 1
bishops	NotreDame_De_Paris.txt 12
bisuncio	NotreDame_De_Paris.txt 1
bit	NotreDame_De_Paris.txt 33
bite	NotreDame_De_Paris.txt 9
biterne	NotreDame_De_Paris.txt 1
bites	NotreDame_De_Paris.txt 1
biting	NotreDame_De_Paris.txt 6
bitou	NotreDame_De_Paris.txt 1
bits	NotreDame_De_Paris.txt 4
bitten	NotreDame_De_Paris.txt 3
bitter	NotreDame_De_Paris.txt 15
bitterly	NotreDame_De_Paris.txt 3
bitterness	NotreDame_De_Paris.txt 10
black	NotreDame_De_Paris.txt 129
blackbird	NotreDame_De_Paris.txt 1
blackened	NotreDame_De_Paris.txt 2
blacker	NotreDame_De_Paris.txt 3
blackguard	NotreDame_De_Paris.txt 1
blackly	NotreDame_De_Paris.txt 2
blade	NotreDame_De_Paris.txt 9
blades	NotreDame_De_Paris.txt 2
blames	NotreDame_De_Paris.txt 1
bland	NotreDame_De_Paris.txt 1
blank	NotreDame_De_Paris.txt 3
blanks	NotreDame_De_Paris.txt 6
blarney	NotreDame_De_Paris.txt 1
blase	NotreDame_De_Paris.txt 1
blaspheme	NotreDame_De_Paris.txt 1
blasphemies	NotreDame_De_Paris.txt 1
blasted	NotreDame_De_Paris.txt 1
blazed	NotreDame_De_Paris.txt 2
blazoned	NotreDame_De_Paris.txt 1
blazoning	NotreDame_De_Paris.txt 1
blazons	NotreDame_De_Paris.txt 1
blear	NotreDame_De_Paris.txt 2
bleat	NotreDame_De_Paris.txt 4
bleated	NotreDame_De_Paris.txt 3
bleating	NotreDame_De_Paris.txt 4
bled	NotreDame_De_Paris.txt 1
bleed	NotreDame_De_Paris.txt 1
bleeding	NotreDame_De_Paris.txt 5
bleeds	NotreDame_De_Paris.txt 1
bless	NotreDame_De_Paris.txt 1
blessed	NotreDame_De_Paris.txt 7
blessing	NotreDame_De_Paris.txt 2
bleu	NotreDame_De_Paris.txt 1
blew	NotreDame_De_Paris.txt 3
blight	NotreDame_De_Paris.txt 2
blind	NotreDame_De_Paris.txt 29
blindly	NotreDame_De_Paris.txt 2
blinds	NotreDame_De_Paris.txt 1
blinked	NotreDame_De_Paris.txt 1
bliss	NotreDame_De_Paris.txt 1
blissful	NotreDame_De_Paris.txt 1
blissfully	NotreDame_De_Paris.txt 1
block	NotreDame_De_Paris.txt 12
blockade	NotreDame_De_Paris.txt 1
blockading	NotreDame_De_Paris.txt 1
blocked	NotreDame_De_Paris.txt 1
blockhead	NotreDame_De_Paris.txt 1
blocks	NotreDame_De_Paris.txt 10
blond	NotreDame_De_Paris.txt 3
blonde	NotreDame_De_Paris.txt 5
blood	NotreDame_De_Paris.txt 32
bloodhounds	NotreDame_De_Paris.txt 1
bloody	NotreDame_De_Paris.txt 4
blossom	NotreDame_De_Paris.txt 1
blossomed	NotreDame_De_Paris.txt 1
blossoming	NotreDame_De_Paris.txt 1
blow	NotreDame_De_Paris.txt 27
blowing	NotreDame_De_Paris.txt 5
blows	NotreDame_De_Paris.txt 20
blue	NotreDame_De_Paris.txt 20
bluest	NotreDame_De_Paris.txt 1
bluish	NotreDame_De_Paris.txt 1
blundering	NotreDame_De_Paris.txt 1
blush	NotreDame_De_Paris.txt 3
blushed	NotreDame_De_Paris.txt 3
blushing	NotreDame_De_Paris.txt 4
blustering	NotreDame_De_Paris.txt 1
boar	NotreDame_De_Paris.txt 7
board	NotreDame_De_Paris.txt 3
boards	NotreDame_De_Paris.txt 1
boat	NotreDame_De_Paris.txt 19
boatman	NotreDame_De_Paris.txt 3
boats	NotreDame_De_Paris.txt 3
bocador	NotreDame_De_Paris.txt 1
bocherville	NotreDame_De_Paris.txt 2
bodices	NotreDame_De_Paris.txt 1
bodies	NotreDame_De_Paris.txt 6
bodily	NotreDame_De_Paris.txt 1
body	NotreDame_De_Paris.txt 56
bodyguard	NotreDame_De_Paris.txt 1
boeuf	NotreDame_De_Paris.txt 4
boeufs	NotreDame_De_Paris.txt 5
bohemia	NotreDame_De_Paris.txt 6
bohemian	NotreDame_De_Paris.txt 28
bohemians	NotreDame_De_Paris.txt 4
boias	NotreDame_De_Paris.txt 1
boil	NotreDame_De_Paris.txt 4
boiled	NotreDame_De_Paris.txt 3
boiler	NotreDame_De_Paris.txt 1
boiling	NotreDame_De_Paris.txt 6
boils	NotreDame_De_Paris.txt 1
bois	NotreDame_De_Paris.txt 3
bold	NotreDame_De_Paris.txt 12
boldest	NotreDame_De_Paris.txt 1
boldly	NotreDame_De_Paris.txt 10
bole	NotreDame_De_Paris.txt 3
bolt	NotreDame_De_Paris.txt 3
bolted	NotreDame_De_Paris.txt 1
bolting	NotreDame_De_Paris.txt 1
bolts	NotreDame_De_Paris.txt 3
bomb	NotreDame_De_Paris.txt 1
bombard	NotreDame_De_Paris.txt 2
bombards	NotreDame_De_Paris.txt 3
bombum	NotreDame_De_Paris.txt 1
bon	NotreDame_De_Paris.txt 1
bond	NotreDame_De_Paris.txt 2
bonds	NotreDame_De_Paris.txt 7
bone	NotreDame_De_Paris.txt 8
bones	NotreDame_De_Paris.txt 10
bonfire	NotreDame_De_Paris.txt 12
boniface	NotreDame_De_Paris.txt 1
bonnaire	NotreDame_De_Paris.txt 1
bonnets	NotreDame_De_Paris.txt 1
bonsoir	NotreDame_De_Paris.txt 1
bony	NotreDame_De_Paris.txt 4
boobies	NotreDame_De_Paris.txt 1
book	NotreDame_De_Paris.txt 74
books	NotreDame_De_Paris.txt 20
bookseller	NotreDame_De_Paris.txt 2
booksellers	NotreDame_De_Paris.txt 2
bookselling	NotreDame_De_Paris.txt 1
boon	NotreDame_De_Paris.txt 1
boor	NotreDame_De_Paris.txt 1
boot	NotreDame_De_Paris.txt 10
bootblacks	NotreDame_De_Paris.txt 2
booths	NotreDame_De_Paris.txt 1
boots	NotreDame_De_Paris.txt 8
booty	NotreDame_De_Paris.txt 1
bophomet	NotreDame_De_Paris.txt 1
bordelle	NotreDame_De_Paris.txt 1
border	NotreDame_De_Paris.txt 3
bordered	NotreDame_De_Paris.txt 5
borders	NotreDame_De_Paris.txt 2
bore	NotreDame_De_Paris.txt 16
bored	NotreDame_De_Paris.txt 2
borgia	NotreDame_De_Paris.txt 1
born	NotreDame_De_Paris.txt 17
borne	NotreDame_De_Paris.txt 11
borrowed	NotreDame_De_Paris.txt 1
borrowing	NotreDame_De_Paris.txt 1
bosom	NotreDame_De_Paris.txt 11
bosoms	NotreDame_De_Paris.txt 1
bosses	NotreDame_De_Paris.txt 3
botchers	NotreDame_De_Paris.txt 1
both	NotreDame_De_Paris.txt 81
bother	NotreDame_De_Paris.txt 1
bothers	NotreDame_De_Paris.txt 1
bottle	NotreDame_De_Paris.txt 4
bottles	NotreDame_De_Paris.txt 4
bottom	NotreDame_De_Paris.txt 27
bottomless	NotreDame_De_Paris.txt 1
bottoms	NotreDame_De_Paris.txt 1
boucanbry	NotreDame_De_Paris.txt 1
bouchard	NotreDame_De_Paris.txt 1
boucheria	NotreDame_De_Paris.txt 1
boucherie	NotreDame_De_Paris.txt 8
boucheries	NotreDame_De_Paris.txt 1
boucicaut	NotreDame_De_Paris.txt 2
boudoir	NotreDame_De_Paris.txt 1
boudraque	NotreDame_De_Paris.txt 1
bought	NotreDame_De_Paris.txt 2
boullayes	NotreDame_De_Paris.txt 1
bound	NotreDame_De_Paris.txt 23
boundary	NotreDame_De_Paris.txt 2
bounded	NotreDame_De_Paris.txt 4
boundless	NotreDame_De_Paris.txt 1
bounds	NotreDame_De_Paris.txt 3
bourbon	NotreDame_De_Paris.txt 25
bourbonnais	NotreDame_De_Paris.txt 1
bourdonnais	NotreDame_De_Paris.txt 1
bourg	NotreDame_De_Paris.txt 6
bourgeois	NotreDame_De_Paris.txt 43
bourgeoise	NotreDame_De_Paris.txt 2
bourgeoises	NotreDame_De_Paris.txt 4
bourgeoisie	NotreDame_De_Paris.txt 3
bourges	NotreDame_De_Paris.txt 3
bourgogne	NotreDame_De_Paris.txt 1
bourgoyne	NotreDame_De_Paris.txt 1
bourgs	NotreDame_De_Paris.txt 1
bourreau	NotreDame_De_Paris.txt 1
bourse	NotreDame_De_Paris.txt 3
boustrophedon	NotreDame_De_Paris.txt 1
bow	NotreDame_De_Paris.txt 6
bowed	NotreDame_De_Paris.txt 9
bowels	NotreDame_De_Paris.txt 1
bowing	NotreDame_De_Paris.txt 1
bowl	NotreDame_De_Paris.txt 7
bowls	NotreDame_De_Paris.txt 3
bowmen	NotreDame_De_Paris.txt 1
bows	NotreDame_De_Paris.txt 2
box	NotreDame_De_Paris.txt 5
boxes	NotreDame_De_Paris.txt 1
boxwood	NotreDame_De_Paris.txt 1
boy	NotreDame_De_Paris.txt 11
boys	NotreDame_De_Paris.txt 5
brabant	NotreDame_De_Paris.txt 1
braced	NotreDame_De_Paris.txt 1
bracelets	NotreDame_De_Paris.txt 1
brache	NotreDame_De_Paris.txt 1
brahmin	NotreDame_De_Paris.txt 1
braided	NotreDame_De_Paris.txt 1
braids	NotreDame_De_Paris.txt 1
brain	NotreDame_De_Paris.txt 12
braine	NotreDame_De_Paris.txt 1
braising	NotreDame_De_Paris.txt 1
branch	NotreDame_De_Paris.txt 4
branched	NotreDame_De_Paris.txt 1
branches	NotreDame_De_Paris.txt 5
branching	NotreDame_De_Paris.txt 2
brand	NotreDame_De_Paris.txt 1
branded	NotreDame_De_Paris.txt 1
brandishing	NotreDame_De_Paris.txt 1
brands	NotreDame_De_Paris.txt 3
braque	NotreDame_De_Paris.txt 3
bras	NotreDame_De_Paris.txt 1
brass	NotreDame_De_Paris.txt 7
brats	NotreDame_De_Paris.txt 1
bravado	NotreDame_De_Paris.txt 2
brave	NotreDame_De_Paris.txt 12
bravely	NotreDame_De_Paris.txt 8
bravest	NotreDame_De_Paris.txt 1
brawls	NotreDame_De_Paris.txt 1
brawny	NotreDame_De_Paris.txt 1
brazen	NotreDame_De_Paris.txt 7
brazier	NotreDame_De_Paris.txt 5
breach	NotreDame_De_Paris.txt 4
bread	NotreDame_De_Paris.txt 15
breadth	NotreDame_De_Paris.txt 4
break	NotreDame_De_Paris.txt 31
breakfast	NotreDame_De_Paris.txt 2
breaking	NotreDame_De_Paris.txt 15
breaks	NotreDame_De_Paris.txt 3
breast	NotreDame_De_Paris.txt 37
breasts	NotreDame_De_Paris.txt 2
breath	NotreDame_De_Paris.txt 32
breathe	NotreDame_De_Paris.txt 7
breathed	NotreDame_De_Paris.txt 10
breathing	NotreDame_De_Paris.txt 14
breathings	NotreDame_De_Paris.txt 1
breathless	NotreDame_De_Paris.txt 12
breathlessly	NotreDame_De_Paris.txt 1
breathlessness	NotreDame_De_Paris.txt 1
breaths	NotreDame_De_Paris.txt 1
bred	NotreDame_De_Paris.txt 1
breeches	NotreDame_De_Paris.txt 6
breeze	NotreDame_De_Paris.txt 6
bresse	NotreDame_De_Paris.txt 1
bressuire	NotreDame_De_Paris.txt 1
bretagne	NotreDame_De_Paris.txt 1
breton	NotreDame_De_Paris.txt 1
bretonne	NotreDame_De_Paris.txt 1
breul	NotreDame_De_Paris.txt 3
breviary	NotreDame_De_Paris.txt 10
brick	NotreDame_De_Paris.txt 4
brickyard	NotreDame_De_Paris.txt 1
bridal	NotreDame_De_Paris.txt 4
bridge	NotreDame_De_Paris.txt 13
bridges	NotreDame_De_Paris.txt 19
bridle	NotreDame_De_Paris.txt 6
bridling	NotreDame_De_Paris.txt 1
brie	NotreDame_De_Paris.txt 6
brief	NotreDame_De_Paris.txt 9
briefly	NotreDame_De_Paris.txt 5
brigade	NotreDame_De_Paris.txt 2
brigand	NotreDame_De_Paris.txt 1
brigandage	NotreDame_De_Paris.txt 2
brigands	NotreDame_De_Paris.txt 3
bright	NotreDame_De_Paris.txt 3
brightest	NotreDame_De_Paris.txt 2
brightly	NotreDame_De_Paris.txt 2
brightness	NotreDame_De_Paris.txt 1
brille	NotreDame_De_Paris.txt 2
brilliancy	NotreDame_De_Paris.txt 1
brilliant	NotreDame_De_Paris.txt 10
brilliantly	NotreDame_De_Paris.txt 1
brim	NotreDame_De_Paris.txt 1
bring	NotreDame_De_Paris.txt 17
bringing	NotreDame_De_Paris.txt 1
brings	NotreDame_De_Paris.txt 3
brink	NotreDame_De_Paris.txt 4
brisk	NotreDame_De_Paris.txt 2
briskly	NotreDame_De_Paris.txt 2
bristle	NotreDame_De_Paris.txt 3
bristled	NotreDame_De_Paris.txt 1
bristling	NotreDame_De_Paris.txt 10
brittany	NotreDame_De_Paris.txt 1
broad	NotreDame_De_Paris.txt 18
broadened	NotreDame_De_Paris.txt 1
broader	NotreDame_De_Paris.txt 1
broadly	NotreDame_De_Paris.txt 2
broadside	NotreDame_De_Paris.txt 1
broadswords	NotreDame_De_Paris.txt 1
brocade	NotreDame_De_Paris.txt 5
brocaded	NotreDame_De_Paris.txt 1
broidered	NotreDame_De_Paris.txt 2
broke	NotreDame_De_Paris.txt 34
broken	NotreDame_De_Paris.txt 52
brokers	NotreDame_De_Paris.txt 1
bronze	NotreDame_De_Paris.txt 5
brook	NotreDame_De_Paris.txt 1
brooks	NotreDame_De_Paris.txt 1
broom	NotreDame_De_Paris.txt 2
broomsticks	NotreDame_De_Paris.txt 1
brosse	NotreDame_De_Paris.txt 1
brother	NotreDame_De_Paris.txt 77
brotherhood	NotreDame_De_Paris.txt 3
brothers	NotreDame_De_Paris.txt 4
brought	NotreDame_De_Paris.txt 27
brow	NotreDame_De_Paris.txt 38
brown	NotreDame_De_Paris.txt 8
browned	NotreDame_De_Paris.txt 1
brows	NotreDame_De_Paris.txt 5
browse	NotreDame_De_Paris.txt 1
bruise	NotreDame_De_Paris.txt 1
bruised	NotreDame_De_Paris.txt 6
brunette	NotreDame_De_Paris.txt 2
bruni	NotreDame_De_Paris.txt 1
bruno	NotreDame_De_Paris.txt 2
brush	NotreDame_De_Paris.txt 3
brushed	NotreDame_De_Paris.txt 2
brushwood	NotreDame_De_Paris.txt 1
brussac	NotreDame_De_Paris.txt 1
brussels	NotreDame_De_Paris.txt 2
brutal	NotreDame_De_Paris.txt 6
brutalities	NotreDame_De_Paris.txt 1
brutality	NotreDame_De_Paris.txt 1
brutally	NotreDame_De_Paris.txt 1
buci	NotreDame_De_Paris.txt 1
buck	NotreDame_De_Paris.txt 1
bucket	NotreDame_De_Paris.txt 1
buckle	NotreDame_De_Paris.txt 5
buckled	NotreDame_De_Paris.txt 1
bucklers	NotreDame_De_Paris.txt 1
buckles	NotreDame_De_Paris.txt 1
buckshot	NotreDame_De_Paris.txt 1
budget	NotreDame_De_Paris.txt 1
buen	NotreDame_De_Paris.txt 1
buffet	NotreDame_De_Paris.txt 3
buffoon	NotreDame_De_Paris.txt 1
buffoons	NotreDame_De_Paris.txt 2
build	NotreDame_De_Paris.txt 1
builder	NotreDame_De_Paris.txt 1
building	NotreDame_De_Paris.txt 8
buildings	NotreDame_De_Paris.txt 6
builds	NotreDame_De_Paris.txt 3
built	NotreDame_De_Paris.txt 14
buisson	NotreDame_De_Paris.txt 1
bulky	NotreDame_De_Paris.txt 1
bull	NotreDame_De_Paris.txt 8
bullets	NotreDame_De_Paris.txt 2
bulls	NotreDame_De_Paris.txt 2
bulwark	NotreDame_De_Paris.txt 1
bump	NotreDame_De_Paris.txt 1
bumping	NotreDame_De_Paris.txt 1
bunch	NotreDame_De_Paris.txt 1
bunches	NotreDame_De_Paris.txt 2
bundle	NotreDame_De_Paris.txt 6
bundles	NotreDame_De_Paris.txt 4
bunglers	NotreDame_De_Paris.txt 1
buntings	NotreDame_De_Paris.txt 1
buona	NotreDame_De_Paris.txt 3
burden	NotreDame_De_Paris.txt 2
burgomaster	NotreDame_De_Paris.txt 2
burgomasters	NotreDame_De_Paris.txt 4
burgs	NotreDame_De_Paris.txt 1
burgundian	NotreDame_De_Paris.txt 4
burgundians	NotreDame_De_Paris.txt 4
burgundy	NotreDame_De_Paris.txt 10
buried	NotreDame_De_Paris.txt 14
burington	NotreDame_De_Paris.txt 1
burly	NotreDame_De_Paris.txt 2
burn	NotreDame_De_Paris.txt 13
burned	NotreDame_De_Paris.txt 8
burning	NotreDame_De_Paris.txt 19
burns	NotreDame_De_Paris.txt 2
burnt	NotreDame_De_Paris.txt 1
bursars	NotreDame_De_Paris.txt 1
burst	NotreDame_De_Paris.txt 38
bursting	NotreDame_De_Paris.txt 9
bursts	NotreDame_De_Paris.txt 4
bury	NotreDame_De_Paris.txt 4
burying	NotreDame_De_Paris.txt 1
bushes	NotreDame_De_Paris.txt 1
bushy	NotreDame_De_Paris.txt 5
business	NotreDame_De_Paris.txt 5
bustled	NotreDame_De_Paris.txt 1
busy	NotreDame_De_Paris.txt 4
busying	NotreDame_De_Paris.txt 1
but	NotreDame_De_Paris.txt 651
butcher	NotreDame_De_Paris.txt 4
butchers	NotreDame_De_Paris.txt 1
buticulario	NotreDame_De_Paris.txt 1
butler	NotreDame_De_Paris.txt 4
buttonholes	NotreDame_De_Paris.txt 1
buttons	NotreDame_De_Paris.txt 1
buttress	NotreDame_De_Paris.txt 1
buttresses	NotreDame_De_Paris.txt 5
butts	NotreDame_De_Paris.txt 1
buxom	NotreDame_De_Paris.txt 1
buy	NotreDame_De_Paris.txt 8
buying	NotreDame_De_Paris.txt 1
buzzed	NotreDame_De_Paris.txt 1
buzzing	NotreDame_De_Paris.txt 4
by	NotreDame_De_Paris.txt 827
byron	NotreDame_De_Paris.txt 1
bystanders	NotreDame_De_Paris.txt 1
byzantine	NotreDame_De_Paris.txt 2
