h	NotreDame_De_Paris.txt 75
ha	NotreDame_De_Paris.txt 2
habendi	NotreDame_De_Paris.txt 1
habere	NotreDame_De_Paris.txt 1
habet	NotreDame_De_Paris.txt 3
habill	NotreDame_De_Paris.txt 1
habit	NotreDame_De_Paris.txt 8
habitat	NotreDame_De_Paris.txt 1
habitation	NotreDame_De_Paris.txt 1
habitations	NotreDame_De_Paris.txt 2
habits	NotreDame_De_Paris.txt 1
habitual	NotreDame_De_Paris.txt 4
habitually	NotreDame_De_Paris.txt 2
habituated	NotreDame_De_Paris.txt 2
hac	NotreDame_De_Paris.txt 1
hackbut	NotreDame_De_Paris.txt 1
hackbuteers	NotreDame_De_Paris.txt 1
hackbuts	NotreDame_De_Paris.txt 2
had	NotreDame_De_Paris.txt 1422
hadst	NotreDame_De_Paris.txt 2
hag	NotreDame_De_Paris.txt 4
hage	NotreDame_De_Paris.txt 1
haggard	NotreDame_De_Paris.txt 7
hags	NotreDame_De_Paris.txt 2
hah	NotreDame_De_Paris.txt 7
hail	NotreDame_De_Paris.txt 5
hailstones	NotreDame_De_Paris.txt 1
hair	NotreDame_De_Paris.txt 53
haired	NotreDame_De_Paris.txt 5
hairs	NotreDame_De_Paris.txt 4
hairy	NotreDame_De_Paris.txt 3
halberdiers	NotreDame_De_Paris.txt 1
halberds	NotreDame_De_Paris.txt 5
half	NotreDame_De_Paris.txt 83
hall	NotreDame_De_Paris.txt 54
hallaron	NotreDame_De_Paris.txt 1
halles	NotreDame_De_Paris.txt 5
hallowed	NotreDame_De_Paris.txt 1
halls	NotreDame_De_Paris.txt 1
hallucination	NotreDame_De_Paris.txt 2
halt	NotreDame_De_Paris.txt 11
halted	NotreDame_De_Paris.txt 31
halter	NotreDame_De_Paris.txt 2
halting	NotreDame_De_Paris.txt 3
halves	NotreDame_De_Paris.txt 1
hamlet	NotreDame_De_Paris.txt 1
hammer	NotreDame_De_Paris.txt 7
hammers	NotreDame_De_Paris.txt 2
hammocks	NotreDame_De_Paris.txt 1
hancy	NotreDame_De_Paris.txt 1
hand	NotreDame_De_Paris.txt 162
handcuffs	NotreDame_De_Paris.txt 1
handed	NotreDame_De_Paris.txt 4
handful	NotreDame_De_Paris.txt 4
handfuls	NotreDame_De_Paris.txt 2
handing	NotreDame_De_Paris.txt 1
handkerchief	NotreDame_De_Paris.txt 1
handkerchiefs	NotreDame_De_Paris.txt 1
handle	NotreDame_De_Paris.txt 5
handled	NotreDame_De_Paris.txt 1
handles	NotreDame_De_Paris.txt 3
handling	NotreDame_De_Paris.txt 1
hands	NotreDame_De_Paris.txt 142
handsome	NotreDame_De_Paris.txt 46
handsomer	NotreDame_De_Paris.txt 2
handsomest	NotreDame_De_Paris.txt 2
handwriting	NotreDame_De_Paris.txt 1
hang	NotreDame_De_Paris.txt 28
hanged	NotreDame_De_Paris.txt 30
hangest	NotreDame_De_Paris.txt 1
hanging	NotreDame_De_Paris.txt 16
hangings	NotreDame_De_Paris.txt 3
hangman	NotreDame_De_Paris.txt 6
hangs	NotreDame_De_Paris.txt 2
hapgood	NotreDame_De_Paris.txt 2
haphazard	NotreDame_De_Paris.txt 4
happen	NotreDame_De_Paris.txt 4
happened	NotreDame_De_Paris.txt 7
happens	NotreDame_De_Paris.txt 3
happiest	NotreDame_De_Paris.txt 1
happily	NotreDame_De_Paris.txt 3
happiness	NotreDame_De_Paris.txt 8
happy	NotreDame_De_Paris.txt 31
haps	NotreDame_De_Paris.txt 1
harancourt	NotreDame_De_Paris.txt 1
harangue	NotreDame_De_Paris.txt 7
harangued	NotreDame_De_Paris.txt 2
haranguing	NotreDame_De_Paris.txt 1
harcourt	NotreDame_De_Paris.txt 1
hard	NotreDame_De_Paris.txt 18
harden	NotreDame_De_Paris.txt 1
hardened	NotreDame_De_Paris.txt 2
harder	NotreDame_De_Paris.txt 2
hardest	NotreDame_De_Paris.txt 1
hardily	NotreDame_De_Paris.txt 2
hardly	NotreDame_De_Paris.txt 37
hardness	NotreDame_De_Paris.txt 1
hares	NotreDame_De_Paris.txt 1
harfleur	NotreDame_De_Paris.txt 1
hark	NotreDame_De_Paris.txt 1
harlay	NotreDame_De_Paris.txt 1
harm	NotreDame_De_Paris.txt 11
harmless	NotreDame_De_Paris.txt 1
harmonies	NotreDame_De_Paris.txt 2
harmonious	NotreDame_De_Paris.txt 5
harmony	NotreDame_De_Paris.txt 9
harness	NotreDame_De_Paris.txt 2
harnessed	NotreDame_De_Paris.txt 2
harnesses	NotreDame_De_Paris.txt 1
harpe	NotreDame_De_Paris.txt 3
harsh	NotreDame_De_Paris.txt 10
harshest	NotreDame_De_Paris.txt 1
harshness	NotreDame_De_Paris.txt 1
hart	NotreDame_De_Paris.txt 3
harvest	NotreDame_De_Paris.txt 2
harvester	NotreDame_De_Paris.txt 1
has	NotreDame_De_Paris.txt 296
hasn	NotreDame_De_Paris.txt 1
hast	NotreDame_De_Paris.txt 4
haste	NotreDame_De_Paris.txt 17
hasten	NotreDame_De_Paris.txt 3
hastened	NotreDame_De_Paris.txt 9
hastening	NotreDame_De_Paris.txt 1
hastily	NotreDame_De_Paris.txt 10
hasty	NotreDame_De_Paris.txt 2
hat	NotreDame_De_Paris.txt 14
hate	NotreDame_De_Paris.txt 13
hated	NotreDame_De_Paris.txt 6
hateful	NotreDame_De_Paris.txt 1
hath	NotreDame_De_Paris.txt 27
hatred	NotreDame_De_Paris.txt 11
hats	NotreDame_De_Paris.txt 1
hauberkmaker	NotreDame_De_Paris.txt 1
haudriette	NotreDame_De_Paris.txt 3
haudriettes	NotreDame_De_Paris.txt 2
haudry	NotreDame_De_Paris.txt 2
haughty	NotreDame_De_Paris.txt 7
haunches	NotreDame_De_Paris.txt 8
haunted	NotreDame_De_Paris.txt 1
haut	NotreDame_De_Paris.txt 1
hauteur	NotreDame_De_Paris.txt 1
have	NotreDame_De_Paris.txt 831
haven	NotreDame_De_Paris.txt 1
having	NotreDame_De_Paris.txt 110
hawk	NotreDame_De_Paris.txt 2
hawklike	NotreDame_De_Paris.txt 1
hax	NotreDame_De_Paris.txt 2
hayloft	NotreDame_De_Paris.txt 1
hazarded	NotreDame_De_Paris.txt 2
hazards	NotreDame_De_Paris.txt 1
he	NotreDame_De_Paris.txt 2171
head	NotreDame_De_Paris.txt 257
headdress	NotreDame_De_Paris.txt 1
headed	NotreDame_De_Paris.txt 5
headgear	NotreDame_De_Paris.txt 3
headlong	NotreDame_De_Paris.txt 2
heads	NotreDame_De_Paris.txt 54
headsman	NotreDame_De_Paris.txt 9
healed	NotreDame_De_Paris.txt 1
health	NotreDame_De_Paris.txt 9
healthy	NotreDame_De_Paris.txt 1
heap	NotreDame_De_Paris.txt 11
heaped	NotreDame_De_Paris.txt 4
heaping	NotreDame_De_Paris.txt 1
heaps	NotreDame_De_Paris.txt 3
hear	NotreDame_De_Paris.txt 51
heard	NotreDame_De_Paris.txt 112
heardest	NotreDame_De_Paris.txt 1
heareth	NotreDame_De_Paris.txt 1
hearing	NotreDame_De_Paris.txt 9
hearings	NotreDame_De_Paris.txt 1
hears	NotreDame_De_Paris.txt 3
heart	NotreDame_De_Paris.txt 87
heartbreaking	NotreDame_De_Paris.txt 1
hearted	NotreDame_De_Paris.txt 1
hearth	NotreDame_De_Paris.txt 1
hearthstone	NotreDame_De_Paris.txt 1
heartily	NotreDame_De_Paris.txt 3
heartrending	NotreDame_De_Paris.txt 7
hearts	NotreDame_De_Paris.txt 6
hearty	NotreDame_De_Paris.txt 2
heat	NotreDame_De_Paris.txt 5
heated	NotreDame_De_Paris.txt 2
heath	NotreDame_De_Paris.txt 3
heathen	NotreDame_De_Paris.txt 1
heaths	NotreDame_De_Paris.txt 1
heaved	NotreDame_De_Paris.txt 5
heaven	NotreDame_De_Paris.txt 28
heavens	NotreDame_De_Paris.txt 14
heavenward	NotreDame_De_Paris.txt 1
heavier	NotreDame_De_Paris.txt 1
heaviest	NotreDame_De_Paris.txt 1
heavily	NotreDame_De_Paris.txt 4
heaving	NotreDame_De_Paris.txt 2
heavy	NotreDame_De_Paris.txt 38
hebdomade	NotreDame_De_Paris.txt 1
hebrew	NotreDame_De_Paris.txt 7
hecataeus	NotreDame_De_Paris.txt 1
hedge	NotreDame_De_Paris.txt 2
hedgerows	NotreDame_De_Paris.txt 1
heed	NotreDame_De_Paris.txt 10
heeding	NotreDame_De_Paris.txt 2
heedless	NotreDame_De_Paris.txt 2
heedlessness	NotreDame_De_Paris.txt 3
heel	NotreDame_De_Paris.txt 2
heels	NotreDame_De_Paris.txt 8
height	NotreDame_De_Paris.txt 19
heights	NotreDame_De_Paris.txt 7
heiresses	NotreDame_De_Paris.txt 2
held	NotreDame_De_Paris.txt 49
helgaldus	NotreDame_De_Paris.txt 1
hell	NotreDame_De_Paris.txt 26
hellain	NotreDame_De_Paris.txt 1
hellish	NotreDame_De_Paris.txt 1
helmet	NotreDame_De_Paris.txt 3
helmets	NotreDame_De_Paris.txt 2
help	NotreDame_De_Paris.txt 13
helped	NotreDame_De_Paris.txt 2
helplessness	NotreDame_De_Paris.txt 1
helye	NotreDame_De_Paris.txt 1
hem	NotreDame_De_Paris.txt 5
hemlet	NotreDame_De_Paris.txt 1
hemmed	NotreDame_De_Paris.txt 1
hemp	NotreDame_De_Paris.txt 2
hempen	NotreDame_De_Paris.txt 3
hence	NotreDame_De_Paris.txt 45
henceforth	NotreDame_De_Paris.txt 5
hennequin	NotreDame_De_Paris.txt 1
henri	NotreDame_De_Paris.txt 6
henriet	NotreDame_De_Paris.txt 3
henriette	NotreDame_De_Paris.txt 2
her	NotreDame_De_Paris.txt 1487
heraldic	NotreDame_De_Paris.txt 2
herb	NotreDame_De_Paris.txt 1
herberie	NotreDame_De_Paris.txt 1
herbs	NotreDame_De_Paris.txt 2
hercandus	NotreDame_De_Paris.txt 1
hercle	NotreDame_De_Paris.txt 1
herculean	NotreDame_De_Paris.txt 1
hercules	NotreDame_De_Paris.txt 1
herd	NotreDame_De_Paris.txt 3
here	NotreDame_De_Paris.txt 217
hereafter	NotreDame_De_Paris.txt 1
hereditary	NotreDame_De_Paris.txt 1
herein	NotreDame_De_Paris.txt 1
heresy	NotreDame_De_Paris.txt 1
heretic	NotreDame_De_Paris.txt 1
heretics	NotreDame_De_Paris.txt 2
heretofore	NotreDame_De_Paris.txt 1
herme	NotreDame_De_Paris.txt 3
hermes	NotreDame_De_Paris.txt 5
hermetic	NotreDame_De_Paris.txt 4
hermetically	NotreDame_De_Paris.txt 1
hermeticism	NotreDame_De_Paris.txt 2
hermetics	NotreDame_De_Paris.txt 6
hermit	NotreDame_De_Paris.txt 2
hermite	NotreDame_De_Paris.txt 12
herodotus	NotreDame_De_Paris.txt 1
heroically	NotreDame_De_Paris.txt 1
heron	NotreDame_De_Paris.txt 1
herrings	NotreDame_De_Paris.txt 1
hers	NotreDame_De_Paris.txt 6
herself	NotreDame_De_Paris.txt 84
hesitate	NotreDame_De_Paris.txt 2
hesitated	NotreDame_De_Paris.txt 7
hesitating	NotreDame_De_Paris.txt 2
hesitation	NotreDame_De_Paris.txt 7
heugh	NotreDame_De_Paris.txt 1
heuh	NotreDame_De_Paris.txt 1
hew	NotreDame_De_Paris.txt 1
hewn	NotreDame_De_Paris.txt 2
hexagonal	NotreDame_De_Paris.txt 1
hexameter	NotreDame_De_Paris.txt 2
hey	NotreDame_De_Paris.txt 2
hibou	NotreDame_De_Paris.txt 1
hic	NotreDame_De_Paris.txt 1
hid	NotreDame_De_Paris.txt 6
hidden	NotreDame_De_Paris.txt 5
hide	NotreDame_De_Paris.txt 10
hideous	NotreDame_De_Paris.txt 28
hides	NotreDame_De_Paris.txt 2
hiding	NotreDame_De_Paris.txt 7
hierarchic	NotreDame_De_Paris.txt 1
hieroglyph	NotreDame_De_Paris.txt 5
hieroglyphic	NotreDame_De_Paris.txt 2
hieroglyphics	NotreDame_De_Paris.txt 5
hieroglyphs	NotreDame_De_Paris.txt 2
high	NotreDame_De_Paris.txt 38
higher	NotreDame_De_Paris.txt 4
highest	NotreDame_De_Paris.txt 4
highly	NotreDame_De_Paris.txt 2
highnesses	NotreDame_De_Paris.txt 1
highway	NotreDame_De_Paris.txt 1
highwayman	NotreDame_De_Paris.txt 1
highwaymen	NotreDame_De_Paris.txt 1
highways	NotreDame_De_Paris.txt 3
hilaire	NotreDame_De_Paris.txt 1
hill	NotreDame_De_Paris.txt 5
hillock	NotreDame_De_Paris.txt 4
hills	NotreDame_De_Paris.txt 8
hilly	NotreDame_De_Paris.txt 2
hilt	NotreDame_De_Paris.txt 4
him	NotreDame_De_Paris.txt 771
himself	NotreDame_De_Paris.txt 286
hind	NotreDame_De_Paris.txt 3
hinder	NotreDame_De_Paris.txt 1
hindoo	NotreDame_De_Paris.txt 4
hindrance	NotreDame_De_Paris.txt 2
hindu	NotreDame_De_Paris.txt 1
hindustan	NotreDame_De_Paris.txt 1
hinge	NotreDame_De_Paris.txt 1
hinges	NotreDame_De_Paris.txt 4
hint	NotreDame_De_Paris.txt 1
hinted	NotreDame_De_Paris.txt 1
hip	NotreDame_De_Paris.txt 1
hippocephali	NotreDame_De_Paris.txt 1
hippocras	NotreDame_De_Paris.txt 4
hippocrass	NotreDame_De_Paris.txt 1
hippocrates	NotreDame_De_Paris.txt 3
hippogriff	NotreDame_De_Paris.txt 1
hips	NotreDame_De_Paris.txt 4
hipshot	NotreDame_De_Paris.txt 1
hirsutus	NotreDame_De_Paris.txt 1
his	NotreDame_De_Paris.txt 1961
hispalus	NotreDame_De_Paris.txt 1
hiss	NotreDame_De_Paris.txt 1
hissed	NotreDame_De_Paris.txt 2
hissing	NotreDame_De_Paris.txt 4
histoire	NotreDame_De_Paris.txt 1
historian	NotreDame_De_Paris.txt 5
historians	NotreDame_De_Paris.txt 1
historical	NotreDame_De_Paris.txt 3
history	NotreDame_De_Paris.txt 24
hit	NotreDame_De_Paris.txt 1
hitched	NotreDame_De_Paris.txt 2
hither	NotreDame_De_Paris.txt 7
hitherto	NotreDame_De_Paris.txt 10
hive	NotreDame_De_Paris.txt 5
hiver	NotreDame_De_Paris.txt 1
hives	NotreDame_De_Paris.txt 1
hivres	NotreDame_De_Paris.txt 1
ho	NotreDame_De_Paris.txt 17
hoarding	NotreDame_De_Paris.txt 1
hoarse	NotreDame_De_Paris.txt 11
hobbes	NotreDame_De_Paris.txt 1
hoctement	NotreDame_De_Paris.txt 1
hod	NotreDame_De_Paris.txt 1
hogshead	NotreDame_De_Paris.txt 9
hogsheads	NotreDame_De_Paris.txt 2
hoisted	NotreDame_De_Paris.txt 2
hol	NotreDame_De_Paris.txt 12
hola	NotreDame_De_Paris.txt 2
hold	NotreDame_De_Paris.txt 46
holder	NotreDame_De_Paris.txt 4
holding	NotreDame_De_Paris.txt 18
holds	NotreDame_De_Paris.txt 8
hole	NotreDame_De_Paris.txt 42
holes	NotreDame_De_Paris.txt 10
hollow	NotreDame_De_Paris.txt 17
hollowed	NotreDame_De_Paris.txt 5
hollows	NotreDame_De_Paris.txt 2
holy	NotreDame_De_Paris.txt 25
homage	NotreDame_De_Paris.txt 1
hombre	NotreDame_De_Paris.txt 2
home	NotreDame_De_Paris.txt 6
homer	NotreDame_De_Paris.txt 7
homeric	NotreDame_De_Paris.txt 1
homerus	NotreDame_De_Paris.txt 2
homini	NotreDame_De_Paris.txt 1
homme	NotreDame_De_Paris.txt 1
homo	NotreDame_De_Paris.txt 2
homogeneous	NotreDame_De_Paris.txt 3
honest	NotreDame_De_Paris.txt 8
honey	NotreDame_De_Paris.txt 3
honeyed	NotreDame_De_Paris.txt 2
honor	NotreDame_De_Paris.txt 20
honorabilem	NotreDame_De_Paris.txt 1
honorable	NotreDame_De_Paris.txt 5
honored	NotreDame_De_Paris.txt 3
honorius	NotreDame_De_Paris.txt 2
hood	NotreDame_De_Paris.txt 2
hooded	NotreDame_De_Paris.txt 2
hoods	NotreDame_De_Paris.txt 1
hoof	NotreDame_De_Paris.txt 4
hoofs	NotreDame_De_Paris.txt 5
hook	NotreDame_De_Paris.txt 3
hooks	NotreDame_De_Paris.txt 1
hoops	NotreDame_De_Paris.txt 1
hoot	NotreDame_De_Paris.txt 4
hooted	NotreDame_De_Paris.txt 2
hooting	NotreDame_De_Paris.txt 3
hootings	NotreDame_De_Paris.txt 1
hoots	NotreDame_De_Paris.txt 2
hop	NotreDame_De_Paris.txt 1
hope	NotreDame_De_Paris.txt 42
hoped	NotreDame_De_Paris.txt 10
hopes	NotreDame_De_Paris.txt 3
hoping	NotreDame_De_Paris.txt 3
hopping	NotreDame_De_Paris.txt 2
horace	NotreDame_De_Paris.txt 3
horde	NotreDame_De_Paris.txt 1
horizon	NotreDame_De_Paris.txt 19
horizontal	NotreDame_De_Paris.txt 5
horizontally	NotreDame_De_Paris.txt 1
horn	NotreDame_De_Paris.txt 5
horned	NotreDame_De_Paris.txt 2
horns	NotreDame_De_Paris.txt 20
horny	NotreDame_De_Paris.txt 2
horrible	NotreDame_De_Paris.txt 44
horribly	NotreDame_De_Paris.txt 2
horror	NotreDame_De_Paris.txt 21
horrors	NotreDame_De_Paris.txt 2
horse	NotreDame_De_Paris.txt 39
horseback	NotreDame_De_Paris.txt 1
horseman	NotreDame_De_Paris.txt 1
horses	NotreDame_De_Paris.txt 17
horseshoe	NotreDame_De_Paris.txt 2
hose	NotreDame_De_Paris.txt 3
hosier	NotreDame_De_Paris.txt 26
hospitable	NotreDame_De_Paris.txt 2
hospital	NotreDame_De_Paris.txt 5
hospitals	NotreDame_De_Paris.txt 1
hostelry	NotreDame_De_Paris.txt 1
hostess	NotreDame_De_Paris.txt 1
hostile	NotreDame_De_Paris.txt 2
hot	NotreDame_De_Paris.txt 11
hotel	NotreDame_De_Paris.txt 3
hotels	NotreDame_De_Paris.txt 2
hotly	NotreDame_De_Paris.txt 1
houls	NotreDame_De_Paris.txt 1
hound	NotreDame_De_Paris.txt 1
hounds	NotreDame_De_Paris.txt 4
hour	NotreDame_De_Paris.txt 53
hours	NotreDame_De_Paris.txt 13
house	NotreDame_De_Paris.txt 92
household	NotreDame_De_Paris.txt 4
houses	NotreDame_De_Paris.txt 57
housings	NotreDame_De_Paris.txt 3
hovel	NotreDame_De_Paris.txt 1
hovels	NotreDame_De_Paris.txt 3
how	NotreDame_De_Paris.txt 127
however	NotreDame_De_Paris.txt 47
howl	NotreDame_De_Paris.txt 6
howled	NotreDame_De_Paris.txt 5
howler	NotreDame_De_Paris.txt 1
howling	NotreDame_De_Paris.txt 5
hrata	NotreDame_De_Paris.txt 1
http	NotreDame_De_Paris.txt 8
hub	NotreDame_De_Paris.txt 1
hubins	NotreDame_De_Paris.txt 1
huchette	NotreDame_De_Paris.txt 1
hucksters	NotreDame_De_Paris.txt 1
hue	NotreDame_De_Paris.txt 4
hues	NotreDame_De_Paris.txt 2
huge	NotreDame_De_Paris.txt 28
hugo	NotreDame_De_Paris.txt 6
hugonet	NotreDame_De_Paris.txt 2
hugues	NotreDame_De_Paris.txt 3
hum	NotreDame_De_Paris.txt 8
human	NotreDame_De_Paris.txt 79
humane	NotreDame_De_Paris.txt 1
humanities	NotreDame_De_Paris.txt 1
humanity	NotreDame_De_Paris.txt 14
humble	NotreDame_De_Paris.txt 1
humblest	NotreDame_De_Paris.txt 1
humerus	NotreDame_De_Paris.txt 1
humid	NotreDame_De_Paris.txt 2
humiliated	NotreDame_De_Paris.txt 1
humiliating	NotreDame_De_Paris.txt 2
humiliation	NotreDame_De_Paris.txt 2
humming	NotreDame_De_Paris.txt 7
humor	NotreDame_De_Paris.txt 8
hump	NotreDame_De_Paris.txt 5
humped	NotreDame_De_Paris.txt 4
hunch	NotreDame_De_Paris.txt 1
hunchback	NotreDame_De_Paris.txt 20
hunchbacked	NotreDame_De_Paris.txt 6
hunchbacks	NotreDame_De_Paris.txt 1
hundred	NotreDame_De_Paris.txt 61
hundreds	NotreDame_De_Paris.txt 1
hung	NotreDame_De_Paris.txt 49
hungadi	NotreDame_De_Paris.txt 3
hungarian	NotreDame_De_Paris.txt 3
hungary	NotreDame_De_Paris.txt 1
hunger	NotreDame_De_Paris.txt 5
hungrier	NotreDame_De_Paris.txt 1
hungry	NotreDame_De_Paris.txt 3
hunt	NotreDame_De_Paris.txt 2
hunted	NotreDame_De_Paris.txt 1
hunter	NotreDame_De_Paris.txt 1
hunting	NotreDame_De_Paris.txt 2
huntsman	NotreDame_De_Paris.txt 1
hunyadi	NotreDame_De_Paris.txt 1
hurdy	NotreDame_De_Paris.txt 1
hurl	NotreDame_De_Paris.txt 3
hurled	NotreDame_De_Paris.txt 12
hurling	NotreDame_De_Paris.txt 3
hurly	NotreDame_De_Paris.txt 2
hurrah	NotreDame_De_Paris.txt 4
hurricane	NotreDame_De_Paris.txt 2
hurried	NotreDame_De_Paris.txt 1
hurriedly	NotreDame_De_Paris.txt 1
hurry	NotreDame_De_Paris.txt 2
hurrying	NotreDame_De_Paris.txt 2
hurt	NotreDame_De_Paris.txt 2
husband	NotreDame_De_Paris.txt 17
husbands	NotreDame_De_Paris.txt 1
hush	NotreDame_De_Paris.txt 1
hussar	NotreDame_De_Paris.txt 1
hussies	NotreDame_De_Paris.txt 2
husson	NotreDame_De_Paris.txt 1
hussy	NotreDame_De_Paris.txt 1
hut	NotreDame_De_Paris.txt 1
hutches	NotreDame_De_Paris.txt 1
hutin	NotreDame_De_Paris.txt 1
hyaena	NotreDame_De_Paris.txt 1
hybrid	NotreDame_De_Paris.txt 5
hydra	NotreDame_De_Paris.txt 4
hyena	NotreDame_De_Paris.txt 1
hymbercourt	NotreDame_De_Paris.txt 2
hymn	NotreDame_De_Paris.txt 1
hymnorum	NotreDame_De_Paris.txt 1
hypertext	NotreDame_De_Paris.txt 1
hypocrisy	NotreDame_De_Paris.txt 1
hypocrite	NotreDame_De_Paris.txt 1
hypotheses	NotreDame_De_Paris.txt 1
hypothesis	NotreDame_De_Paris.txt 1
