p	Miserables.txt 12
pa	Miserables.txt 3
pabourgeot	Miserables.txt 3
pace	Miserables.txt 38
paced	Miserables.txt 7
paces	Miserables.txt 69
pache	Miserables.txt 2
pacific	Miserables.txt 3
pacifically	Miserables.txt 1
pacification	Miserables.txt 1
pacing	Miserables.txt 9
pack	Miserables.txt 17
package	Miserables.txt 18
packages	Miserables.txt 3
packed	Miserables.txt 1
packer	Miserables.txt 1
packet	Miserables.txt 3
packets	Miserables.txt 1
packing	Miserables.txt 2
packs	Miserables.txt 1
pacy	Miserables.txt 1
paddle	Miserables.txt 1
paddock	Miserables.txt 3
padlock	Miserables.txt 1
padlocked	Miserables.txt 3
pads	Miserables.txt 1
padua	Miserables.txt 1
paer	Miserables.txt 1
pagan	Miserables.txt 2
paganism	Miserables.txt 1
page	Miserables.txt 14
pages	Miserables.txt 13
paglan	Miserables.txt 1
pagoda	Miserables.txt 2
paid	Miserables.txt 111
pail	Miserables.txt 5
pain	Miserables.txt 12
pained	Miserables.txt 6
painful	Miserables.txt 26
painfully	Miserables.txt 2
paining	Miserables.txt 1
pains	Miserables.txt 5
paint	Miserables.txt 10
painted	Miserables.txt 29
painter	Miserables.txt 8
painters	Miserables.txt 4
painting	Miserables.txt 8
paintings	Miserables.txt 4
paints	Miserables.txt 2
pair	Miserables.txt 39
pairing	Miserables.txt 1
pairs	Miserables.txt 1
paix	Miserables.txt 2
pajol	Miserables.txt 1
pal	Miserables.txt 1
palabres	Miserables.txt 1
palace	Miserables.txt 26
palaces	Miserables.txt 2
paladin	Miserables.txt 1
paladins	Miserables.txt 2
palafox	Miserables.txt 2
palais	Miserables.txt 2
palaiseau	Miserables.txt 2
palatinate	Miserables.txt 1
pale	Miserables.txt 84
paled	Miserables.txt 2
palely	Miserables.txt 1
paler	Miserables.txt 2
palermo	Miserables.txt 2
pales	Miserables.txt 1
palestine	Miserables.txt 1
paletot	Miserables.txt 1
palettes	Miserables.txt 3
palimpsest	Miserables.txt 1
palings	Miserables.txt 1
palisade	Miserables.txt 2
palisades	Miserables.txt 2
palisse	Miserables.txt 1
palissel	Miserables.txt 1
pall	Miserables.txt 6
pallas	Miserables.txt 1
pallet	Miserables.txt 11
pallets	Miserables.txt 5
palliation	Miserables.txt 1
pallid	Miserables.txt 8
pallio	Miserables.txt 1
pallium	Miserables.txt 1
pallor	Miserables.txt 18
pallors	Miserables.txt 1
palm	Miserables.txt 3
palmieri	Miserables.txt 1
palmipeds	Miserables.txt 1
palpable	Miserables.txt 5
palpitated	Miserables.txt 2
palpitating	Miserables.txt 2
palpitation	Miserables.txt 1
palpitations	Miserables.txt 3
pals	Miserables.txt 1
palsied	Miserables.txt 1
palsy	Miserables.txt 2
paltriness	Miserables.txt 1
paltry	Miserables.txt 5
pamela	Miserables.txt 5
pampas	Miserables.txt 1
pamphlets	Miserables.txt 1
pan	Miserables.txt 6
panacea	Miserables.txt 1
panama	Miserables.txt 1
panard	Miserables.txt 1
panathenaea	Miserables.txt 1
pancakes	Miserables.txt 1
panchaud	Miserables.txt 9
pandemonium	Miserables.txt 2
pandour	Miserables.txt 2
pane	Miserables.txt 21
panegyric	Miserables.txt 1
panel	Miserables.txt 4
panels	Miserables.txt 3
panes	Miserables.txt 14
pang	Miserables.txt 2
pangs	Miserables.txt 5
panic	Miserables.txt 4
pannis	Miserables.txt 1
panoply	Miserables.txt 1
pans	Miserables.txt 2
pant	Miserables.txt 1
pantaloon	Miserables.txt 1
panted	Miserables.txt 3
pantheistical	Miserables.txt 1
pantheon	Miserables.txt 14
panther	Miserables.txt 1
pantin	Miserables.txt 7
panting	Miserables.txt 10
pantinois	Miserables.txt 1
pantolabus	Miserables.txt 1
pantomime	Miserables.txt 1
pantouflochade	Miserables.txt 1
pantoufloche	Miserables.txt 1
pantre	Miserables.txt 1
papa	Miserables.txt 3
papal	Miserables.txt 4
papas	Miserables.txt 1
papavoine	Miserables.txt 1
papelotte	Miserables.txt 8
paper	Miserables.txt 139
papers	Miserables.txt 23
paperwork	Miserables.txt 1
paphos	Miserables.txt 1
papish	Miserables.txt 1
papyrus	Miserables.txt 1
par	Miserables.txt 4
para	Miserables.txt 1
parables	Miserables.txt 1
parabola	Miserables.txt 1
parade	Miserables.txt 2
paradise	Miserables.txt 47
paradises	Miserables.txt 2
paradisiacal	Miserables.txt 1
paradox	Miserables.txt 1
paragraph	Miserables.txt 12
paragraphs	Miserables.txt 4
parallel	Miserables.txt 8
parallelism	Miserables.txt 1
parallels	Miserables.txt 1
paralysis	Miserables.txt 2
paralyze	Miserables.txt 2
paralyzed	Miserables.txt 1
paralyzes	Miserables.txt 2
parapet	Miserables.txt 13
paraphernalia	Miserables.txt 1
paraphrase	Miserables.txt 1
parasite	Miserables.txt 4
parasites	Miserables.txt 4
parasitic	Miserables.txt 2
parasitism	Miserables.txt 2
parasol	Miserables.txt 1
paratt	Miserables.txt 1
parbleu	Miserables.txt 13
parc	Miserables.txt 1
parce	Miserables.txt 1
parcel	Miserables.txt 3
parcelled	Miserables.txt 1
parcels	Miserables.txt 1
parchment	Miserables.txt 1
pardalisca	Miserables.txt 1
pardi	Miserables.txt 8
pardie	Miserables.txt 1
pardieu	Miserables.txt 10
pardine	Miserables.txt 4
pardon	Miserables.txt 40
pardonable	Miserables.txt 3
pardoned	Miserables.txt 8
pardons	Miserables.txt 3
pare	Miserables.txt 1
parentheses	Miserables.txt 1
parenthesis	Miserables.txt 5
parenthetically	Miserables.txt 1
parents	Miserables.txt 7
pariah	Miserables.txt 1
paring	Miserables.txt 1
paris	Miserables.txt 413
parish	Miserables.txt 10
parishes	Miserables.txt 3
parishioner	Miserables.txt 2
parishioners	Miserables.txt 1
parisian	Miserables.txt 26
parisians	Miserables.txt 12
parisienne	Miserables.txt 2
park	Miserables.txt 2
parked	Miserables.txt 1
parks	Miserables.txt 1
parlance	Miserables.txt 3
parleyed	Miserables.txt 1
parliament	Miserables.txt 8
parliamentary	Miserables.txt 4
parliaments	Miserables.txt 1
parlor	Miserables.txt 18
parmentier	Miserables.txt 1
parmentiere	Miserables.txt 1
parnasse	Miserables.txt 2
parny	Miserables.txt 1
parodied	Miserables.txt 3
parodies	Miserables.txt 1
parody	Miserables.txt 4
parodying	Miserables.txt 1
paroquet	Miserables.txt 3
paroquets	Miserables.txt 1
paroxysm	Miserables.txt 4
paroxysms	Miserables.txt 2
parricide	Miserables.txt 1
parricides	Miserables.txt 2
parried	Miserables.txt 1
parries	Miserables.txt 1
parrots	Miserables.txt 1
parsley	Miserables.txt 1
parsonage	Miserables.txt 4
part	Miserables.txt 166
parte	Miserables.txt 1
parted	Miserables.txt 13
parthenon	Miserables.txt 2
parthian	Miserables.txt 1
partial	Miserables.txt 1
partibus	Miserables.txt 1
participant	Miserables.txt 2
participate	Miserables.txt 1
participates	Miserables.txt 2
participation	Miserables.txt 1
participles	Miserables.txt 1
particle	Miserables.txt 2
particular	Miserables.txt 26
particularly	Miserables.txt 32
particulars	Miserables.txt 3
parties	Miserables.txt 16
parting	Miserables.txt 1
partisan	Miserables.txt 3
partition	Miserables.txt 16
partitions	Miserables.txt 4
partly	Miserables.txt 5
partner	Miserables.txt 1
partook	Miserables.txt 2
partout	Miserables.txt 1
partridges	Miserables.txt 2
parts	Miserables.txt 22
party	Miserables.txt 34
parures	Miserables.txt 1
parvulos	Miserables.txt 1
parvulum	Miserables.txt 1
parvulus	Miserables.txt 2
pas	Miserables.txt 17
pascal	Miserables.txt 3
pasha	Miserables.txt 1
pass	Miserables.txt 157
passa	Miserables.txt 1
passable	Miserables.txt 2
passably	Miserables.txt 1
passage	Miserables.txt 51
passages	Miserables.txt 8
passait	Miserables.txt 1
passants	Miserables.txt 1
passed	Miserables.txt 310
passengers	Miserables.txt 2
passer	Miserables.txt 40
passerby	Miserables.txt 1
passers	Miserables.txt 49
passersby	Miserables.txt 4
passes	Miserables.txt 35
passing	Miserables.txt 97
passion	Miserables.txt 32
passionate	Miserables.txt 7
passionately	Miserables.txt 6
passions	Miserables.txt 21
passive	Miserables.txt 11
passively	Miserables.txt 3
passivity	Miserables.txt 3
passport	Miserables.txt 19
passports	Miserables.txt 1
password	Miserables.txt 3
passy	Miserables.txt 5
past	Miserables.txt 118
paste	Miserables.txt 6
pasted	Miserables.txt 4
pastor	Miserables.txt 1
pastoral	Miserables.txt 8
pastry	Miserables.txt 3
pasture	Miserables.txt 1
pastures	Miserables.txt 1
pat	Miserables.txt 1
patagon	Miserables.txt 3
patch	Miserables.txt 4
patched	Miserables.txt 5
patching	Miserables.txt 1
patchouli	Miserables.txt 1
pateaux	Miserables.txt 1
paten	Miserables.txt 1
patent	Miserables.txt 4
pater	Miserables.txt 4
paternal	Miserables.txt 6
paternally	Miserables.txt 2
paternity	Miserables.txt 6
paternoster	Miserables.txt 2
path	Miserables.txt 25
pathetic	Miserables.txt 5
pathologically	Miserables.txt 1
paths	Miserables.txt 12
pathway	Miserables.txt 2
patience	Miserables.txt 13
patient	Miserables.txt 4
patiently	Miserables.txt 2
patients	Miserables.txt 6
patmos	Miserables.txt 1
patois	Miserables.txt 3
patrem	Miserables.txt 1
patria	Miserables.txt 1
patriarch	Miserables.txt 2
patriarchal	Miserables.txt 2
patriarches	Miserables.txt 1
patriarchs	Miserables.txt 2
patrician	Miserables.txt 1
patrimonies	Miserables.txt 1
patrimony	Miserables.txt 1
patriotes	Miserables.txt 1
patriotic	Miserables.txt 4
patriotism	Miserables.txt 1
patriots	Miserables.txt 3
patrocles	Miserables.txt 1
patrol	Miserables.txt 23
patrols	Miserables.txt 7
patron	Miserables.txt 18
patronage	Miserables.txt 1
patronized	Miserables.txt 1
patronizes	Miserables.txt 1
patrons	Miserables.txt 1
patter	Miserables.txt 1
pattern	Miserables.txt 11
patterns	Miserables.txt 1
pau	Miserables.txt 2
paucity	Miserables.txt 1
paul	Miserables.txt 16
paulin	Miserables.txt 1
paunches	Miserables.txt 1
pauper	Miserables.txt 2
pauperism	Miserables.txt 4
pause	Miserables.txt 34
paused	Miserables.txt 72
pauses	Miserables.txt 2
pausing	Miserables.txt 6
pauvre	Miserables.txt 1
pauvres	Miserables.txt 1
paved	Miserables.txt 12
pavee	Miserables.txt 4
pavement	Miserables.txt 76
pavements	Miserables.txt 25
pavilion	Miserables.txt 14
pavillons	Miserables.txt 1
paving	Miserables.txt 49
paw	Miserables.txt 5
pawed	Miserables.txt 1
pawn	Miserables.txt 1
pawnbroker	Miserables.txt 1
pawned	Miserables.txt 2
pawnshop	Miserables.txt 1
paws	Miserables.txt 13
pay	Miserables.txt 98
payait	Miserables.txt 1
payer	Miserables.txt 1
paying	Miserables.txt 17
payment	Miserables.txt 4
payments	Miserables.txt 4
pays	Miserables.txt 7
peace	Miserables.txt 88
peaceable	Miserables.txt 12
peaceably	Miserables.txt 3
peaceful	Miserables.txt 16
peacefully	Miserables.txt 2
peacefulness	Miserables.txt 1
peach	Miserables.txt 2
peak	Miserables.txt 3
peaked	Miserables.txt 2
peal	Miserables.txt 9
pealing	Miserables.txt 1
peals	Miserables.txt 5
pear	Miserables.txt 7
pearl	Miserables.txt 5
pearls	Miserables.txt 8
pears	Miserables.txt 3
peas	Miserables.txt 2
peasant	Miserables.txt 57
peasants	Miserables.txt 19
peau	Miserables.txt 1
pebble	Miserables.txt 5
pebbles	Miserables.txt 2
pebbly	Miserables.txt 1
peccavi	Miserables.txt 1
pechmeja	Miserables.txt 1
peck	Miserables.txt 2
pecked	Miserables.txt 1
pecking	Miserables.txt 1
pecks	Miserables.txt 1
pectoral	Miserables.txt 1
peculiar	Miserables.txt 70
peculiarities	Miserables.txt 9
peculiarity	Miserables.txt 19
peculiarly	Miserables.txt 6
pedagogue	Miserables.txt 1
pedant	Miserables.txt 3
pedantic	Miserables.txt 1
pedantry	Miserables.txt 2
pedants	Miserables.txt 1
pedasus	Miserables.txt 1
peddlers	Miserables.txt 1
pedestal	Miserables.txt 5
pedestals	Miserables.txt 1
pedestrian	Miserables.txt 5
pedestrians	Miserables.txt 6
pediment	Miserables.txt 4
pedler	Miserables.txt 3
pedlers	Miserables.txt 2
peel	Miserables.txt 1
peeled	Miserables.txt 1
peeling	Miserables.txt 1
peep	Miserables.txt 9
peeped	Miserables.txt 7
peepers	Miserables.txt 4
peeping	Miserables.txt 1
peeps	Miserables.txt 1
peer	Miserables.txt 10
peerage	Miserables.txt 5
peered	Miserables.txt 1
peering	Miserables.txt 1
peers	Miserables.txt 7
peevish	Miserables.txt 4
peg	Miserables.txt 1
pegasi	Miserables.txt 1
pegre	Miserables.txt 4
pegrenne	Miserables.txt 1
peine	Miserables.txt 2
pekin	Miserables.txt 1
pekins	Miserables.txt 1
pelagie	Miserables.txt 1
pelagius	Miserables.txt 2
pelicier	Miserables.txt 1
pelion	Miserables.txt 1
pelisse	Miserables.txt 3
pell	Miserables.txt 18
pellet	Miserables.txt 3
pelligrini	Miserables.txt 1
pen	Miserables.txt 34
penal	Miserables.txt 13
penalties	Miserables.txt 2
penalty	Miserables.txt 15
penance	Miserables.txt 2
pencil	Miserables.txt 9
pencilled	Miserables.txt 2
pend	Miserables.txt 1
pendant	Miserables.txt 6
pendent	Miserables.txt 2
pending	Miserables.txt 2
pendit	Miserables.txt 1
pendu	Miserables.txt 1
pendulous	Miserables.txt 1
pendulum	Miserables.txt 4
pene	Miserables.txt 1
penetrable	Miserables.txt 1
penetrate	Miserables.txt 16
penetrated	Miserables.txt 29
penetrates	Miserables.txt 6
penetrating	Miserables.txt 14
penetration	Miserables.txt 7
penguins	Miserables.txt 1
penitence	Miserables.txt 2
penitent	Miserables.txt 1
penitentiaries	Miserables.txt 1
penitentiary	Miserables.txt 1
penitents	Miserables.txt 1
penknife	Miserables.txt 1
penned	Miserables.txt 7
penniless	Miserables.txt 2
penning	Miserables.txt 1
penny	Miserables.txt 11
pens	Miserables.txt 3
pension	Miserables.txt 3
pensive	Miserables.txt 16
penthouse	Miserables.txt 3
penumbra	Miserables.txt 2
penury	Miserables.txt 1
people	Miserables.txt 474
peopled	Miserables.txt 3
peoples	Miserables.txt 23
pepin	Miserables.txt 2
pepiniere	Miserables.txt 2
pepita	Miserables.txt 1
pepper	Miserables.txt 2
peppery	Miserables.txt 1
per	Miserables.txt 11
perambulating	Miserables.txt 1
perceive	Miserables.txt 40
perceived	Miserables.txt 121
perceives	Miserables.txt 7
perceiving	Miserables.txt 22
perceptible	Miserables.txt 10
perception	Miserables.txt 3
perceptions	Miserables.txt 3
perchance	Miserables.txt 14
perche	Miserables.txt 1
perched	Miserables.txt 3
perchloride	Miserables.txt 1
percosius	Miserables.txt 1
perdas	Miserables.txt 1
perde	Miserables.txt 1
perdition	Miserables.txt 2
perdu	Miserables.txt 2
pere	Miserables.txt 11
peremptory	Miserables.txt 2
peres	Miserables.txt 2
perfect	Miserables.txt 35
perfected	Miserables.txt 2
perfecting	Miserables.txt 1
perfection	Miserables.txt 8
perfections	Miserables.txt 2
perfectly	Miserables.txt 77
perfidious	Miserables.txt 2
perforating	Miserables.txt 1
perform	Miserables.txt 8
performance	Miserables.txt 1
performances	Miserables.txt 4
performed	Miserables.txt 24
performing	Miserables.txt 7
performs	Miserables.txt 1
perfroschinum	Miserables.txt 1
perfume	Miserables.txt 17
perfumed	Miserables.txt 6
perfumes	Miserables.txt 7
perfuming	Miserables.txt 1
perhaps	Miserables.txt 149
pericles	Miserables.txt 1
perier	Miserables.txt 3
perigord	Miserables.txt 1
perigueux	Miserables.txt 1
peril	Miserables.txt 28
perilous	Miserables.txt 7
perilously	Miserables.txt 1
perils	Miserables.txt 3
period	Miserables.txt 28
periodic	Miserables.txt 1
periodical	Miserables.txt 3
periods	Miserables.txt 1
periphrase	Miserables.txt 1
perish	Miserables.txt 8
perished	Miserables.txt 3
perishes	Miserables.txt 2
perishing	Miserables.txt 1
peristyles	Miserables.txt 1
perle	Miserables.txt 1
permanent	Miserables.txt 7
permanently	Miserables.txt 1
permeate	Miserables.txt 1
permeated	Miserables.txt 9
permeates	Miserables.txt 1
permissible	Miserables.txt 7
permission	Miserables.txt 38
permit	Miserables.txt 34
permits	Miserables.txt 7
permitted	Miserables.txt 52
permitting	Miserables.txt 1
pernicious	Miserables.txt 1
perpendicular	Miserables.txt 8
perpendicularly	Miserables.txt 3
perpetrated	Miserables.txt 2
perpetration	Miserables.txt 1
perpetua	Miserables.txt 1
perpetual	Miserables.txt 19
perpetually	Miserables.txt 4
perpetuating	Miserables.txt 1
perpetue	Miserables.txt 5
perpetuity	Miserables.txt 1
perplexed	Miserables.txt 4
perplexity	Miserables.txt 4
perponcher	Miserables.txt 1
perquisites	Miserables.txt 2
perrault	Miserables.txt 2
perrette	Miserables.txt 1
perronet	Miserables.txt 1
persecute	Miserables.txt 2
persecuted	Miserables.txt 2
persecution	Miserables.txt 4
persecutions	Miserables.txt 1
perseverance	Miserables.txt 6
perseveranter	Miserables.txt 1
persevere	Miserables.txt 2
persia	Miserables.txt 1
persian	Miserables.txt 2
persist	Miserables.txt 10
persisted	Miserables.txt 12
persistence	Miserables.txt 4
persistency	Miserables.txt 1
persistent	Miserables.txt 3
persists	Miserables.txt 6
person	Miserables.txt 216
personage	Miserables.txt 21
personages	Miserables.txt 7
personal	Miserables.txt 20
personalities	Miserables.txt 1
personality	Miserables.txt 6
personally	Miserables.txt 2
personification	Miserables.txt 1
personified	Miserables.txt 3
persons	Miserables.txt 66
perspective	Miserables.txt 9
perspectives	Miserables.txt 2
perspicacity	Miserables.txt 2
perspiration	Miserables.txt 17
perspiring	Miserables.txt 2
persuade	Miserables.txt 3
persuaded	Miserables.txt 3
persuading	Miserables.txt 1
persuasive	Miserables.txt 1
pertaining	Miserables.txt 1
perturbed	Miserables.txt 1
perturbing	Miserables.txt 1
peruke	Miserables.txt 1
perusal	Miserables.txt 3
peruse	Miserables.txt 7
perused	Miserables.txt 5
perusing	Miserables.txt 3
perverse	Miserables.txt 1
perversity	Miserables.txt 2
pest	Miserables.txt 3
pesth	Miserables.txt 1
pestiferous	Miserables.txt 2
pestilence	Miserables.txt 1
pestilences	Miserables.txt 1
pestilential	Miserables.txt 1
pests	Miserables.txt 1
pet	Miserables.txt 3
petals	Miserables.txt 1
petard	Miserables.txt 2
peteghem	Miserables.txt 1
peter	Miserables.txt 4
petersburg	Miserables.txt 1
petit	Miserables.txt 75
petite	Miserables.txt 13
petites	Miserables.txt 1
petition	Miserables.txt 6
petits	Miserables.txt 4
petram	Miserables.txt 1
petrarch	Miserables.txt 1
petrels	Miserables.txt 1
petrified	Miserables.txt 18
petrus	Miserables.txt 1
petticoat	Miserables.txt 25
petticoats	Miserables.txt 7
pettifogger	Miserables.txt 3
pettifogging	Miserables.txt 3
pettiness	Miserables.txt 6
pettinesses	Miserables.txt 1
petto	Miserables.txt 1
petty	Miserables.txt 39
peu	Miserables.txt 2
peuh	Miserables.txt 1
peuple	Miserables.txt 1
peut	Miserables.txt 1
peux	Miserables.txt 1
pew	Miserables.txt 1
pewter	Miserables.txt 7
pg	Miserables.txt 1
pglaf	Miserables.txt 8
phalanx	Miserables.txt 1
phalasar	Miserables.txt 1
phantasmagoria	Miserables.txt 1
phantasmagories	Miserables.txt 2
phantom	Miserables.txt 25
phantoms	Miserables.txt 16
pharmacopolae	Miserables.txt 1
pharmacy	Miserables.txt 1
pharos	Miserables.txt 1
phase	Miserables.txt 15
phases	Miserables.txt 12
phenomena	Miserables.txt 2
phenomenal	Miserables.txt 1
phenomenon	Miserables.txt 16
phew	Miserables.txt 2
phial	Miserables.txt 2
phials	Miserables.txt 3
philanthropist	Miserables.txt 10
philemon	Miserables.txt 1
philetas	Miserables.txt 1
philibert	Miserables.txt 1
philiberts	Miserables.txt 1
philintus	Miserables.txt 1
philip	Miserables.txt 3
philippe	Miserables.txt 41
philippeaux	Miserables.txt 1
philippes	Miserables.txt 1
philippi	Miserables.txt 1
philological	Miserables.txt 1
philologist	Miserables.txt 1
philosophe	Miserables.txt 1
philosopher	Miserables.txt 19
philosophers	Miserables.txt 18
philosophical	Miserables.txt 10
philosophically	Miserables.txt 1
philosophies	Miserables.txt 4
philosophy	Miserables.txt 56
phiz	Miserables.txt 2
phlegmatic	Miserables.txt 2
phocian	Miserables.txt 1
phocion	Miserables.txt 2
phoebe	Miserables.txt 1
phoebus	Miserables.txt 1
phoedromus	Miserables.txt 1
phoenician	Miserables.txt 2
phosphorescence	Miserables.txt 1
phosphorescent	Miserables.txt 1
phosphoric	Miserables.txt 2
phrase	Miserables.txt 27
phrases	Miserables.txt 9
phrenologist	Miserables.txt 2
phrygian	Miserables.txt 1
phthisis	Miserables.txt 3
phyles	Miserables.txt 1
phyllis	Miserables.txt 1
physical	Miserables.txt 10
physically	Miserables.txt 1
physician	Miserables.txt 10
physicians	Miserables.txt 1
physicked	Miserables.txt 1
physiocrates	Miserables.txt 1
physiognomist	Miserables.txt 3
physiognomy	Miserables.txt 19
physiologist	Miserables.txt 4
physiology	Miserables.txt 1
piano	Miserables.txt 3
pibroch	Miserables.txt 2
picard	Miserables.txt 6
picardy	Miserables.txt 2
picareria	Miserables.txt 1
pick	Miserables.txt 27
pickaxe	Miserables.txt 5
pickaxes	Miserables.txt 1
picked	Miserables.txt 53
picker	Miserables.txt 11
pickers	Miserables.txt 3
picking	Miserables.txt 5
pickings	Miserables.txt 1
pickpocket	Miserables.txt 6
pickpockets	Miserables.txt 2
picks	Miserables.txt 2
picpus	Miserables.txt 60
picquigny	Miserables.txt 1
picton	Miserables.txt 4
picture	Miserables.txt 26
pictured	Miserables.txt 2
pictures	Miserables.txt 6
picturesque	Miserables.txt 3
pidytes	Miserables.txt 1
pie	Miserables.txt 1
piece	Miserables.txt 140
pieces	Miserables.txt 33
piedmont	Miserables.txt 1
pieds	Miserables.txt 1
pier	Miserables.txt 4
pierce	Miserables.txt 8
pierced	Miserables.txt 31
pierces	Miserables.txt 1
piercing	Miserables.txt 16
piernas	Miserables.txt 1
pierre	Miserables.txt 14
pierron	Miserables.txt 4
pierrot	Miserables.txt 2
pierrots	Miserables.txt 1
piesse	Miserables.txt 2
piet	Miserables.txt 1
pieties	Miserables.txt 1
pietonne	Miserables.txt 1
piety	Miserables.txt 4
pig	Miserables.txt 4
pigault	Miserables.txt 2
pigeon	Miserables.txt 2
pigeons	Miserables.txt 1
pigmy	Miserables.txt 1
pigritia	Miserables.txt 1
pike	Miserables.txt 8
pikes	Miserables.txt 4
pilasters	Miserables.txt 1
pilate	Miserables.txt 1
pilche	Miserables.txt 1
pilcher	Miserables.txt 1
pile	Miserables.txt 32
piled	Miserables.txt 10
piles	Miserables.txt 10
pilfering	Miserables.txt 2
piling	Miserables.txt 1
pillage	Miserables.txt 5
pillaged	Miserables.txt 4
pillaging	Miserables.txt 2
pillar	Miserables.txt 6
pillars	Miserables.txt 5
pillow	Miserables.txt 18
pilorge	Miserables.txt 1
pilot	Miserables.txt 1
pin	Miserables.txt 9
pincers	Miserables.txt 11
pinch	Miserables.txt 5
pinchbeck	Miserables.txt 1
pinched	Miserables.txt 4
pinches	Miserables.txt 1
pindaric	Miserables.txt 1
pine	Miserables.txt 4
pined	Miserables.txt 1
pinioned	Miserables.txt 12
pink	Miserables.txt 16
pinnace	Miserables.txt 2
pins	Miserables.txt 3
pinson	Miserables.txt 1
pint	Miserables.txt 2
pioneers	Miserables.txt 1
pious	Miserables.txt 6
piously	Miserables.txt 1
pipe	Miserables.txt 20
pipes	Miserables.txt 9
pips	Miserables.txt 1
piquais	Miserables.txt 1
pique	Miserables.txt 1
piqued	Miserables.txt 2
piques	Miserables.txt 1
piraeus	Miserables.txt 2
pirates	Miserables.txt 1
pirch	Miserables.txt 2
pire	Miserables.txt 1
piron	Miserables.txt 1
pirouette	Miserables.txt 3
pisa	Miserables.txt 1
pisacane	Miserables.txt 2
pisistratus	Miserables.txt 1
pissevache	Miserables.txt 1
pissot	Miserables.txt 1
pistol	Miserables.txt 59
pistoles	Miserables.txt 4
pistols	Miserables.txt 21
pit	Miserables.txt 3
pitch	Miserables.txt 10
pitched	Miserables.txt 1
pitcher	Miserables.txt 1
pitchers	Miserables.txt 1
pitfall	Miserables.txt 1
pith	Miserables.txt 1
pitiable	Miserables.txt 1
pitied	Miserables.txt 6
pitiful	Miserables.txt 3
pitiless	Miserables.txt 16
pitilessly	Miserables.txt 2
pits	Miserables.txt 2
pitt	Miserables.txt 1
pity	Miserables.txt 64
pius	Miserables.txt 2
pivot	Miserables.txt 4
placard	Miserables.txt 1
placarded	Miserables.txt 1
placards	Miserables.txt 1
place	Miserables.txt 430
placed	Miserables.txt 149
places	Miserables.txt 49
placest	Miserables.txt 1
placid	Miserables.txt 1
placidity	Miserables.txt 3
placing	Miserables.txt 7
plagiarist	Miserables.txt 1
plague	Miserables.txt 7
plaids	Miserables.txt 1
plain	Miserables.txt 56
plainly	Miserables.txt 15
plains	Miserables.txt 7
plaintain	Miserables.txt 1
plaintive	Miserables.txt 9
plait	Miserables.txt 1
plaits	Miserables.txt 2
plan	Miserables.txt 24
plancenoit	Miserables.txt 8
planche	Miserables.txt 2
planchette	Miserables.txt 3
plane	Miserables.txt 12
planesium	Miserables.txt 1
planet	Miserables.txt 8
planets	Miserables.txt 3
plank	Miserables.txt 14
planked	Miserables.txt 1
planks	Miserables.txt 22
planned	Miserables.txt 5
plans	Miserables.txt 9
plant	Miserables.txt 13
plantain	Miserables.txt 1
plantation	Miserables.txt 1
plantavit	Miserables.txt 1
planted	Miserables.txt 19
plantes	Miserables.txt 13
planting	Miserables.txt 2
plants	Miserables.txt 14
plaque	Miserables.txt 4
plaques	Miserables.txt 1
plaster	Miserables.txt 23
plastered	Miserables.txt 2
plastering	Miserables.txt 2
plastron	Miserables.txt 1
plat	Miserables.txt 1
plate	Miserables.txt 12
plateau	Miserables.txt 24
plates	Miserables.txt 12
platform	Miserables.txt 4
plating	Miserables.txt 1
platitudes	Miserables.txt 2
plato	Miserables.txt 2
platon	Miserables.txt 1
platoon	Miserables.txt 6
platoons	Miserables.txt 2
platre	Miserables.txt 1
platriere	Miserables.txt 2
platter	Miserables.txt 5
platters	Miserables.txt 1
plautus	Miserables.txt 3
play	Miserables.txt 67
played	Miserables.txt 39
player	Miserables.txt 2
players	Miserables.txt 1
playfulness	Miserables.txt 3
playing	Miserables.txt 26
plays	Miserables.txt 12
plaything	Miserables.txt 3
playthings	Miserables.txt 3
playwright	Miserables.txt 2
plea	Miserables.txt 2
pleaders	Miserables.txt 1
pleading	Miserables.txt 1
pleasant	Miserables.txt 3
pleasantly	Miserables.txt 1
pleasantries	Miserables.txt 2
pleasantry	Miserables.txt 3
please	Miserables.txt 50
pleased	Miserables.txt 34
pleases	Miserables.txt 11
pleasing	Miserables.txt 5
pleasure	Miserables.txt 37
pleasures	Miserables.txt 8
plebeian	Miserables.txt 2
plebeians	Miserables.txt 1
pledged	Miserables.txt 2
pleiad	Miserables.txt 2
pleignier	Miserables.txt 1
pleins	Miserables.txt 1
plena	Miserables.txt 1
plenitude	Miserables.txt 8
plentiful	Miserables.txt 1
plenty	Miserables.txt 7
plethoras	Miserables.txt 1
plied	Miserables.txt 1
plinth	Miserables.txt 1
pliny	Miserables.txt 1
plis	Miserables.txt 1
plombes	Miserables.txt 1
plot	Miserables.txt 16
plots	Miserables.txt 4
plotted	Miserables.txt 4
plotting	Miserables.txt 2
plough	Miserables.txt 2
ploughed	Miserables.txt 1
ploughing	Miserables.txt 1
pluck	Miserables.txt 7
plucked	Miserables.txt 5
plucking	Miserables.txt 4
plucks	Miserables.txt 1
plug	Miserables.txt 1
plugged	Miserables.txt 1
plum	Miserables.txt 1
plumage	Miserables.txt 2
plume	Miserables.txt 3
plumes	Miserables.txt 3
plumet	Miserables.txt 57
plummet	Miserables.txt 2
plummets	Miserables.txt 1
plump	Miserables.txt 6
plunder	Miserables.txt 3
plundered	Miserables.txt 2
plundering	Miserables.txt 1
plunge	Miserables.txt 8
plunged	Miserables.txt 44
plunges	Miserables.txt 2
plunging	Miserables.txt 3
plural	Miserables.txt 2
pluribus	Miserables.txt 1
plus	Miserables.txt 11
plush	Miserables.txt 3
plutarch	Miserables.txt 1
plutarque	Miserables.txt 19
pluviose	Miserables.txt 1
ply	Miserables.txt 3
plying	Miserables.txt 2
poacher	Miserables.txt 7
poachers	Miserables.txt 1
pocket	Miserables.txt 129
pocketbook	Miserables.txt 5
pocketed	Miserables.txt 2
pocketing	Miserables.txt 1
pockets	Miserables.txt 33
pocula	Miserables.txt 1
poecilus	Miserables.txt 1
poem	Miserables.txt 4
poems	Miserables.txt 1
poet	Miserables.txt 14
poetic	Miserables.txt 1
poetical	Miserables.txt 1
poetry	Miserables.txt 14
poets	Miserables.txt 9
pogonatus	Miserables.txt 1
poichevert	Miserables.txt 1
poignant	Miserables.txt 17
poignarded	Miserables.txt 1
poignards	Miserables.txt 1
poincot	Miserables.txt 1
point	Miserables.txt 348
pointe	Miserables.txt 1
pointed	Miserables.txt 52
pointer	Miserables.txt 1
pointing	Miserables.txt 14
points	Miserables.txt 50
pointu	Miserables.txt 1
poiree	Miserables.txt 1
poirees	Miserables.txt 1
poirier	Miserables.txt 1
poison	Miserables.txt 7
poisoned	Miserables.txt 1
poisoner	Miserables.txt 1
poisoners	Miserables.txt 1
poisoning	Miserables.txt 1
poisonous	Miserables.txt 1
poisson	Miserables.txt 1
poissonniere	Miserables.txt 1
poissy	Miserables.txt 1
poitevin	Miserables.txt 1
poitiers	Miserables.txt 3
poked	Miserables.txt 1
pol	Miserables.txt 5
poland	Miserables.txt 8
polarization	Miserables.txt 2
pole	Miserables.txt 18
polecat	Miserables.txt 1
polemics	Miserables.txt 1
poles	Miserables.txt 5
police	Miserables.txt 201
policeman	Miserables.txt 9
policemen	Miserables.txt 8
policy	Miserables.txt 3
polignac	Miserables.txt 3
polish	Miserables.txt 2
polished	Miserables.txt 16
polite	Miserables.txt 5
politely	Miserables.txt 1
politeness	Miserables.txt 5
politenesses	Miserables.txt 1
political	Miserables.txt 46
politically	Miserables.txt 1
politician	Miserables.txt 1
politicians	Miserables.txt 4
politics	Miserables.txt 21
poliveau	Miserables.txt 1
pollarded	Miserables.txt 1
pollux	Miserables.txt 1
pologne	Miserables.txt 1
polonceau	Miserables.txt 19
polonois	Miserables.txt 1
poltroon	Miserables.txt 1
poltroons	Miserables.txt 1
polybius	Miserables.txt 1
polyborus	Miserables.txt 1
polydamas	Miserables.txt 2
polymnia	Miserables.txt 1
polynices	Miserables.txt 1
polyp	Miserables.txt 3
polypaetes	Miserables.txt 1
polyphemus	Miserables.txt 1
polypus	Miserables.txt 2
polytechnic	Miserables.txt 4
polytechnique	Miserables.txt 1
pomaded	Miserables.txt 1
pomme	Miserables.txt 1
pommerci	Miserables.txt 1
pomona	Miserables.txt 1
pomp	Miserables.txt 3
pompadour	Miserables.txt 1
pompeius	Miserables.txt 1
pompey	Miserables.txt 1
pompierry	Miserables.txt 1
pon	Miserables.txt 1
ponceau	Miserables.txt 3
ponder	Miserables.txt 1
pondered	Miserables.txt 3
pondering	Miserables.txt 2
ponds	Miserables.txt 4
poniard	Miserables.txt 1
ponine	Miserables.txt 5
ponsonby	Miserables.txt 5
pont	Miserables.txt 28
pontarlier	Miserables.txt 8
pontiff	Miserables.txt 1
pontifical	Miserables.txt 3
pontifically	Miserables.txt 2
pontius	Miserables.txt 1
pontmarie	Miserables.txt 1
pontmercy	Miserables.txt 93
pontoise	Miserables.txt 10
pontoon	Miserables.txt 1
pontoons	Miserables.txt 1
ponts	Miserables.txt 1
poodle	Miserables.txt 1
pool	Miserables.txt 21
pools	Miserables.txt 6
poor	Miserables.txt 299
poorer	Miserables.txt 4
poorly	Miserables.txt 5
pope	Miserables.txt 15
popes	Miserables.txt 1
popincourt	Miserables.txt 4
poplar	Miserables.txt 1
poplars	Miserables.txt 2
poppets	Miserables.txt 1
poppies	Miserables.txt 3
poppy	Miserables.txt 1
populace	Miserables.txt 37
populaces	Miserables.txt 1
populaire	Miserables.txt 1
popular	Miserables.txt 30
popularity	Miserables.txt 5
populated	Miserables.txt 1
population	Miserables.txt 11
poquelin	Miserables.txt 1
porcelain	Miserables.txt 4
porch	Miserables.txt 1
porcherons	Miserables.txt 1
porches	Miserables.txt 1
porcupine	Miserables.txt 1
porea	Miserables.txt 1
poret	Miserables.txt 1
pork	Miserables.txt 1
porous	Miserables.txt 2
porphyry	Miserables.txt 1
porque	Miserables.txt 1
porrichinelle	Miserables.txt 2
port	Miserables.txt 11
portal	Miserables.txt 2
portals	Miserables.txt 6
porte	Miserables.txt 29
portecochere	Miserables.txt 1
portentous	Miserables.txt 1
porter	Miserables.txt 87
porters	Miserables.txt 9
portes	Miserables.txt 2
portfolio	Miserables.txt 2
portfolios	Miserables.txt 1
porthole	Miserables.txt 1
porticos	Miserables.txt 1
portion	Miserables.txt 24
portioned	Miserables.txt 1
portions	Miserables.txt 2
portmanteau	Miserables.txt 1
portrait	Miserables.txt 17
portraits	Miserables.txt 8
portress	Miserables.txt 37
portresses	Miserables.txt 5
ports	Miserables.txt 4
portugal	Miserables.txt 1
poses	Miserables.txt 2
position	Miserables.txt 36
positions	Miserables.txt 3
positive	Miserables.txt 5
positively	Miserables.txt 5
positiveness	Miserables.txt 1
possess	Miserables.txt 35
possessed	Miserables.txt 65
possesses	Miserables.txt 27
possessing	Miserables.txt 11
possession	Miserables.txt 63
possessions	Miserables.txt 1
possessor	Miserables.txt 1
possibilities	Miserables.txt 3
possibility	Miserables.txt 15
possible	Miserables.txt 181
possibly	Miserables.txt 43
post	Miserables.txt 108
postboy	Miserables.txt 1
poste	Miserables.txt 1
posted	Miserables.txt 21
poster	Miserables.txt 5
posterior	Miserables.txt 1
posterity	Miserables.txt 1
postern	Miserables.txt 1
posters	Miserables.txt 4
postes	Miserables.txt 4
postilion	Miserables.txt 12
postilions	Miserables.txt 1
posting	Miserables.txt 12
postman	Miserables.txt 2
postmegorum	Miserables.txt 1
postmen	Miserables.txt 1
postponed	Miserables.txt 1
postponing	Miserables.txt 2
posts	Miserables.txt 16
postscript	Miserables.txt 1
postscriptum	Miserables.txt 1
postulant	Miserables.txt 1
postulants	Miserables.txt 2
postulatore	Miserables.txt 1
posture	Miserables.txt 10
postures	Miserables.txt 1
pot	Miserables.txt 36
potains	Miserables.txt 1
potato	Miserables.txt 1
potatoes	Miserables.txt 5
poteau	Miserables.txt 1
potent	Miserables.txt 1
poterie	Miserables.txt 1
potestas	Miserables.txt 2
potier	Miserables.txt 3
potion	Miserables.txt 7
potions	Miserables.txt 1
potpourri	Miserables.txt 2
pots	Miserables.txt 9
potsdam	Miserables.txt 1
potsherd	Miserables.txt 2
potsherds	Miserables.txt 1
potter	Miserables.txt 1
potteries	Miserables.txt 1
potters	Miserables.txt 1
pottery	Miserables.txt 2
pouches	Miserables.txt 1
pouf	Miserables.txt 1
poulailler	Miserables.txt 2
poule	Miserables.txt 1
poultry	Miserables.txt 3
pound	Miserables.txt 3
pounded	Miserables.txt 1
pounder	Miserables.txt 1
pounders	Miserables.txt 1
pounding	Miserables.txt 1
pounds	Miserables.txt 4
pour	Miserables.txt 16
poured	Miserables.txt 13
pouring	Miserables.txt 6
pourrait	Miserables.txt 1
pourree	Miserables.txt 1
pours	Miserables.txt 1
poussagrive	Miserables.txt 1
pousselevent	Miserables.txt 1
pout	Miserables.txt 4
pouted	Miserables.txt 2
poutrain	Miserables.txt 3
poverty	Miserables.txt 32
powder	Miserables.txt 42
powdered	Miserables.txt 7
powders	Miserables.txt 1
power	Miserables.txt 81
powerful	Miserables.txt 29
powerfully	Miserables.txt 2
powerless	Miserables.txt 1
powers	Miserables.txt 10
pox	Miserables.txt 1
practicable	Miserables.txt 3
practical	Miserables.txt 6
practically	Miserables.txt 1
practice	Miserables.txt 10
practices	Miserables.txt 3
practise	Miserables.txt 5
practised	Miserables.txt 4
practises	Miserables.txt 1
practising	Miserables.txt 2
practitioners	Miserables.txt 2
pradeaux	Miserables.txt 1
prado	Miserables.txt 2
prairial	Miserables.txt 1
praise	Miserables.txt 2
praised	Miserables.txt 5
praises	Miserables.txt 1
praiseworthy	Miserables.txt 1
prancing	Miserables.txt 1
pranks	Miserables.txt 3
pratest	Miserables.txt 1
prating	Miserables.txt 1
pratiquez	Miserables.txt 1
prattle	Miserables.txt 5
prattles	Miserables.txt 1
pray	Miserables.txt 21
prayed	Miserables.txt 4
prayer	Miserables.txt 38
prayers	Miserables.txt 21
praying	Miserables.txt 12
prays	Miserables.txt 2
pre	Miserables.txt 3
preach	Miserables.txt 1
preached	Miserables.txt 5
preacher	Miserables.txt 6
preaches	Miserables.txt 2
preaching	Miserables.txt 3
preachy	Miserables.txt 2
preameneu	Miserables.txt 1
prebends	Miserables.txt 2
precaution	Miserables.txt 19
precautions	Miserables.txt 16
precede	Miserables.txt 2
preceded	Miserables.txt 10
precedence	Miserables.txt 3
precedes	Miserables.txt 8
preceding	Miserables.txt 62
precentor	Miserables.txt 1
precentors	Miserables.txt 6
preceptor	Miserables.txt 2
precepts	Miserables.txt 1
precheurs	Miserables.txt 11
precieuses	Miserables.txt 1
precious	Miserables.txt 18
precipice	Miserables.txt 12
precipices	Miserables.txt 9
precipitate	Miserables.txt 3
precipitated	Miserables.txt 7
precipitately	Miserables.txt 7
precipitates	Miserables.txt 2
precipitating	Miserables.txt 3
precipitation	Miserables.txt 4
precise	Miserables.txt 17
precisely	Miserables.txt 47
precision	Miserables.txt 6
preclude	Miserables.txt 3
precursor	Miserables.txt 1
predecessor	Miserables.txt 2
predestination	Miserables.txt 1
predestinations	Miserables.txt 1
predestined	Miserables.txt 7
predicament	Miserables.txt 4
predict	Miserables.txt 1
predicted	Miserables.txt 1
predominated	Miserables.txt 2
predominates	Miserables.txt 3
preen	Miserables.txt 1
preface	Miserables.txt 1
prefect	Miserables.txt 22
prefects	Miserables.txt 2
prefecture	Miserables.txt 31
prefer	Miserables.txt 23
preferable	Miserables.txt 1
preference	Miserables.txt 4
preferred	Miserables.txt 23
preferring	Miserables.txt 6
prefers	Miserables.txt 2
prefet	Miserables.txt 2
prefete	Miserables.txt 1
prehendit	Miserables.txt 1
prejudging	Miserables.txt 1
prejudice	Miserables.txt 3
prejudices	Miserables.txt 16
prelate	Miserables.txt 2
prelates	Miserables.txt 1
preliminary	Miserables.txt 3
prelude	Miserables.txt 1
premature	Miserables.txt 1
prematurely	Miserables.txt 3
premeditate	Miserables.txt 1
premeditated	Miserables.txt 2
premeditation	Miserables.txt 3
premiere	Miserables.txt 1
premises	Miserables.txt 2
premonitory	Miserables.txt 1
prenais	Miserables.txt 1
prenant	Miserables.txt 1
prenard	Miserables.txt 1
prenomens	Miserables.txt 1
preoccupation	Miserables.txt 9
preoccupations	Miserables.txt 5
preoccupied	Miserables.txt 9
preoccupy	Miserables.txt 1
preparation	Miserables.txt 19
preparations	Miserables.txt 4
preparatory	Miserables.txt 4
prepare	Miserables.txt 12
prepared	Miserables.txt 22
prepares	Miserables.txt 1
preparing	Miserables.txt 8
prepossessing	Miserables.txt 1
pres	Miserables.txt 5
presbytery	Miserables.txt 1
prescribed	Miserables.txt 4
prescription	Miserables.txt 1
presence	Miserables.txt 141
present	Miserables.txt 134
presentation	Miserables.txt 2
presented	Miserables.txt 79
presentiment	Miserables.txt 3
presenting	Miserables.txt 8
presently	Miserables.txt 10
presents	Miserables.txt 18
preservation	Miserables.txt 6
preservative	Miserables.txt 2
preserve	Miserables.txt 20
preserved	Miserables.txt 35
preserves	Miserables.txt 4
preserving	Miserables.txt 5
preside	Miserables.txt 1
presided	Miserables.txt 4
presidency	Miserables.txt 1
president	Miserables.txt 46
presidente	Miserables.txt 1
presidentess	Miserables.txt 1
presides	Miserables.txt 2
presiding	Miserables.txt 1
press	Miserables.txt 13
pressant	Miserables.txt 1
pressed	Miserables.txt 29
presses	Miserables.txt 1
pressing	Miserables.txt 13
pressure	Miserables.txt 14
prestige	Miserables.txt 2
presume	Miserables.txt 1
presumption	Miserables.txt 1
presumptions	Miserables.txt 2
presupposes	Miserables.txt 2
prete	Miserables.txt 1
pretence	Miserables.txt 1
pretend	Miserables.txt 6
pretended	Miserables.txt 9
pretending	Miserables.txt 1
pretends	Miserables.txt 2
pretension	Miserables.txt 1
pretensions	Miserables.txt 4
pretext	Miserables.txt 13
pretious	Miserables.txt 1
pretot	Miserables.txt 1
pretres	Miserables.txt 1
prettier	Miserables.txt 3
prettiest	Miserables.txt 4
prettily	Miserables.txt 4
pretty	Miserables.txt 98
prevail	Miserables.txt 1
prevailed	Miserables.txt 2
prevailing	Miserables.txt 1
prevalent	Miserables.txt 1
prevent	Miserables.txt 57
prevented	Miserables.txt 10
prevention	Miserables.txt 1
prevents	Miserables.txt 5
previous	Miserables.txt 14
previously	Miserables.txt 29
prey	Miserables.txt 30
preyed	Miserables.txt 1
priapus	Miserables.txt 2
price	Miserables.txt 16
prices	Miserables.txt 2
prick	Miserables.txt 3
pricked	Miserables.txt 2
pricking	Miserables.txt 2
pricks	Miserables.txt 2
pride	Miserables.txt 22
prie	Miserables.txt 4
pried	Miserables.txt 1
priest	Miserables.txt 69
priesthood	Miserables.txt 4
priestly	Miserables.txt 1
priests	Miserables.txt 19
prig	Miserables.txt 1
prigged	Miserables.txt 2
prim	Miserables.txt 1
primary	Miserables.txt 1
prime	Miserables.txt 5
primed	Miserables.txt 2
primitive	Miserables.txt 4
primum	Miserables.txt 1
prince	Miserables.txt 40
princely	Miserables.txt 1
princes	Miserables.txt 13
princess	Miserables.txt 2
princesse	Miserables.txt 2
principal	Miserables.txt 46
principle	Miserables.txt 15
principles	Miserables.txt 20
pringle	Miserables.txt 1
print	Miserables.txt 2
printanier	Miserables.txt 8
printed	Miserables.txt 15
printemps	Miserables.txt 1
printer	Miserables.txt 4
printers	Miserables.txt 2
printing	Miserables.txt 8
prints	Miserables.txt 2
prior	Miserables.txt 2
prioress	Miserables.txt 60
prioresses	Miserables.txt 1
priori	Miserables.txt 2
priority	Miserables.txt 1
priors	Miserables.txt 1
pris	Miserables.txt 1
prison	Miserables.txt 83
prisoner	Miserables.txt 82
prisoners	Miserables.txt 25
prisons	Miserables.txt 14
pritchard	Miserables.txt 2
private	Miserables.txt 28
privately	Miserables.txt 1
privation	Miserables.txt 2
privations	Miserables.txt 3
privies	Miserables.txt 1
privilege	Miserables.txt 8
privileged	Miserables.txt 4
privileges	Miserables.txt 3
priviliged	Miserables.txt 1
privy	Miserables.txt 1
prize	Miserables.txt 6
prizes	Miserables.txt 2
pro	Miserables.txt 1
probability	Miserables.txt 6
probable	Miserables.txt 36
probably	Miserables.txt 114
probalinthus	Miserables.txt 1
probe	Miserables.txt 2
probes	Miserables.txt 1
probing	Miserables.txt 1
probity	Miserables.txt 14
problem	Miserables.txt 26
problems	Miserables.txt 16
procedure	Miserables.txt 3
proceed	Miserables.txt 30
proceeded	Miserables.txt 36
proceeding	Miserables.txt 23
proceedings	Miserables.txt 3
proceeds	Miserables.txt 11
process	Miserables.txt 29
processes	Miserables.txt 2
processing	Miserables.txt 1
procession	Miserables.txt 20
proclaim	Miserables.txt 1
proclaimed	Miserables.txt 5
proclaims	Miserables.txt 1
proclamation	Miserables.txt 4
proclamations	Miserables.txt 5
procopius	Miserables.txt 1
procure	Miserables.txt 7
procured	Miserables.txt 7
procuress	Miserables.txt 1
procuring	Miserables.txt 6
prodigal	Miserables.txt 13
prodigality	Miserables.txt 3
prodigies	Miserables.txt 3
prodigious	Miserables.txt 20
prodigiously	Miserables.txt 2
prodigy	Miserables.txt 8
produce	Miserables.txt 33
produced	Miserables.txt 92
produces	Miserables.txt 25
producing	Miserables.txt 4
product	Miserables.txt 7
production	Miserables.txt 6
productive	Miserables.txt 2
products	Miserables.txt 5
profanation	Miserables.txt 2
profane	Miserables.txt 5
profaned	Miserables.txt 1
professed	Miserables.txt 5
profession	Miserables.txt 14
professional	Miserables.txt 3
professions	Miserables.txt 2
professor	Miserables.txt 9
professors	Miserables.txt 2
proficient	Miserables.txt 1
profile	Miserables.txt 21
profiles	Miserables.txt 7
profit	Miserables.txt 20
profitable	Miserables.txt 1
profited	Miserables.txt 8
profiting	Miserables.txt 3
profits	Miserables.txt 3
profonds	Miserables.txt 1
profound	Miserables.txt 111
profoundly	Miserables.txt 23
profundis	Miserables.txt 3
profundities	Miserables.txt 1
profundity	Miserables.txt 3
prognosticator	Miserables.txt 1
programme	Miserables.txt 4
progress	Miserables.txt 101
progressed	Miserables.txt 1
progresses	Miserables.txt 1
progressing	Miserables.txt 2
progression	Miserables.txt 2
progressively	Miserables.txt 1
prohibited	Miserables.txt 3
prohibition	Miserables.txt 2
prohibitions	Miserables.txt 1
project	Miserables.txt 92
projected	Miserables.txt 9
projectile	Miserables.txt 7
projectiles	Miserables.txt 9
projecting	Miserables.txt 3
projection	Miserables.txt 3
projections	Miserables.txt 2
projects	Miserables.txt 7
proletarian	Miserables.txt 1
proletariat	Miserables.txt 1
prologue	Miserables.txt 1
prolong	Miserables.txt 1
prolongation	Miserables.txt 5
prolonged	Miserables.txt 11
prolongs	Miserables.txt 1
promenade	Miserables.txt 10
promenader	Miserables.txt 1
promenaders	Miserables.txt 1
promenades	Miserables.txt 1
promethean	Miserables.txt 1
prometheus	Miserables.txt 4
prominent	Miserables.txt 10
prominently	Miserables.txt 2
promiscuousness	Miserables.txt 3
promise	Miserables.txt 21
promised	Miserables.txt 22
promises	Miserables.txt 2
promising	Miserables.txt 2
promontories	Miserables.txt 2
promontory	Miserables.txt 3
promoted	Miserables.txt 2
promoting	Miserables.txt 2
promotion	Miserables.txt 2
promotions	Miserables.txt 1
prompt	Miserables.txt 10
prompte	Miserables.txt 1
prompter	Miserables.txt 1
promptitude	Miserables.txt 1
promptly	Miserables.txt 11
prompts	Miserables.txt 1
promulgate	Miserables.txt 1
promulgated	Miserables.txt 1
promulgating	Miserables.txt 1
promulgation	Miserables.txt 1
prone	Miserables.txt 5
pronounce	Miserables.txt 11
pronounced	Miserables.txt 61
pronounces	Miserables.txt 1
pronouncing	Miserables.txt 4
pronunciation	Miserables.txt 5
proof	Miserables.txt 20
proofread	Miserables.txt 1
proofs	Miserables.txt 14
prop	Miserables.txt 2
propelled	Miserables.txt 1
proper	Miserables.txt 25
properantem	Miserables.txt 1
properly	Miserables.txt 15
property	Miserables.txt 36
prophecy	Miserables.txt 1
prophet	Miserables.txt 4
prophetic	Miserables.txt 2
propitious	Miserables.txt 5
proportion	Miserables.txt 31
proportioned	Miserables.txt 5
proportioning	Miserables.txt 1
proportions	Miserables.txt 3
propos	Miserables.txt 1
proposals	Miserables.txt 1
propose	Miserables.txt 2
proposed	Miserables.txt 8
proposition	Miserables.txt 1
propositions	Miserables.txt 1
propounded	Miserables.txt 1
propped	Miserables.txt 2
proprietary	Miserables.txt 1
proprieties	Miserables.txt 1
proprietor	Miserables.txt 10
proprietors	Miserables.txt 4
proprietress	Miserables.txt 2
props	Miserables.txt 1
propulsions	Miserables.txt 1
prosaic	Miserables.txt 1
proscribe	Miserables.txt 1
proscribed	Miserables.txt 3
prose	Miserables.txt 6
prosecute	Miserables.txt 1
prosecuted	Miserables.txt 1
prosecuting	Miserables.txt 2
prosecution	Miserables.txt 3
prosecutions	Miserables.txt 1
prosecutor	Miserables.txt 5
proselytism	Miserables.txt 1
prosequi	Miserables.txt 1
prosiness	Miserables.txt 1
prospect	Miserables.txt 1
prospectus	Miserables.txt 1
prospectuses	Miserables.txt 1
prosper	Miserables.txt 4
prospered	Miserables.txt 1
prosperity	Miserables.txt 12
prosperous	Miserables.txt 2
prostitute	Miserables.txt 3
prostituted	Miserables.txt 1
prostitution	Miserables.txt 11
prostrate	Miserables.txt 8
prostrated	Miserables.txt 1
prostrates	Miserables.txt 2
prostrating	Miserables.txt 2
prostration	Miserables.txt 2
protect	Miserables.txt 7
protected	Miserables.txt 13
protecting	Miserables.txt 3
protection	Miserables.txt 9
protector	Miserables.txt 8
protects	Miserables.txt 3
proteges	Miserables.txt 1
protest	Miserables.txt 20
protestant	Miserables.txt 1
protestation	Miserables.txt 2
protestations	Miserables.txt 1
protested	Miserables.txt 1
protests	Miserables.txt 4
proteus	Miserables.txt 1
prothonotaries	Miserables.txt 1
prototype	Miserables.txt 1
prototypes	Miserables.txt 1
protracted	Miserables.txt 2
protruding	Miserables.txt 1
proud	Miserables.txt 18
prouder	Miserables.txt 1
proudly	Miserables.txt 5
prouvaire	Miserables.txt 31
prouvaires	Miserables.txt 2
prove	Miserables.txt 32
proved	Miserables.txt 26
provencal	Miserables.txt 2
provence	Miserables.txt 2
proverb	Miserables.txt 1
proverbial	Miserables.txt 2
proves	Miserables.txt 3
provide	Miserables.txt 11
provided	Miserables.txt 43
providence	Miserables.txt 44
providential	Miserables.txt 8
providing	Miserables.txt 4
province	Miserables.txt 7
provinces	Miserables.txt 8
provincial	Miserables.txt 8
proving	Miserables.txt 4
provision	Miserables.txt 3
provisional	Miserables.txt 5
provisionally	Miserables.txt 1
provisions	Miserables.txt 7
provoked	Miserables.txt 3
provokes	Miserables.txt 1
provoking	Miserables.txt 1
provost	Miserables.txt 2
provostship	Miserables.txt 1
prowess	Miserables.txt 2
prowl	Miserables.txt 3
prowled	Miserables.txt 3
prowler	Miserables.txt 15
prowlers	Miserables.txt 8
prowling	Miserables.txt 9
prowls	Miserables.txt 1
proximity	Miserables.txt 3
prude	Miserables.txt 5
prudence	Miserables.txt 15
prudent	Miserables.txt 7
prudery	Miserables.txt 3
prudes	Miserables.txt 1
prudhomme	Miserables.txt 4
prudhommes	Miserables.txt 2
prune	Miserables.txt 1
prunelle	Miserables.txt 1
pruner	Miserables.txt 9
pruning	Miserables.txt 2
prusias	Miserables.txt 1
prussia	Miserables.txt 5
prussian	Miserables.txt 13
prussians	Miserables.txt 7
prying	Miserables.txt 2
prytaneum	Miserables.txt 1
psalm	Miserables.txt 2
psalmodies	Miserables.txt 2
psalmody	Miserables.txt 1
psalms	Miserables.txt 1
pseudonym	Miserables.txt 1
pseudonyme	Miserables.txt 1
pssst	Miserables.txt 1
psyche	Miserables.txt 2
psychological	Miserables.txt 1
pterigybranche	Miserables.txt 1
ptolemais	Miserables.txt 1
pttt	Miserables.txt 1
public	Miserables.txt 132
publication	Miserables.txt 2
publications	Miserables.txt 1
publicist	Miserables.txt 1
publicly	Miserables.txt 3
publish	Miserables.txt 3
published	Miserables.txt 10
publisher	Miserables.txt 3
publishers	Miserables.txt 2
publishing	Miserables.txt 4
puce	Miserables.txt 1
pudding	Miserables.txt 3
puddle	Miserables.txt 2
puerile	Miserables.txt 7
puerilely	Miserables.txt 1
puerilities	Miserables.txt 1
puerte	Miserables.txt 1
puff	Miserables.txt 3
puffed	Miserables.txt 3
puffing	Miserables.txt 1
puffs	Miserables.txt 5
puget	Miserables.txt 3
pugilism	Miserables.txt 1
pugilist	Miserables.txt 1
puits	Miserables.txt 1
puking	Miserables.txt 1
pull	Miserables.txt 6
pulled	Miserables.txt 41
puller	Miserables.txt 1
pulley	Miserables.txt 3
pulling	Miserables.txt 7
pulpit	Miserables.txt 3
pulse	Miserables.txt 8
pulseless	Miserables.txt 1
pulvere	Miserables.txt 1
pulverize	Miserables.txt 1
pulverized	Miserables.txt 1
pumping	Miserables.txt 1
pun	Miserables.txt 7
punch	Miserables.txt 2
punchinello	Miserables.txt 3
punctually	Miserables.txt 2
punctuate	Miserables.txt 1
punic	Miserables.txt 1
punish	Miserables.txt 2
punishable	Miserables.txt 1
punished	Miserables.txt 15
punishing	Miserables.txt 1
punishment	Miserables.txt 10
punishments	Miserables.txt 3
punit	Miserables.txt 1
punitive	Miserables.txt 1
punning	Miserables.txt 1
puns	Miserables.txt 7
puny	Miserables.txt 6
pupil	Miserables.txt 11
pupils	Miserables.txt 22
purchase	Miserables.txt 9
purchased	Miserables.txt 17
purchaser	Miserables.txt 1
purchasers	Miserables.txt 2
purchases	Miserables.txt 6
purchasing	Miserables.txt 3
pure	Miserables.txt 57
purely	Miserables.txt 11
purer	Miserables.txt 1
purest	Miserables.txt 2
purge	Miserables.txt 1
purify	Miserables.txt 2
purist	Miserables.txt 1
puritan	Miserables.txt 1
purities	Miserables.txt 1
purity	Miserables.txt 13
purloin	Miserables.txt 2
purple	Miserables.txt 23
purpose	Miserables.txt 58
purposely	Miserables.txt 1
purposes	Miserables.txt 3
purse	Miserables.txt 31
pursed	Miserables.txt 1
purses	Miserables.txt 5
pursuance	Miserables.txt 2
pursue	Miserables.txt 6
pursued	Miserables.txt 36
pursuer	Miserables.txt 1
pursuers	Miserables.txt 1
pursues	Miserables.txt 4
pursuing	Miserables.txt 8
pursuit	Miserables.txt 8
pursuits	Miserables.txt 1
pursy	Miserables.txt 1
purveyor	Miserables.txt 1
pus	Miserables.txt 1
push	Miserables.txt 14
pushed	Miserables.txt 37
pushes	Miserables.txt 2
pushing	Miserables.txt 8
pustules	Miserables.txt 1
pustulous	Miserables.txt 1
put	Miserables.txt 284
puteaux	Miserables.txt 1
putrefaction	Miserables.txt 1
putrescence	Miserables.txt 2
putrid	Miserables.txt 1
puts	Miserables.txt 14
putting	Miserables.txt 30
putty	Miserables.txt 1
puy	Miserables.txt 2
puyraveau	Miserables.txt 1
puysegur	Miserables.txt 1
puzzle	Miserables.txt 3
puzzled	Miserables.txt 5
puzzling	Miserables.txt 1
pydna	Miserables.txt 1
pygmalion	Miserables.txt 1
pygmy	Miserables.txt 2
pylades	Miserables.txt 4
pyramid	Miserables.txt 4
pyramidal	Miserables.txt 1
pyramids	Miserables.txt 3
pyramus	Miserables.txt 1
pyrenees	Miserables.txt 4
pyrotechnics	Miserables.txt 1
pyrrhon	Miserables.txt 1
