m	Miserables.txt 971
ma	Miserables.txt 27
mabeuf	Miserables.txt 95
mabile	Miserables.txt 1
mabillon	Miserables.txt 1
mac	Miserables.txt 4
macaroons	Miserables.txt 1
macbeth	Miserables.txt 1
maccabees	Miserables.txt 1
macchi	Miserables.txt 1
macchiavelli	Miserables.txt 1
macerations	Miserables.txt 1
machiavelli	Miserables.txt 3
machinations	Miserables.txt 1
machine	Miserables.txt 15
machineel	Miserables.txt 1
machines	Miserables.txt 5
mack	Miserables.txt 2
mad	Miserables.txt 44
madam	Miserables.txt 12
madame	Miserables.txt 257
made	Miserables.txt 788
madeira	Miserables.txt 1
madeleine	Miserables.txt 284
madelonettes	Miserables.txt 6
mademoiselle	Miserables.txt 112
madly	Miserables.txt 3
madman	Miserables.txt 4
madness	Miserables.txt 14
madras	Miserables.txt 1
madrepore	Miserables.txt 2
madrid	Miserables.txt 3
maelstrom	Miserables.txt 1
maenads	Miserables.txt 1
maevius	Miserables.txt 1
magaera	Miserables.txt 1
magazine	Miserables.txt 1
magi	Miserables.txt 1
magic	Miserables.txt 7
magical	Miserables.txt 2
magician	Miserables.txt 1
magicians	Miserables.txt 1
magimel	Miserables.txt 1
magisterial	Miserables.txt 2
magistracy	Miserables.txt 5
magistrate	Miserables.txt 15
magistrates	Miserables.txt 3
magloire	Miserables.txt 77
magnanimities	Miserables.txt 1
magnanimity	Miserables.txt 2
magnanimous	Miserables.txt 4
magnates	Miserables.txt 1
magnet	Miserables.txt 1
magnetic	Miserables.txt 5
magnetism	Miserables.txt 1
magnificence	Miserables.txt 7
magnificences	Miserables.txt 1
magnificent	Miserables.txt 53
magnificently	Miserables.txt 1
magnified	Miserables.txt 1
magnify	Miserables.txt 1
magnifying	Miserables.txt 1
magnon	Miserables.txt 30
magnons	Miserables.txt 1
magnus	Miserables.txt 1
magny	Miserables.txt 1
mahogany	Miserables.txt 5
mahomet	Miserables.txt 2
mahometanism	Miserables.txt 1
mahoney	Miserables.txt 1
mai	Miserables.txt 2
maid	Miserables.txt 20
maiden	Miserables.txt 5
maidenliness	Miserables.txt 1
maidens	Miserables.txt 2
maids	Miserables.txt 6
mail	Miserables.txt 13
maillard	Miserables.txt 2
maillotins	Miserables.txt 1
main	Miserables.txt 12
maine	Miserables.txt 12
maintain	Miserables.txt 5
maintained	Miserables.txt 7
maintaining	Miserables.txt 2
maintains	Miserables.txt 2
maintenance	Miserables.txt 1
maior	Miserables.txt 1
maire	Miserables.txt 59
mais	Miserables.txt 4
maison	Miserables.txt 1
maistre	Miserables.txt 3
maitland	Miserables.txt 3
maitre	Miserables.txt 5
majestic	Miserables.txt 10
majestically	Miserables.txt 6
majesty	Miserables.txt 38
majo	Miserables.txt 1
major	Miserables.txt 4
majore	Miserables.txt 1
majorities	Miserables.txt 1
majority	Miserables.txt 14
make	Miserables.txt 370
maker	Miserables.txt 14
makers	Miserables.txt 5
makes	Miserables.txt 109
making	Miserables.txt 145
mal	Miserables.txt 1
malade	Miserables.txt 2
maladies	Miserables.txt 9
malady	Miserables.txt 19
malaquais	Miserables.txt 2
malarme	Miserables.txt 1
malbrouck	Miserables.txt 1
male	Miserables.txt 8
malebranche	Miserables.txt 2
malediction	Miserables.txt 4
malefactor	Miserables.txt 5
malefactors	Miserables.txt 7
malek	Miserables.txt 1
males	Miserables.txt 1
malevolent	Miserables.txt 1
malfilatre	Miserables.txt 1
malher	Miserables.txt 1
malheur	Miserables.txt 1
malheurs	Miserables.txt 1
malice	Miserables.txt 7
malicious	Miserables.txt 21
malignant	Miserables.txt 1
mallet	Miserables.txt 1
malplaquet	Miserables.txt 2
malta	Miserables.txt 3
malteses	Miserables.txt 1
malure	Miserables.txt 1
malvoisie	Miserables.txt 1
mam	Miserables.txt 1
maman	Miserables.txt 1
mame	Miserables.txt 9
mamemoiselle	Miserables.txt 1
mamma	Miserables.txt 6
mammas	Miserables.txt 1
mammiferous	Miserables.txt 1
mammoths	Miserables.txt 1
mamselle	Miserables.txt 11
man	Miserables.txt 2003
manage	Miserables.txt 19
managed	Miserables.txt 15
manager	Miserables.txt 2
manages	Miserables.txt 1
manchon	Miserables.txt 1
mandar	Miserables.txt 1
mandate	Miserables.txt 2
mande	Miserables.txt 1
mandrin	Miserables.txt 1
mane	Miserables.txt 2
manezingues	Miserables.txt 1
mange	Miserables.txt 1
mangedentelle	Miserables.txt 1
manger	Miserables.txt 2
manhood	Miserables.txt 3
mania	Miserables.txt 2
maniacal	Miserables.txt 1
manibus	Miserables.txt 1
manifest	Miserables.txt 2
manifestations	Miserables.txt 1
manifested	Miserables.txt 1
manifesting	Miserables.txt 1
manifests	Miserables.txt 1
manifold	Miserables.txt 1
manikin	Miserables.txt 2
manin	Miserables.txt 1
manipulated	Miserables.txt 1
manipulating	Miserables.txt 1
manipulation	Miserables.txt 3
mankind	Miserables.txt 4
manliness	Miserables.txt 1
manly	Miserables.txt 6
manner	Miserables.txt 163
manners	Miserables.txt 20
mannikin	Miserables.txt 1
manoeuvre	Miserables.txt 5
manoeuvres	Miserables.txt 7
manoeuvring	Miserables.txt 1
manon	Miserables.txt 1
manor	Miserables.txt 3
manosque	Miserables.txt 1
manou	Miserables.txt 1
mans	Miserables.txt 1
mansard	Miserables.txt 4
mansion	Miserables.txt 1
manslaughterers	Miserables.txt 1
manteaux	Miserables.txt 5
mantelet	Miserables.txt 1
mantes	Miserables.txt 1
mantillas	Miserables.txt 1
mantilles	Miserables.txt 1
mantle	Miserables.txt 12
mantles	Miserables.txt 1
mantua	Miserables.txt 4
manuals	Miserables.txt 1
manuel	Miserables.txt 4
manufactories	Miserables.txt 1
manufactory	Miserables.txt 1
manufacture	Miserables.txt 8
manufactured	Miserables.txt 1
manufacturer	Miserables.txt 6
manufacturers	Miserables.txt 1
manufacturing	Miserables.txt 1
manure	Miserables.txt 10
manuscript	Miserables.txt 10
manuscripts	Miserables.txt 3
manutianis	Miserables.txt 1
many	Miserables.txt 236
map	Miserables.txt 6
mar	Miserables.txt 2
marabouts	Miserables.txt 1
marais	Miserables.txt 16
marat	Miserables.txt 12
maraude	Miserables.txt 2
marauder	Miserables.txt 3
marauders	Miserables.txt 3
marauding	Miserables.txt 4
marble	Miserables.txt 33
marbles	Miserables.txt 2
marceau	Miserables.txt 10
marcel	Miserables.txt 3
march	Miserables.txt 74
marchand	Miserables.txt 1
marchands	Miserables.txt 1
marchangy	Miserables.txt 2
marche	Miserables.txt 7
marched	Miserables.txt 14
marches	Miserables.txt 3
marchiennes	Miserables.txt 1
marching	Miserables.txt 12
marcian	Miserables.txt 1
marcognet	Miserables.txt 2
marcos	Miserables.txt 1
marcus	Miserables.txt 2
mardi	Miserables.txt 1
mardigras	Miserables.txt 1
mardis	Miserables.txt 1
mardisoir	Miserables.txt 1
mare	Miserables.txt 2
marechal	Miserables.txt 1
marechale	Miserables.txt 1
marengo	Miserables.txt 13
margaret	Miserables.txt 1
margaric	Miserables.txt 1
margin	Miserables.txt 7
margoton	Miserables.txt 1
marguerite	Miserables.txt 16
marguerites	Miserables.txt 1
maria	Miserables.txt 3
mariage	Miserables.txt 1
marie	Miserables.txt 12
maries	Miserables.txt 1
mariette	Miserables.txt 1
marignan	Miserables.txt 1
marigny	Miserables.txt 2
marine	Miserables.txt 5
mariner	Miserables.txt 1
mariners	Miserables.txt 1
marines	Miserables.txt 1
maringo	Miserables.txt 1
marion	Miserables.txt 3
marital	Miserables.txt 1
maritime	Miserables.txt 1
marius	Miserables.txt 1373
mark	Miserables.txt 17
marked	Miserables.txt 25
market	Miserables.txt 30
marketing	Miserables.txt 1
markets	Miserables.txt 4
marking	Miserables.txt 1
marks	Miserables.txt 7
marksman	Miserables.txt 2
marksmanship	Miserables.txt 3
marl	Miserables.txt 1
marlborough	Miserables.txt 1
marly	Miserables.txt 2
marmot	Miserables.txt 3
marmousets	Miserables.txt 1
marne	Miserables.txt 5
marnix	Miserables.txt 2
marques	Miserables.txt 1
marquesa	Miserables.txt 1
marquis	Miserables.txt 25
marquisates	Miserables.txt 1
marquise	Miserables.txt 11
marquises	Miserables.txt 3
marriage	Miserables.txt 36
marriages	Miserables.txt 2
married	Miserables.txt 23
marries	Miserables.txt 1
marronne	Miserables.txt 1
marrons	Miserables.txt 1
marrow	Miserables.txt 2
marry	Miserables.txt 26
marrying	Miserables.txt 3
mars	Miserables.txt 18
marsan	Miserables.txt 1
marseillaise	Miserables.txt 7
marseillaises	Miserables.txt 1
marseilles	Miserables.txt 5
marsh	Miserables.txt 2
marshal	Miserables.txt 14
marshals	Miserables.txt 3
marshes	Miserables.txt 5
mart	Miserables.txt 1
martainville	Miserables.txt 2
martha	Miserables.txt 1
marthe	Miserables.txt 2
martin	Miserables.txt 33
martingale	Miserables.txt 3
marto	Miserables.txt 1
martyr	Miserables.txt 5
martyrdom	Miserables.txt 4
martyred	Miserables.txt 1
martyrs	Miserables.txt 7
marvel	Miserables.txt 7
marvellous	Miserables.txt 16
marvellously	Miserables.txt 1
marvels	Miserables.txt 8
mary	Miserables.txt 3
masaniello	Miserables.txt 1
mascarades	Miserables.txt 1
masculine	Miserables.txt 3
mask	Miserables.txt 27
masked	Miserables.txt 21
masker	Miserables.txt 1
maskers	Miserables.txt 14
masks	Miserables.txt 11
mason	Miserables.txt 4
masonic	Miserables.txt 1
masonry	Miserables.txt 10
masons	Miserables.txt 1
masquais	Miserables.txt 1
masquerade	Miserables.txt 1
masquerades	Miserables.txt 1
mass	Miserables.txt 72
massacre	Miserables.txt 7
massacred	Miserables.txt 1
massacres	Miserables.txt 2
massed	Miserables.txt 7
masses	Miserables.txt 28
massieu	Miserables.txt 1
massing	Miserables.txt 3
massive	Miserables.txt 13
mast	Miserables.txt 4
master	Miserables.txt 76
mastered	Miserables.txt 2
masterful	Miserables.txt 2
masterfully	Miserables.txt 1
masterly	Miserables.txt 3
masterpiece	Miserables.txt 9
masterpieces	Miserables.txt 7
masters	Miserables.txt 18
mastery	Miserables.txt 1
mastic	Miserables.txt 1
mastodon	Miserables.txt 2
mastodons	Miserables.txt 2
mastroquets	Miserables.txt 1
mat	Miserables.txt 10
matantur	Miserables.txt 1
match	Miserables.txt 6
matched	Miserables.txt 1
matches	Miserables.txt 3
matelote	Miserables.txt 14
matelotes	Miserables.txt 1
mater	Miserables.txt 1
material	Miserables.txt 26
materialism	Miserables.txt 4
materially	Miserables.txt 2
materials	Miserables.txt 2
materiaux	Miserables.txt 1
maternal	Miserables.txt 7
maternity	Miserables.txt 8
mates	Miserables.txt 1
mathan	Miserables.txt 1
mathematical	Miserables.txt 2
mathematically	Miserables.txt 3
mathematician	Miserables.txt 1
mathematics	Miserables.txt 3
mathieu	Miserables.txt 9
mathurin	Miserables.txt 2
mathurins	Miserables.txt 3
matin	Miserables.txt 4
matins	Miserables.txt 2
mats	Miserables.txt 2
matt	Miserables.txt 4
matter	Miserables.txt 195
mattered	Miserables.txt 5
matters	Miserables.txt 37
matthew	Miserables.txt 1
matting	Miserables.txt 1
mattock	Miserables.txt 7
mattress	Miserables.txt 28
mattresses	Miserables.txt 5
mature	Miserables.txt 1
maturity	Miserables.txt 1
matutinal	Miserables.txt 2
maubert	Miserables.txt 5
maubuee	Miserables.txt 4
maugout	Miserables.txt 1
maupetit	Miserables.txt 1
maur	Miserables.txt 1
maurolics	Miserables.txt 1
mauve	Miserables.txt 1
mauves	Miserables.txt 2
mavot	Miserables.txt 3
maw	Miserables.txt 7
maxim	Miserables.txt 2
maxims	Miserables.txt 1
maximum	Miserables.txt 3
may	Miserables.txt 357
mayagan	Miserables.txt 1
mayence	Miserables.txt 2
mayeux	Miserables.txt 1
mayor	Miserables.txt 120
mayoralities	Miserables.txt 1
mayoralty	Miserables.txt 3
mayors	Miserables.txt 1
mazarin	Miserables.txt 1
mazarine	Miserables.txt 1
mazas	Miserables.txt 1
mazes	Miserables.txt 1
mazet	Miserables.txt 1
me	Miserables.txt 1156
meadow	Miserables.txt 13
meadows	Miserables.txt 9
meagre	Miserables.txt 8
meal	Miserables.txt 2
meals	Miserables.txt 7
mealyback	Miserables.txt 1
mean	Miserables.txt 60
meandered	Miserables.txt 1
meaning	Miserables.txt 27
meanings	Miserables.txt 1
means	Miserables.txt 115
meant	Miserables.txt 31
meantime	Miserables.txt 53
meanwhile	Miserables.txt 40
measure	Miserables.txt 22
measured	Miserables.txt 12
measureless	Miserables.txt 1
measurement	Miserables.txt 1
measures	Miserables.txt 9
measuring	Miserables.txt 2
meat	Miserables.txt 22
meaux	Miserables.txt 16
mechanical	Miserables.txt 15
mechanically	Miserables.txt 23
mechanism	Miserables.txt 6
mechanisms	Miserables.txt 1
mechlin	Miserables.txt 3
mechtilde	Miserables.txt 3
mecistaeus	Miserables.txt 1
meck	Miserables.txt 2
medal	Miserables.txt 3
medallion	Miserables.txt 2
medallions	Miserables.txt 1
medals	Miserables.txt 1
medard	Miserables.txt 7
meddle	Miserables.txt 3
meddles	Miserables.txt 1
media	Miserables.txt 1
mediation	Miserables.txt 1
mediatorial	Miserables.txt 1
medical	Miserables.txt 5
medici	Miserables.txt 2
medicine	Miserables.txt 6
medicines	Miserables.txt 1
medine	Miserables.txt 1
mediocre	Miserables.txt 6
mediocres	Miserables.txt 1
mediocrity	Miserables.txt 2
medit	Miserables.txt 1
meditate	Miserables.txt 8
meditated	Miserables.txt 28
meditates	Miserables.txt 2
meditating	Miserables.txt 11
meditation	Miserables.txt 26
meditations	Miserables.txt 5
mediterranean	Miserables.txt 3
medium	Miserables.txt 13
mediums	Miserables.txt 1
medleys	Miserables.txt 1
medusa	Miserables.txt 2
meduse	Miserables.txt 2
meeren	Miserables.txt 1
meet	Miserables.txt 45
meeting	Miserables.txt 16
meetings	Miserables.txt 2
meets	Miserables.txt 7
meg	Miserables.txt 2
megaeras	Miserables.txt 1
meganthios	Miserables.txt 1
megaryon	Miserables.txt 1
megisserie	Miserables.txt 1
meinec	Miserables.txt 1
mela	Miserables.txt 1
melan	Miserables.txt 1
melancholy	Miserables.txt 113
melas	Miserables.txt 3
mell	Miserables.txt 18
melodies	Miserables.txt 2
melodrama	Miserables.txt 3
melodramas	Miserables.txt 1
melody	Miserables.txt 1
melon	Miserables.txt 7
melons	Miserables.txt 2
melpomene	Miserables.txt 1
melt	Miserables.txt 7
melted	Miserables.txt 7
melting	Miserables.txt 2
melts	Miserables.txt 3
melun	Miserables.txt 1
member	Miserables.txt 33
members	Miserables.txt 13
membranes	Miserables.txt 1
membranous	Miserables.txt 1
meme	Miserables.txt 6
memoir	Miserables.txt 1
memoire	Miserables.txt 1
memoirs	Miserables.txt 6
memorable	Miserables.txt 9
memorandum	Miserables.txt 3
memorial	Miserables.txt 1
memories	Miserables.txt 18
memory	Miserables.txt 63
men	Miserables.txt 615
menace	Miserables.txt 6
menaced	Miserables.txt 7
menaces	Miserables.txt 2
menacing	Miserables.txt 13
menaechmus	Miserables.txt 1
menage	Miserables.txt 1
menagerie	Miserables.txt 2
menageries	Miserables.txt 1
menais	Miserables.txt 1
menalchme	Miserables.txt 1
mend	Miserables.txt 1
mended	Miserables.txt 1
mender	Miserables.txt 12
mendiant	Miserables.txt 1
mendicant	Miserables.txt 12
mendici	Miserables.txt 1
mending	Miserables.txt 1
mendon	Miserables.txt 1
menesse	Miserables.txt 1
menetriers	Miserables.txt 1
menilmontant	Miserables.txt 9
mental	Miserables.txt 6
mentally	Miserables.txt 2
mention	Miserables.txt 25
mentioned	Miserables.txt 54
mentioning	Miserables.txt 2
mer	Miserables.txt 2
mercantile	Miserables.txt 1
merchandise	Miserables.txt 3
merchant	Miserables.txt 17
merchantibility	Miserables.txt 1
merchants	Miserables.txt 5
merci	Miserables.txt 1
mercier	Miserables.txt 1
merciere	Miserables.txt 1
merciful	Miserables.txt 1
merciless	Miserables.txt 1
mercury	Miserables.txt 1
mercy	Miserables.txt 18
merde	Miserables.txt 1
mere	Miserables.txt 21
merely	Miserables.txt 55
meres	Miserables.txt 1
merest	Miserables.txt 2
mericourt	Miserables.txt 1
merino	Miserables.txt 3
merinos	Miserables.txt 1
meriones	Miserables.txt 1
merit	Miserables.txt 7
merited	Miserables.txt 1
meritis	Miserables.txt 1
meritorious	Miserables.txt 1
merits	Miserables.txt 6
merlan	Miserables.txt 1
merle	Miserables.txt 1
merlin	Miserables.txt 1
merlonus	Miserables.txt 2
merloussiere	Miserables.txt 1
merovingian	Miserables.txt 1
merrily	Miserables.txt 10
merriment	Miserables.txt 1
merry	Miserables.txt 60
merrymaking	Miserables.txt 1
mesdames	Miserables.txt 3
mesgrigny	Miserables.txt 1
mesh	Miserables.txt 3
meshes	Miserables.txt 4
mesieres	Miserables.txt 2
mesmer	Miserables.txt 2
mess	Miserables.txt 2
message	Miserables.txt 3
messager	Miserables.txt 1
messages	Miserables.txt 2
messalina	Miserables.txt 2
messenger	Miserables.txt 5
messier	Miserables.txt 1
messieurs	Miserables.txt 3
mestienne	Miserables.txt 20
met	Miserables.txt 56
metal	Miserables.txt 2
metallic	Miserables.txt 3
metalloids	Miserables.txt 1
metals	Miserables.txt 1
metamorphosable	Miserables.txt 1
metamorphosed	Miserables.txt 2
metamorphoses	Miserables.txt 1
metamorphosis	Miserables.txt 1
metaphor	Miserables.txt 13
metaphorical	Miserables.txt 3
metaphors	Miserables.txt 5
metaphysical	Miserables.txt 1
metaphysics	Miserables.txt 1
meteor	Miserables.txt 3
meteorological	Miserables.txt 1
method	Miserables.txt 10
methodical	Miserables.txt 3
methods	Miserables.txt 4
methusalem	Miserables.txt 1
methuselah	Miserables.txt 1
metonymies	Miserables.txt 1
metre	Miserables.txt 2
metres	Miserables.txt 16
metropolis	Miserables.txt 3
mets	Miserables.txt 1
metternich	Miserables.txt 3
mettre	Miserables.txt 1
metz	Miserables.txt 1
meudon	Miserables.txt 1
meulan	Miserables.txt 1
meurice	Miserables.txt 1
meuse	Miserables.txt 1
mewed	Miserables.txt 1
mewing	Miserables.txt 1
mezzocane	Miserables.txt 1
mi	Miserables.txt 2
miasma	Miserables.txt 5
miasmas	Miserables.txt 5
miasms	Miserables.txt 2
mibray	Miserables.txt 2
mice	Miserables.txt 6
michael	Miserables.txt 8
michel	Miserables.txt 10
michelle	Miserables.txt 2
microscope	Miserables.txt 4
microscopic	Miserables.txt 3
mid	Miserables.txt 14
midday	Miserables.txt 17
middle	Miserables.txt 78
midi	Miserables.txt 1
midnight	Miserables.txt 29
midst	Miserables.txt 93
midway	Miserables.txt 5
mien	Miserables.txt 18
miens	Miserables.txt 1
mieux	Miserables.txt 3
might	Miserables.txt 339
mightier	Miserables.txt 1
mighty	Miserables.txt 8
miguel	Miserables.txt 1
mihiel	Miserables.txt 1
mila	Miserables.txt 2
milan	Miserables.txt 3
milch	Miserables.txt 1
mild	Miserables.txt 3
mildly	Miserables.txt 3
mildness	Miserables.txt 2
mile	Miserables.txt 2
miles	Miserables.txt 1
milhaud	Miserables.txt 3
miliary	Miserables.txt 2
militaire	Miserables.txt 1
militant	Miserables.txt 2
militarism	Miserables.txt 2
military	Miserables.txt 37
militia	Miserables.txt 1
milk	Miserables.txt 15
mill	Miserables.txt 7
milled	Miserables.txt 1
millepeds	Miserables.txt 3
miller	Miserables.txt 1
millet	Miserables.txt 4
millevoye	Miserables.txt 1
milliard	Miserables.txt 2
milliards	Miserables.txt 7
million	Miserables.txt 11
millionaire	Miserables.txt 6
millionaires	Miserables.txt 1
millionairess	Miserables.txt 1
millionnaire	Miserables.txt 9
millions	Miserables.txt 25
mills	Miserables.txt 3
millstone	Miserables.txt 2
millstones	Miserables.txt 1
miltiere	Miserables.txt 1
milton	Miserables.txt 3
mimae	Miserables.txt 1
mimi	Miserables.txt 1
mind	Miserables.txt 228
minded	Miserables.txt 4
mindedness	Miserables.txt 1
minds	Miserables.txt 36
mine	Miserables.txt 39
mined	Miserables.txt 1
miner	Miserables.txt 1
mineral	Miserables.txt 2
miners	Miserables.txt 7
minerva	Miserables.txt 3
minerve	Miserables.txt 2
mines	Miserables.txt 7
minette	Miserables.txt 14
mingle	Miserables.txt 11
mingled	Miserables.txt 99
mingles	Miserables.txt 8
mingling	Miserables.txt 3
miniature	Miserables.txt 1
minims	Miserables.txt 1
mining	Miserables.txt 1
minion	Miserables.txt 1
minister	Miserables.txt 26
ministers	Miserables.txt 3
ministry	Miserables.txt 5
minstrel	Miserables.txt 1
minus	Miserables.txt 8
minute	Miserables.txt 53
minuteness	Miserables.txt 2
minutes	Miserables.txt 85
miquelets	Miserables.txt 1
mirabeau	Miserables.txt 5
mirabelle	Miserables.txt 2
miracle	Miserables.txt 7
miracles	Miserables.txt 16
miracolo	Miserables.txt 1
miraculously	Miserables.txt 2
mirage	Miserables.txt 3
mirages	Miserables.txt 3
miralabi	Miserables.txt 1
mirant	Miserables.txt 1
mire	Miserables.txt 32
mirepoix	Miserables.txt 1
miring	Miserables.txt 1
mirlababo	Miserables.txt 1
mirliton	Miserables.txt 2
miroir	Miserables.txt 2
miromesnil	Miserables.txt 1
mirror	Miserables.txt 42
mirrors	Miserables.txt 6
mirth	Miserables.txt 10
mirthful	Miserables.txt 3
mis	Miserables.txt 1
misadventure	Miserables.txt 1
misalliance	Miserables.txt 1
misalliances	Miserables.txt 1
miscarriage	Miserables.txt 2
miscarried	Miserables.txt 4
miscarry	Miserables.txt 2
mischief	Miserables.txt 6
mischievous	Miserables.txt 2
misconstruction	Miserables.txt 1
miscreant	Miserables.txt 1
misdeed	Miserables.txt 1
misdeeds	Miserables.txt 2
misdemeanor	Miserables.txt 3
miser	Miserables.txt 2
miserable	Miserables.txt 37
miserables	Miserables.txt 14
misere	Miserables.txt 1
miserere	Miserables.txt 1
misericorde	Miserables.txt 1
miseries	Miserables.txt 10
misery	Miserables.txt 83
misfortune	Miserables.txt 30
misfortunes	Miserables.txt 8
misgiving	Miserables.txt 1
misinformed	Miserables.txt 1
misinterpretation	Miserables.txt 1
mislay	Miserables.txt 1
mislead	Miserables.txt 1
misled	Miserables.txt 2
miss	Miserables.txt 13
missal	Miserables.txt 1
missed	Miserables.txt 11
misserable	Miserables.txt 1
missery	Miserables.txt 1
misses	Miserables.txt 3
misshapen	Miserables.txt 15
missing	Miserables.txt 18
mission	Miserables.txt 9
missionaries	Miserables.txt 1
missions	Miserables.txt 1
mississippi	Miserables.txt 1
missives	Miserables.txt 3
missolonghi	Miserables.txt 1
missouri	Miserables.txt 1
mist	Miserables.txt 25
mistake	Miserables.txt 41
mistaken	Miserables.txt 30
mistakes	Miserables.txt 5
mistaking	Miserables.txt 1
mister	Miserables.txt 6
misteriously	Miserables.txt 1
mistletoe	Miserables.txt 1
mistook	Miserables.txt 1
mistress	Miserables.txt 34
mistresses	Miserables.txt 9
mistrust	Miserables.txt 1
mists	Miserables.txt 10
misty	Miserables.txt 2
misunderstanding	Miserables.txt 2
misunderstood	Miserables.txt 1
misused	Miserables.txt 1
mitchell	Miserables.txt 2
mite	Miserables.txt 2
mitigated	Miserables.txt 1
mitraille	Miserables.txt 1
mitre	Miserables.txt 2
mitred	Miserables.txt 1
mitres	Miserables.txt 3
mitron	Miserables.txt 1
mix	Miserables.txt 2
mixed	Miserables.txt 14
mixing	Miserables.txt 1
mixture	Miserables.txt 13
mm	Miserables.txt 2
mme	Miserables.txt 1
mo	Miserables.txt 1
moans	Miserables.txt 1
moat	Miserables.txt 3
moats	Miserables.txt 1
mob	Miserables.txt 10
mobile	Miserables.txt 1
mobs	Miserables.txt 1
mock	Miserables.txt 1
mockery	Miserables.txt 4
mocking	Miserables.txt 1
mode	Miserables.txt 15
model	Miserables.txt 6
modelled	Miserables.txt 1
modena	Miserables.txt 1
moderate	Miserables.txt 9
moderated	Miserables.txt 1
moderately	Miserables.txt 4
moderates	Miserables.txt 1
moderation	Miserables.txt 1
modern	Miserables.txt 9
moderns	Miserables.txt 1
modes	Miserables.txt 1
modest	Miserables.txt 11
modestly	Miserables.txt 1
modesty	Miserables.txt 21
modicum	Miserables.txt 2
modification	Miserables.txt 2
modifications	Miserables.txt 1
modified	Miserables.txt 6
modify	Miserables.txt 1
modiste	Miserables.txt 1
modus	Miserables.txt 1
mohammed	Miserables.txt 1
mohammedan	Miserables.txt 1
mohammedanism	Miserables.txt 1
moi	Miserables.txt 2
moineaux	Miserables.txt 1
moire	Miserables.txt 6
moires	Miserables.txt 1
mois	Miserables.txt 2
moisson	Miserables.txt 1
moist	Miserables.txt 2
moistened	Miserables.txt 2
moisture	Miserables.txt 3
mokanna	Miserables.txt 1
mole	Miserables.txt 6
molecule	Miserables.txt 1
molecules	Miserables.txt 1
molesme	Miserables.txt 1
moliere	Miserables.txt 10
momacque	Miserables.txt 1
moment	Miserables.txt 564
momentarily	Miserables.txt 3
momentary	Miserables.txt 13
moments	Miserables.txt 91
momes	Miserables.txt 1
momignard	Miserables.txt 1
momignards	Miserables.txt 1
mommol	Miserables.txt 1
mon	Miserables.txt 31
monarch	Miserables.txt 3
monarchical	Miserables.txt 6
monarchie	Miserables.txt 1
monarchies	Miserables.txt 2
monarchs	Miserables.txt 1
monarchy	Miserables.txt 29
monasteries	Miserables.txt 5
monastery	Miserables.txt 10
monastic	Miserables.txt 3
monasticism	Miserables.txt 6
monceaux	Miserables.txt 1
monday	Miserables.txt 2
monde	Miserables.txt 2
mondetour	Miserables.txt 31
money	Miserables.txt 132
moneyed	Miserables.txt 1
monger	Miserables.txt 1
moniteur	Miserables.txt 11
monk	Miserables.txt 11
monkey	Miserables.txt 4
monkeys	Miserables.txt 3
monkish	Miserables.txt 1
monks	Miserables.txt 8
monnot	Miserables.txt 1
monologue	Miserables.txt 6
monologues	Miserables.txt 3
monopoly	Miserables.txt 1
monorhymed	Miserables.txt 1
monosyllable	Miserables.txt 1
monosyllables	Miserables.txt 2
monotonies	Miserables.txt 1
monotonous	Miserables.txt 4
monseigneur	Miserables.txt 89
monsieur	Miserables.txt 369
monsignor	Miserables.txt 4
monsiuer	Miserables.txt 1
monster	Miserables.txt 41
monsters	Miserables.txt 9
monstrosities	Miserables.txt 1
monstrous	Miserables.txt 46
monstrously	Miserables.txt 1
mont	Miserables.txt 51
montals	Miserables.txt 1
montarlot	Miserables.txt 1
montauban	Miserables.txt 2
montbazon	Miserables.txt 1
montbrison	Miserables.txt 1
montcalm	Miserables.txt 1
montchenu	Miserables.txt 1
montdidier	Miserables.txt 1
monte	Miserables.txt 1
montebello	Miserables.txt 2
montenotte	Miserables.txt 2
montes	Miserables.txt 1
montesquieu	Miserables.txt 1
monteynard	Miserables.txt 1
montfaucon	Miserables.txt 2
montfermeil	Miserables.txt 76
montgomery	Miserables.txt 1
month	Miserables.txt 64
monthly	Miserables.txt 1
months	Miserables.txt 95
montmartre	Miserables.txt 8
montmatre	Miserables.txt 1
montmirail	Miserables.txt 2
montmorency	Miserables.txt 2
montorgueil	Miserables.txt 3
montparnasse	Miserables.txt 90
montpellier	Miserables.txt 1
montpercy	Miserables.txt 1
montre	Miserables.txt 2
montreuil	Miserables.txt 4
montrevel	Miserables.txt 1
montrouge	Miserables.txt 1
montvernet	Miserables.txt 1
monument	Miserables.txt 10
monumental	Miserables.txt 7
monuments	Miserables.txt 2
mood	Miserables.txt 7
moon	Miserables.txt 42
moonlight	Miserables.txt 10
moor	Miserables.txt 2
moored	Miserables.txt 3
moors	Miserables.txt 1
mopped	Miserables.txt 1
moral	Miserables.txt 32
morality	Miserables.txt 10
moralizing	Miserables.txt 2
morally	Miserables.txt 3
morals	Miserables.txt 2
morand	Miserables.txt 1
morasses	Miserables.txt 1
morbigou	Miserables.txt 1
morbleu	Miserables.txt 1
morbus	Miserables.txt 1
more	Miserables.txt 1130
moreau	Miserables.txt 1
moreover	Miserables.txt 132
moret	Miserables.txt 1
morey	Miserables.txt 1
morgue	Miserables.txt 1
morillo	Miserables.txt 2
morillos	Miserables.txt 1
morin	Miserables.txt 1
morion	Miserables.txt 1
moriturum	Miserables.txt 2
morland	Miserables.txt 3
morn	Miserables.txt 3
morning	Miserables.txt 235
morocco	Miserables.txt 2
morose	Miserables.txt 1
morrow	Miserables.txt 110
morsel	Miserables.txt 7
morsels	Miserables.txt 2
mortal	Miserables.txt 4
mortality	Miserables.txt 2
mortally	Miserables.txt 1
mortals	Miserables.txt 5
mortar	Miserables.txt 5
mortellerie	Miserables.txt 1
mortgages	Miserables.txt 1
mortgagor	Miserables.txt 1
mortier	Miserables.txt 1
mortifications	Miserables.txt 1
mortified	Miserables.txt 1
mortuary	Miserables.txt 1
mortuus	Miserables.txt 2
morvan	Miserables.txt 1
mos	Miserables.txt 1
moscow	Miserables.txt 2
moses	Miserables.txt 4
moskowa	Miserables.txt 2
mosque	Miserables.txt 2
moss	Miserables.txt 7
mosses	Miserables.txt 3
most	Miserables.txt 332
mostly	Miserables.txt 1
mot	Miserables.txt 1
moth	Miserables.txt 2
mothe	Miserables.txt 1
mother	Miserables.txt 362
mothers	Miserables.txt 45
motion	Miserables.txt 16
motioned	Miserables.txt 1
motionless	Miserables.txt 75
motive	Miserables.txt 6
motives	Miserables.txt 7
motley	Miserables.txt 1
motor	Miserables.txt 1
motors	Miserables.txt 2
motto	Miserables.txt 2
mouche	Miserables.txt 1
mouffetard	Miserables.txt 10
mould	Miserables.txt 10
moulded	Miserables.txt 4
moulding	Miserables.txt 2
mouldy	Miserables.txt 6
moulins	Miserables.txt 2
moulting	Miserables.txt 1
mound	Miserables.txt 2
mount	Miserables.txt 12
mountain	Miserables.txt 18
mountaineers	Miserables.txt 3
mountainous	Miserables.txt 2
mountains	Miserables.txt 20
mountebank	Miserables.txt 8
mountebanks	Miserables.txt 2
mounted	Miserables.txt 45
mounting	Miserables.txt 17
mounts	Miserables.txt 14
mourn	Miserables.txt 3
mourned	Miserables.txt 1
mournful	Miserables.txt 30
mournfully	Miserables.txt 5
mourning	Miserables.txt 22
mourut	Miserables.txt 1
mouse	Miserables.txt 14
mousetrap	Miserables.txt 1
mousquetaire	Miserables.txt 1
mousquetaires	Miserables.txt 1
mousqueton	Miserables.txt 1
mousson	Miserables.txt 1
moussu	Miserables.txt 1
moustache	Miserables.txt 1
moustaches	Miserables.txt 2
moutardes	Miserables.txt 1
mouth	Miserables.txt 101
mouthed	Miserables.txt 2
mouthful	Miserables.txt 4
mouthfuls	Miserables.txt 2
mouthing	Miserables.txt 1
mouths	Miserables.txt 27
moutu	Miserables.txt 1
movable	Miserables.txt 2
move	Miserables.txt 18
moved	Miserables.txt 52
movement	Miserables.txt 103
movements	Miserables.txt 26
moves	Miserables.txt 2
moving	Miserables.txt 29
mow	Miserables.txt 1
mowed	Miserables.txt 1
mower	Miserables.txt 1
mown	Miserables.txt 3
mr	Miserables.txt 53
much	Miserables.txt 328
muche	Miserables.txt 2
mud	Miserables.txt 47
muddy	Miserables.txt 10
muff	Miserables.txt 2
muffle	Miserables.txt 1
muffled	Miserables.txt 2
mufflers	Miserables.txt 1
muffling	Miserables.txt 2
mugs	Miserables.txt 1
mule	Miserables.txt 1
mules	Miserables.txt 1
muleteer	Miserables.txt 1
mulieres	Miserables.txt 1
mulleins	Miserables.txt 1
multiple	Miserables.txt 1
multiplication	Miserables.txt 2
multiplied	Miserables.txt 8
multiplies	Miserables.txt 1
multiply	Miserables.txt 6
multiplying	Miserables.txt 2
multitude	Miserables.txt 25
multitudes	Miserables.txt 6
multum	Miserables.txt 1
mumbled	Miserables.txt 3
mumbling	Miserables.txt 2
mummified	Miserables.txt 1
mummy	Miserables.txt 1
munatius	Miserables.txt 1
municipal	Miserables.txt 23
municipalities	Miserables.txt 1
municipality	Miserables.txt 2
munitions	Miserables.txt 3
munophis	Miserables.txt 1
munster	Miserables.txt 1
mur	Miserables.txt 20
mural	Miserables.txt 1
murat	Miserables.txt 2
murder	Miserables.txt 9
murdered	Miserables.txt 4
murderer	Miserables.txt 6
murderers	Miserables.txt 4
murdering	Miserables.txt 2
murders	Miserables.txt 1
murky	Miserables.txt 1
murmur	Miserables.txt 22
murmured	Miserables.txt 42
murmuring	Miserables.txt 8
murmurs	Miserables.txt 6
musain	Miserables.txt 13
musc	Miserables.txt 1
muscle	Miserables.txt 2
muscles	Miserables.txt 7
muscular	Miserables.txt 1
muse	Miserables.txt 1
musebois	Miserables.txt 1
muses	Miserables.txt 1
museum	Miserables.txt 5
mushrooms	Miserables.txt 1
music	Miserables.txt 17
musical	Miserables.txt 2
musichetta	Miserables.txt 2
musician	Miserables.txt 3
musicians	Miserables.txt 1
musing	Miserables.txt 1
musings	Miserables.txt 1
musket	Miserables.txt 7
musketeers	Miserables.txt 1
musketry	Miserables.txt 9
muskets	Miserables.txt 5
muskowa	Miserables.txt 1
muslin	Miserables.txt 4
muslins	Miserables.txt 1
musses	Miserables.txt 1
must	Miserables.txt 523
mustache	Miserables.txt 4
mustaches	Miserables.txt 6
mustards	Miserables.txt 1
mustn	Miserables.txt 2
mutations	Miserables.txt 1
mute	Miserables.txt 27
mutes	Miserables.txt 1
mutilated	Miserables.txt 2
mutilating	Miserables.txt 1
mutilation	Miserables.txt 1
mutor	Miserables.txt 1
mutter	Miserables.txt 4
muttered	Miserables.txt 25
muttering	Miserables.txt 4
mutterings	Miserables.txt 1
mutton	Miserables.txt 4
mutual	Miserables.txt 5
mutualists	Miserables.txt 1
mutually	Miserables.txt 3
muzhik	Miserables.txt 1
muzzle	Miserables.txt 9
muzzled	Miserables.txt 1
muzzles	Miserables.txt 2
my	Miserables.txt 1168
myriel	Miserables.txt 33
myrmidons	Miserables.txt 1
myrrhinus	Miserables.txt 1
myrtle	Miserables.txt 1
myself	Miserables.txt 144
mysteries	Miserables.txt 14
mysterious	Miserables.txt 120
mysteriously	Miserables.txt 1
mystery	Miserables.txt 40
mystic	Miserables.txt 1
mystical	Miserables.txt 1
mysticism	Miserables.txt 1
mystification	Miserables.txt 2
mythological	Miserables.txt 1
mythology	Miserables.txt 2
myths	Miserables.txt 1
