q	Miserables.txt 2
qu	Miserables.txt 29
quack	Miserables.txt 1
quadam	Miserables.txt 1
quadrangular	Miserables.txt 1
quadrifrons	Miserables.txt 2
quadriga	Miserables.txt 1
quadrilles	Miserables.txt 2
quadrins	Miserables.txt 1
quadruple	Miserables.txt 3
quaestor	Miserables.txt 1
quaffed	Miserables.txt 1
quagmire	Miserables.txt 12
quagmires	Miserables.txt 1
quai	Miserables.txt 17
quaint	Miserables.txt 1
quake	Miserables.txt 1
quaker	Miserables.txt 1
quaking	Miserables.txt 1
qualifications	Miserables.txt 1
qualified	Miserables.txt 2
qualities	Miserables.txt 11
quality	Miserables.txt 19
quand	Miserables.txt 10
quandry	Miserables.txt 2
quantities	Miserables.txt 3
quantity	Miserables.txt 17
quarante	Miserables.txt 1
quarantine	Miserables.txt 2
quarrel	Miserables.txt 11
quarrelled	Miserables.txt 2
quarrelling	Miserables.txt 2
quarrels	Miserables.txt 3
quarries	Miserables.txt 3
quarry	Miserables.txt 1
quarrying	Miserables.txt 1
quarte	Miserables.txt 1
quarter	Miserables.txt 125
quarterly	Miserables.txt 2
quarters	Miserables.txt 47
quartette	Miserables.txt 3
quartettes	Miserables.txt 2
quartier	Miserables.txt 10
quarto	Miserables.txt 2
quasi	Miserables.txt 6
quatrain	Miserables.txt 2
quatrains	Miserables.txt 2
quatre	Miserables.txt 5
quavering	Miserables.txt 1
quay	Miserables.txt 30
quays	Miserables.txt 8
que	Miserables.txt 24
queen	Miserables.txt 8
queens	Miserables.txt 1
queer	Miserables.txt 23
quelen	Miserables.txt 1
quelqu	Miserables.txt 1
quels	Miserables.txt 1
quenisset	Miserables.txt 2
query	Miserables.txt 2
quest	Miserables.txt 5
question	Miserables.txt 139
questionable	Miserables.txt 2
questioned	Miserables.txt 13
questioning	Miserables.txt 8
questions	Miserables.txt 57
queue	Miserables.txt 3
queyras	Miserables.txt 3
qui	Miserables.txt 10
quia	Miserables.txt 2
quibble	Miserables.txt 1
quibbles	Miserables.txt 1
quibbling	Miserables.txt 1
quibus	Miserables.txt 2
quick	Miserables.txt 19
quickly	Miserables.txt 35
quicksand	Miserables.txt 2
quicksands	Miserables.txt 2
quiconque	Miserables.txt 1
quid	Miserables.txt 7
quiet	Miserables.txt 10
quietly	Miserables.txt 5
quill	Miserables.txt 1
quilles	Miserables.txt 1
quills	Miserables.txt 4
quilted	Miserables.txt 1
quin	Miserables.txt 1
quincampois	Miserables.txt 1
quincampoix	Miserables.txt 1
quince	Miserables.txt 2
quincunx	Miserables.txt 1
quincunxes	Miserables.txt 2
quine	Miserables.txt 1
quinet	Miserables.txt 1
quintessence	Miserables.txt 1
quintuple	Miserables.txt 1
quinturions	Miserables.txt 1
quinze	Miserables.txt 1
quiot	Miserables.txt 4
quips	Miserables.txt 1
quirites	Miserables.txt 1
quirking	Miserables.txt 1
quiroga	Miserables.txt 1
quis	Miserables.txt 2
quit	Miserables.txt 12
quite	Miserables.txt 103
quits	Miserables.txt 3
quittance	Miserables.txt 1
quitted	Miserables.txt 61
quitter	Miserables.txt 1
quittez	Miserables.txt 1
quitting	Miserables.txt 11
quiver	Miserables.txt 20
quivered	Miserables.txt 9
quivering	Miserables.txt 16
quivers	Miserables.txt 7
quixote	Miserables.txt 1
quo	Miserables.txt 2
quoique	Miserables.txt 1
quot	Miserables.txt 2
quote	Miserables.txt 4
quoted	Miserables.txt 4
quotidienne	Miserables.txt 3
quoting	Miserables.txt 1
