e	NotreDame_De_Paris.txt 30
each	NotreDame_De_Paris.txt 147
eager	NotreDame_De_Paris.txt 4
eagerly	NotreDame_De_Paris.txt 8
eagerness	NotreDame_De_Paris.txt 1
eagle	NotreDame_De_Paris.txt 5
eagles	NotreDame_De_Paris.txt 1
ear	NotreDame_De_Paris.txt 40
eared	NotreDame_De_Paris.txt 1
earlier	NotreDame_De_Paris.txt 1
earliest	NotreDame_De_Paris.txt 2
earls	NotreDame_De_Paris.txt 1
early	NotreDame_De_Paris.txt 7
earn	NotreDame_De_Paris.txt 4
earned	NotreDame_De_Paris.txt 4
earnest	NotreDame_De_Paris.txt 1
earnestly	NotreDame_De_Paris.txt 1
ears	NotreDame_De_Paris.txt 27
earth	NotreDame_De_Paris.txt 44
earthenware	NotreDame_De_Paris.txt 6
earthquake	NotreDame_De_Paris.txt 1
earthworm	NotreDame_De_Paris.txt 1
earthy	NotreDame_De_Paris.txt 1
ease	NotreDame_De_Paris.txt 20
easier	NotreDame_De_Paris.txt 4
easily	NotreDame_De_Paris.txt 12
east	NotreDame_De_Paris.txt 14
easter	NotreDame_De_Paris.txt 5
eastern	NotreDame_De_Paris.txt 1
easters	NotreDame_De_Paris.txt 1
eastward	NotreDame_De_Paris.txt 1
easy	NotreDame_De_Paris.txt 16
eat	NotreDame_De_Paris.txt 17
eaten	NotreDame_De_Paris.txt 4
eating	NotreDame_De_Paris.txt 4
eats	NotreDame_De_Paris.txt 3
eau	NotreDame_De_Paris.txt 4
eaves	NotreDame_De_Paris.txt 2
ebb	NotreDame_De_Paris.txt 1
ebbing	NotreDame_De_Paris.txt 1
ebbs	NotreDame_De_Paris.txt 1
ebony	NotreDame_De_Paris.txt 1
ebook	NotreDame_De_Paris.txt 10
ebooks	NotreDame_De_Paris.txt 7
ebrietas	NotreDame_De_Paris.txt 1
ebullition	NotreDame_De_Paris.txt 1
ecce	NotreDame_De_Paris.txt 1
eccentric	NotreDame_De_Paris.txt 7
eccentrically	NotreDame_De_Paris.txt 1
ecclesiarum	NotreDame_De_Paris.txt 1
ecclesiastical	NotreDame_De_Paris.txt 14
ecclesioe	NotreDame_De_Paris.txt 2
echar	NotreDame_De_Paris.txt 1
echo	NotreDame_De_Paris.txt 5
echoing	NotreDame_De_Paris.txt 1
eclectic	NotreDame_De_Paris.txt 1
eclipse	NotreDame_De_Paris.txt 1
ecnomus	NotreDame_De_Paris.txt 1
economy	NotreDame_De_Paris.txt 1
ecouys	NotreDame_De_Paris.txt 1
ecrivans	NotreDame_De_Paris.txt 1
ecstacies	NotreDame_De_Paris.txt 1
ecstacy	NotreDame_De_Paris.txt 1
ecstasy	NotreDame_De_Paris.txt 5
ecstatic	NotreDame_De_Paris.txt 1
edacior	NotreDame_De_Paris.txt 1
edax	NotreDame_De_Paris.txt 1
eddies	NotreDame_De_Paris.txt 1
edge	NotreDame_De_Paris.txt 20
edged	NotreDame_De_Paris.txt 2
edges	NotreDame_De_Paris.txt 4
edict	NotreDame_De_Paris.txt 2
edification	NotreDame_De_Paris.txt 1
edifice	NotreDame_De_Paris.txt 67
edifices	NotreDame_De_Paris.txt 34
edified	NotreDame_De_Paris.txt 1
edition	NotreDame_De_Paris.txt 8
editions	NotreDame_De_Paris.txt 6
education	NotreDame_De_Paris.txt 2
educational	NotreDame_De_Paris.txt 1
eduensis	NotreDame_De_Paris.txt 1
edward	NotreDame_De_Paris.txt 3
eel	NotreDame_De_Paris.txt 1
efface	NotreDame_De_Paris.txt 1
effaced	NotreDame_De_Paris.txt 14
effaces	NotreDame_De_Paris.txt 2
effacing	NotreDame_De_Paris.txt 1
effect	NotreDame_De_Paris.txt 42
effected	NotreDame_De_Paris.txt 2
effecting	NotreDame_De_Paris.txt 1
effects	NotreDame_De_Paris.txt 1
effectual	NotreDame_De_Paris.txt 1
effectually	NotreDame_De_Paris.txt 1
effervescing	NotreDame_De_Paris.txt 1
effigy	NotreDame_De_Paris.txt 1
efflorescent	NotreDame_De_Paris.txt 1
effort	NotreDame_De_Paris.txt 31
efforts	NotreDame_De_Paris.txt 9
effrontery	NotreDame_De_Paris.txt 1
effrontry	NotreDame_De_Paris.txt 1
egg	NotreDame_De_Paris.txt 6
eggs	NotreDame_De_Paris.txt 1
eggshells	NotreDame_De_Paris.txt 1
egotistical	NotreDame_De_Paris.txt 1
egress	NotreDame_De_Paris.txt 1
egypt	NotreDame_De_Paris.txt 39
egyptian	NotreDame_De_Paris.txt 18
egyptians	NotreDame_De_Paris.txt 8
eh	NotreDame_De_Paris.txt 12
eheu	NotreDame_De_Paris.txt 1
ei	NotreDame_De_Paris.txt 1
eia	NotreDame_De_Paris.txt 2
eiderdown	NotreDame_De_Paris.txt 1
eight	NotreDame_De_Paris.txt 23
eighteen	NotreDame_De_Paris.txt 6
eighteenth	NotreDame_De_Paris.txt 5
eighth	NotreDame_De_Paris.txt 3
eighty	NotreDame_De_Paris.txt 5
ein	NotreDame_De_Paris.txt 1
either	NotreDame_De_Paris.txt 23
ejaculated	NotreDame_De_Paris.txt 1
eklinga	NotreDame_De_Paris.txt 2
elaborate	NotreDame_De_Paris.txt 1
elaborated	NotreDame_De_Paris.txt 1
elapsed	NotreDame_De_Paris.txt 3
elasticity	NotreDame_De_Paris.txt 1
elbow	NotreDame_De_Paris.txt 6
elbowed	NotreDame_De_Paris.txt 4
elbowing	NotreDame_De_Paris.txt 2
elbows	NotreDame_De_Paris.txt 9
elder	NotreDame_De_Paris.txt 5
eldest	NotreDame_De_Paris.txt 3
elect	NotreDame_De_Paris.txt 2
elected	NotreDame_De_Paris.txt 2
election	NotreDame_De_Paris.txt 2
elector	NotreDame_De_Paris.txt 2
electors	NotreDame_De_Paris.txt 4
electress	NotreDame_De_Paris.txt 1
electric	NotreDame_De_Paris.txt 2
electricity	NotreDame_De_Paris.txt 1
electronic	NotreDame_De_Paris.txt 27
electronically	NotreDame_De_Paris.txt 2
elegance	NotreDame_De_Paris.txt 3
elegant	NotreDame_De_Paris.txt 3
eleison	NotreDame_De_Paris.txt 2
element	NotreDame_De_Paris.txt 2
elementary	NotreDame_De_Paris.txt 1
elements	NotreDame_De_Paris.txt 1
elephant	NotreDame_De_Paris.txt 4
elephants	NotreDame_De_Paris.txt 2
elevated	NotreDame_De_Paris.txt 7
elevating	NotreDame_De_Paris.txt 1
elevation	NotreDame_De_Paris.txt 1
eleven	NotreDame_De_Paris.txt 10
eleventh	NotreDame_De_Paris.txt 5
elf	NotreDame_De_Paris.txt 1
eli	NotreDame_De_Paris.txt 1
elisabeth	NotreDame_De_Paris.txt 1
ell	NotreDame_De_Paris.txt 1
elle	NotreDame_De_Paris.txt 1
elliptical	NotreDame_De_Paris.txt 1
eloquence	NotreDame_De_Paris.txt 3
eloy	NotreDame_De_Paris.txt 1
else	NotreDame_De_Paris.txt 21
elsewhere	NotreDame_De_Paris.txt 7
elucidate	NotreDame_De_Paris.txt 1
emaciated	NotreDame_De_Paris.txt 3
emaciation	NotreDame_De_Paris.txt 1
email	NotreDame_De_Paris.txt 3
emanated	NotreDame_De_Paris.txt 2
emanation	NotreDame_De_Paris.txt 1
emancipate	NotreDame_De_Paris.txt 1
emancipated	NotreDame_De_Paris.txt 1
emancipates	NotreDame_De_Paris.txt 1
embarrass	NotreDame_De_Paris.txt 2
embarrassed	NotreDame_De_Paris.txt 7
embarrassing	NotreDame_De_Paris.txt 1
embarrassment	NotreDame_De_Paris.txt 6
embarrassments	NotreDame_De_Paris.txt 1
embas	NotreDame_De_Paris.txt 2
embassy	NotreDame_De_Paris.txt 9
embattled	NotreDame_De_Paris.txt 1
embellish	NotreDame_De_Paris.txt 1
embellished	NotreDame_De_Paris.txt 2
embellishments	NotreDame_De_Paris.txt 1
ember	NotreDame_De_Paris.txt 1
emblem	NotreDame_De_Paris.txt 2
emboldened	NotreDame_De_Paris.txt 6
embossed	NotreDame_De_Paris.txt 1
embrace	NotreDame_De_Paris.txt 4
embracing	NotreDame_De_Paris.txt 3
embrasure	NotreDame_De_Paris.txt 1
embroider	NotreDame_De_Paris.txt 1
embroidered	NotreDame_De_Paris.txt 12
embroideress	NotreDame_De_Paris.txt 1
embroideries	NotreDame_De_Paris.txt 2
embroidering	NotreDame_De_Paris.txt 1
embroidery	NotreDame_De_Paris.txt 5
emen	NotreDame_De_Paris.txt 3
emerald	NotreDame_De_Paris.txt 1
emerge	NotreDame_De_Paris.txt 4
emerged	NotreDame_De_Paris.txt 9
emerges	NotreDame_De_Paris.txt 1
emerging	NotreDame_De_Paris.txt 6
emery	NotreDame_De_Paris.txt 1
eminence	NotreDame_De_Paris.txt 21
eminent	NotreDame_De_Paris.txt 1
eminently	NotreDame_De_Paris.txt 1
emissaries	NotreDame_De_Paris.txt 1
emit	NotreDame_De_Paris.txt 1
emitting	NotreDame_De_Paris.txt 1
emotion	NotreDame_De_Paris.txt 6
emotions	NotreDame_De_Paris.txt 3
emperor	NotreDame_De_Paris.txt 14
emperors	NotreDame_De_Paris.txt 3
emphasis	NotreDame_De_Paris.txt 3
emphasized	NotreDame_De_Paris.txt 1
empire	NotreDame_De_Paris.txt 10
employ	NotreDame_De_Paris.txt 1
employed	NotreDame_De_Paris.txt 5
employee	NotreDame_De_Paris.txt 1
employees	NotreDame_De_Paris.txt 2
employing	NotreDame_De_Paris.txt 1
employment	NotreDame_De_Paris.txt 1
empowered	NotreDame_De_Paris.txt 1
empress	NotreDame_De_Paris.txt 1
emprostathonos	NotreDame_De_Paris.txt 1
emptied	NotreDame_De_Paris.txt 4
empty	NotreDame_De_Paris.txt 27
en	NotreDame_De_Paris.txt 8
enable	NotreDame_De_Paris.txt 1
enabled	NotreDame_De_Paris.txt 2
enacted	NotreDame_De_Paris.txt 2
enacting	NotreDame_De_Paris.txt 1
enamel	NotreDame_De_Paris.txt 1
enamelled	NotreDame_De_Paris.txt 1
enamels	NotreDame_De_Paris.txt 1
encased	NotreDame_De_Paris.txt 4
enchained	NotreDame_De_Paris.txt 2
enchanted	NotreDame_De_Paris.txt 5
enchanting	NotreDame_De_Paris.txt 2
enchantment	NotreDame_De_Paris.txt 2
enchantress	NotreDame_De_Paris.txt 3
enchased	NotreDame_De_Paris.txt 1
encircled	NotreDame_De_Paris.txt 4
enclose	NotreDame_De_Paris.txt 1
enclosed	NotreDame_De_Paris.txt 5
enclosure	NotreDame_De_Paris.txt 19
enclosures	NotreDame_De_Paris.txt 2
encounter	NotreDame_De_Paris.txt 1
encountered	NotreDame_De_Paris.txt 4
encountering	NotreDame_De_Paris.txt 2
encounters	NotreDame_De_Paris.txt 1
encouraged	NotreDame_De_Paris.txt 1
encouragement	NotreDame_De_Paris.txt 1
encouraging	NotreDame_De_Paris.txt 2
encroach	NotreDame_De_Paris.txt 1
encroached	NotreDame_De_Paris.txt 2
encumbered	NotreDame_De_Paris.txt 7
encyclopedia	NotreDame_De_Paris.txt 1
end	NotreDame_De_Paris.txt 106
endeavor	NotreDame_De_Paris.txt 2
endeavored	NotreDame_De_Paris.txt 5
endeavoring	NotreDame_De_Paris.txt 2
ended	NotreDame_De_Paris.txt 6
ending	NotreDame_De_Paris.txt 1
endless	NotreDame_De_Paris.txt 3
endowed	NotreDame_De_Paris.txt 3
ends	NotreDame_De_Paris.txt 7
endued	NotreDame_De_Paris.txt 1
endure	NotreDame_De_Paris.txt 1
endured	NotreDame_De_Paris.txt 4
endures	NotreDame_De_Paris.txt 1
enduring	NotreDame_De_Paris.txt 1
enemies	NotreDame_De_Paris.txt 3
enemy	NotreDame_De_Paris.txt 4
energetically	NotreDame_De_Paris.txt 2
energia	NotreDame_De_Paris.txt 1
energy	NotreDame_De_Paris.txt 1
enervated	NotreDame_De_Paris.txt 1
enfants	NotreDame_De_Paris.txt 1
enfeoffed	NotreDame_De_Paris.txt 1
enfer	NotreDame_De_Paris.txt 1
engaged	NotreDame_De_Paris.txt 9
engaging	NotreDame_De_Paris.txt 1
england	NotreDame_De_Paris.txt 4
english	NotreDame_De_Paris.txt 10
engrafting	NotreDame_De_Paris.txt 1
engraved	NotreDame_De_Paris.txt 7
engraving	NotreDame_De_Paris.txt 1
engravings	NotreDame_De_Paris.txt 2
engrossed	NotreDame_De_Paris.txt 2
enguerrand	NotreDame_De_Paris.txt 1
engulfed	NotreDame_De_Paris.txt 2
enigma	NotreDame_De_Paris.txt 1
enigmatic	NotreDame_De_Paris.txt 1
enigmatical	NotreDame_De_Paris.txt 1
enim	NotreDame_De_Paris.txt 3
enjoined	NotreDame_De_Paris.txt 2
enjoy	NotreDame_De_Paris.txt 1
enjoyed	NotreDame_De_Paris.txt 6
enjoyment	NotreDame_De_Paris.txt 2
enlighten	NotreDame_De_Paris.txt 1
enlightened	NotreDame_De_Paris.txt 1
enliven	NotreDame_De_Paris.txt 2
enlivened	NotreDame_De_Paris.txt 1
enmeshing	NotreDame_De_Paris.txt 1
enormities	NotreDame_De_Paris.txt 4
enormity	NotreDame_De_Paris.txt 2
enormous	NotreDame_De_Paris.txt 37
enough	NotreDame_De_Paris.txt 29
enraged	NotreDame_De_Paris.txt 3
enraptured	NotreDame_De_Paris.txt 1
enriched	NotreDame_De_Paris.txt 2
enrichments	NotreDame_De_Paris.txt 2
enroll	NotreDame_De_Paris.txt 1
ensconced	NotreDame_De_Paris.txt 1
ensemble	NotreDame_De_Paris.txt 1
enshrined	NotreDame_De_Paris.txt 1
enshrouded	NotreDame_De_Paris.txt 1
ensued	NotreDame_De_Paris.txt 7
ensuring	NotreDame_De_Paris.txt 1
entablature	NotreDame_De_Paris.txt 1
entablatures	NotreDame_De_Paris.txt 1
entangle	NotreDame_De_Paris.txt 1
entangled	NotreDame_De_Paris.txt 8
entangling	NotreDame_De_Paris.txt 1
enter	NotreDame_De_Paris.txt 36
entered	NotreDame_De_Paris.txt 30
entering	NotreDame_De_Paris.txt 9
enterprise	NotreDame_De_Paris.txt 2
enterprises	NotreDame_De_Paris.txt 1
enterprising	NotreDame_De_Paris.txt 1
enters	NotreDame_De_Paris.txt 4
entertain	NotreDame_De_Paris.txt 1
entertainment	NotreDame_De_Paris.txt 1
enthusiasm	NotreDame_De_Paris.txt 8
enthusiastic	NotreDame_De_Paris.txt 2
enthusiastically	NotreDame_De_Paris.txt 1
entire	NotreDame_De_Paris.txt 29
entirely	NotreDame_De_Paris.txt 14
entirety	NotreDame_De_Paris.txt 1
entity	NotreDame_De_Paris.txt 4
entr	NotreDame_De_Paris.txt 1
entrails	NotreDame_De_Paris.txt 1
entrance	NotreDame_De_Paris.txt 28
entrances	NotreDame_De_Paris.txt 2
entreat	NotreDame_De_Paris.txt 6
entreated	NotreDame_De_Paris.txt 2
entreating	NotreDame_De_Paris.txt 2
entry	NotreDame_De_Paris.txt 4
enumeration	NotreDame_De_Paris.txt 1
enunciate	NotreDame_De_Paris.txt 1
envelope	NotreDame_De_Paris.txt 9
enveloped	NotreDame_De_Paris.txt 7
enveloping	NotreDame_De_Paris.txt 1
envelops	NotreDame_De_Paris.txt 1
envenomed	NotreDame_De_Paris.txt 2
envied	NotreDame_De_Paris.txt 2
envoys	NotreDame_De_Paris.txt 4
envy	NotreDame_De_Paris.txt 3
epernay	NotreDame_De_Paris.txt 1
ephesus	NotreDame_De_Paris.txt 1
epic	NotreDame_De_Paris.txt 1
epics	NotreDame_De_Paris.txt 1
epicurius	NotreDame_De_Paris.txt 1
epidaurus	NotreDame_De_Paris.txt 1
epidermis	NotreDame_De_Paris.txt 1
epilepsy	NotreDame_De_Paris.txt 1
epiphany	NotreDame_De_Paris.txt 1
episcopal	NotreDame_De_Paris.txt 1
episcopus	NotreDame_De_Paris.txt 1
episode	NotreDame_De_Paris.txt 1
epistle	NotreDame_De_Paris.txt 1
epistolas	NotreDame_De_Paris.txt 1
epitaph	NotreDame_De_Paris.txt 2
epitaphium	NotreDame_De_Paris.txt 1
epithalamium	NotreDame_De_Paris.txt 4
epitogia	NotreDame_De_Paris.txt 1
epoch	NotreDame_De_Paris.txt 22
epochs	NotreDame_De_Paris.txt 4
equal	NotreDame_De_Paris.txt 8
equally	NotreDame_De_Paris.txt 4
equerries	NotreDame_De_Paris.txt 1
equerry	NotreDame_De_Paris.txt 4
equestrian	NotreDame_De_Paris.txt 1
equilibrium	NotreDame_De_Paris.txt 7
equinoctial	NotreDame_De_Paris.txt 1
equipment	NotreDame_De_Paris.txt 4
equitem	NotreDame_De_Paris.txt 1
equivocal	NotreDame_De_Paris.txt 1
er	NotreDame_De_Paris.txt 2
era	NotreDame_De_Paris.txt 2
eram	NotreDame_De_Paris.txt 1
erases	NotreDame_De_Paris.txt 1
erat	NotreDame_De_Paris.txt 1
erect	NotreDame_De_Paris.txt 15
erected	NotreDame_De_Paris.txt 10
erecting	NotreDame_De_Paris.txt 1
erection	NotreDame_De_Paris.txt 2
erects	NotreDame_De_Paris.txt 1
ermine	NotreDame_De_Paris.txt 2
erostatus	NotreDame_De_Paris.txt 1
erras	NotreDame_De_Paris.txt 1
error	NotreDame_De_Paris.txt 3
errors	NotreDame_De_Paris.txt 4
erudition	NotreDame_De_Paris.txt 1
eruption	NotreDame_De_Paris.txt 2
es	NotreDame_De_Paris.txt 3
escape	NotreDame_De_Paris.txt 27
escaped	NotreDame_De_Paris.txt 24
escapes	NotreDame_De_Paris.txt 4
escorcherie	NotreDame_De_Paris.txt 1
escort	NotreDame_De_Paris.txt 7
escorting	NotreDame_De_Paris.txt 1
escutcheons	NotreDame_De_Paris.txt 1
esmenarda	NotreDame_De_Paris.txt 1
esmeral	NotreDame_De_Paris.txt 1
esmeralda	NotreDame_De_Paris.txt 75
espadas	NotreDame_De_Paris.txt 1
espantar	NotreDame_De_Paris.txt 1
espars	NotreDame_De_Paris.txt 1
especially	NotreDame_De_Paris.txt 21
espied	NotreDame_De_Paris.txt 1
espying	NotreDame_De_Paris.txt 1
essarts	NotreDame_De_Paris.txt 1
essentially	NotreDame_De_Paris.txt 1
est	NotreDame_De_Paris.txt 21
establish	NotreDame_De_Paris.txt 1
established	NotreDame_De_Paris.txt 7
establishments	NotreDame_De_Paris.txt 1
estan	NotreDame_De_Paris.txt 1
esteem	NotreDame_De_Paris.txt 4
esteemed	NotreDame_De_Paris.txt 2
estellins	NotreDame_De_Paris.txt 1
estouteville	NotreDame_De_Paris.txt 13
estrade	NotreDame_De_Paris.txt 5
et	NotreDame_De_Paris.txt 34
etampes	NotreDame_De_Paris.txt 3
etc	NotreDame_De_Paris.txt 18
etching	NotreDame_De_Paris.txt 1
eternal	NotreDame_De_Paris.txt 20
eternally	NotreDame_De_Paris.txt 6
eternity	NotreDame_De_Paris.txt 5
etext	NotreDame_De_Paris.txt 1
ethiopia	NotreDame_De_Paris.txt 1
etiam	NotreDame_De_Paris.txt 1
etienne	NotreDame_De_Paris.txt 3
etoile	NotreDame_De_Paris.txt 4
etruscan	NotreDame_De_Paris.txt 2
etuelde	NotreDame_De_Paris.txt 1
eulogy	NotreDame_De_Paris.txt 2
eura	NotreDame_De_Paris.txt 1
europe	NotreDame_De_Paris.txt 7
european	NotreDame_De_Paris.txt 1
eustache	NotreDame_De_Paris.txt 20
ev	NotreDame_De_Paris.txt 5
evangelists	NotreDame_De_Paris.txt 1
evaporating	NotreDame_De_Paris.txt 1
evaporations	NotreDame_De_Paris.txt 1
eve	NotreDame_De_Paris.txt 7
even	NotreDame_De_Paris.txt 127
evening	NotreDame_De_Paris.txt 50
event	NotreDame_De_Paris.txt 2
events	NotreDame_De_Paris.txt 6
ever	NotreDame_De_Paris.txt 51
every	NotreDame_De_Paris.txt 157
everybody	NotreDame_De_Paris.txt 2
everything	NotreDame_De_Paris.txt 47
everywhere	NotreDame_De_Paris.txt 18
evident	NotreDame_De_Paris.txt 8
evidently	NotreDame_De_Paris.txt 5
evil	NotreDame_De_Paris.txt 13
evils	NotreDame_De_Paris.txt 1
evoe	NotreDame_De_Paris.txt 1
evoked	NotreDame_De_Paris.txt 2
evoking	NotreDame_De_Paris.txt 1
evolutions	NotreDame_De_Paris.txt 2
exactly	NotreDame_De_Paris.txt 4
exaggerated	NotreDame_De_Paris.txt 1
exaggerating	NotreDame_De_Paris.txt 1
exaggeration	NotreDame_De_Paris.txt 2
exaltation	NotreDame_De_Paris.txt 2
exalted	NotreDame_De_Paris.txt 1
examination	NotreDame_De_Paris.txt 5
examinations	NotreDame_De_Paris.txt 1
examine	NotreDame_De_Paris.txt 4
examined	NotreDame_De_Paris.txt 8
examiner	NotreDame_De_Paris.txt 1
examines	NotreDame_De_Paris.txt 2
examining	NotreDame_De_Paris.txt 9
example	NotreDame_De_Paris.txt 6
examples	NotreDame_De_Paris.txt 3
exasperated	NotreDame_De_Paris.txt 1
exaudisti	NotreDame_De_Paris.txt 1
excavated	NotreDame_De_Paris.txt 1
excavating	NotreDame_De_Paris.txt 1
exceed	NotreDame_De_Paris.txt 1
exceeding	NotreDame_De_Paris.txt 1
excellent	NotreDame_De_Paris.txt 9
excellently	NotreDame_De_Paris.txt 2
except	NotreDame_De_Paris.txt 31
excepted	NotreDame_De_Paris.txt 1
exception	NotreDame_De_Paris.txt 14
excepts	NotreDame_De_Paris.txt 1
excess	NotreDame_De_Paris.txt 4
excessive	NotreDame_De_Paris.txt 2
excessively	NotreDame_De_Paris.txt 1
exchange	NotreDame_De_Paris.txt 5
exchanged	NotreDame_De_Paris.txt 3
exchanging	NotreDame_De_Paris.txt 1
excitati	NotreDame_De_Paris.txt 1
excite	NotreDame_De_Paris.txt 2
excited	NotreDame_De_Paris.txt 4
exciting	NotreDame_De_Paris.txt 1
exclaim	NotreDame_De_Paris.txt 1
exclaimed	NotreDame_De_Paris.txt 87
exclaiming	NotreDame_De_Paris.txt 3
exclamation	NotreDame_De_Paris.txt 7
exclusion	NotreDame_De_Paris.txt 1
exclusive	NotreDame_De_Paris.txt 1
exclusively	NotreDame_De_Paris.txt 2
excommunicates	NotreDame_De_Paris.txt 1
excrescence	NotreDame_De_Paris.txt 1
excrescences	NotreDame_De_Paris.txt 1
excuse	NotreDame_De_Paris.txt 1
excused	NotreDame_De_Paris.txt 1
excutiendo	NotreDame_De_Paris.txt 1
execrable	NotreDame_De_Paris.txt 1
executatoe	NotreDame_De_Paris.txt 1
execute	NotreDame_De_Paris.txt 5
executed	NotreDame_De_Paris.txt 9
executes	NotreDame_De_Paris.txt 1
executing	NotreDame_De_Paris.txt 4
execution	NotreDame_De_Paris.txt 12
executioner	NotreDame_De_Paris.txt 19
executioners	NotreDame_De_Paris.txt 4
executions	NotreDame_De_Paris.txt 2
executive	NotreDame_De_Paris.txt 1
executor	NotreDame_De_Paris.txt 1
exemplary	NotreDame_De_Paris.txt 1
exempt	NotreDame_De_Paris.txt 2
exercise	NotreDame_De_Paris.txt 3
exerting	NotreDame_De_Paris.txt 1
exertions	NotreDame_De_Paris.txt 2
exeunte	NotreDame_De_Paris.txt 1
exhaled	NotreDame_De_Paris.txt 1
exhales	NotreDame_De_Paris.txt 1
exhausted	NotreDame_De_Paris.txt 9
exhaustion	NotreDame_De_Paris.txt 1
exhibited	NotreDame_De_Paris.txt 1
exhibiting	NotreDame_De_Paris.txt 1
exhilaratingly	NotreDame_De_Paris.txt 1
exigua	NotreDame_De_Paris.txt 1
exile	NotreDame_De_Paris.txt 1
exist	NotreDame_De_Paris.txt 9
existe	NotreDame_De_Paris.txt 1
existed	NotreDame_De_Paris.txt 11
existence	NotreDame_De_Paris.txt 7
existente	NotreDame_De_Paris.txt 1
existing	NotreDame_De_Paris.txt 2
exists	NotreDame_De_Paris.txt 6
exit	NotreDame_De_Paris.txt 1
exits	NotreDame_De_Paris.txt 1
exorbitant	NotreDame_De_Paris.txt 1
exorcised	NotreDame_De_Paris.txt 2
exorcisms	NotreDame_De_Paris.txt 1
exordium	NotreDame_De_Paris.txt 3
expanded	NotreDame_De_Paris.txt 2
expanding	NotreDame_De_Paris.txt 1
expanse	NotreDame_De_Paris.txt 2
expanses	NotreDame_De_Paris.txt 3
expansion	NotreDame_De_Paris.txt 2
expect	NotreDame_De_Paris.txt 2
expected	NotreDame_De_Paris.txt 4
expecting	NotreDame_De_Paris.txt 5
expedient	NotreDame_De_Paris.txt 1
expedients	NotreDame_De_Paris.txt 2
expedition	NotreDame_De_Paris.txt 1
expeditious	NotreDame_De_Paris.txt 1
expelled	NotreDame_De_Paris.txt 1
expels	NotreDame_De_Paris.txt 1
expend	NotreDame_De_Paris.txt 1
expended	NotreDame_De_Paris.txt 1
expending	NotreDame_De_Paris.txt 1
expenditure	NotreDame_De_Paris.txt 1
expends	NotreDame_De_Paris.txt 1
expense	NotreDame_De_Paris.txt 3
expenses	NotreDame_De_Paris.txt 7
experience	NotreDame_De_Paris.txt 2
experienced	NotreDame_De_Paris.txt 6
experiences	NotreDame_De_Paris.txt 2
experiments	NotreDame_De_Paris.txt 1
expert	NotreDame_De_Paris.txt 1
expiated	NotreDame_De_Paris.txt 1
expiation	NotreDame_De_Paris.txt 1
expiration	NotreDame_De_Paris.txt 5
expire	NotreDame_De_Paris.txt 2
expired	NotreDame_De_Paris.txt 3
explain	NotreDame_De_Paris.txt 15
explained	NotreDame_De_Paris.txt 6
explaining	NotreDame_De_Paris.txt 2
explains	NotreDame_De_Paris.txt 2
explanation	NotreDame_De_Paris.txt 8
explanations	NotreDame_De_Paris.txt 2
explicit	NotreDame_De_Paris.txt 1
explode	NotreDame_De_Paris.txt 1
explore	NotreDame_De_Paris.txt 1
exploring	NotreDame_De_Paris.txt 1
explosion	NotreDame_De_Paris.txt 2
explosively	NotreDame_De_Paris.txt 1
exporting	NotreDame_De_Paris.txt 1
expose	NotreDame_De_Paris.txt 2
exposed	NotreDame_De_Paris.txt 6
exposition	NotreDame_De_Paris.txt 1
exposure	NotreDame_De_Paris.txt 1
express	NotreDame_De_Paris.txt 5
expressed	NotreDame_De_Paris.txt 3
expresses	NotreDame_De_Paris.txt 6
expressing	NotreDame_De_Paris.txt 1
expression	NotreDame_De_Paris.txt 29
expressions	NotreDame_De_Paris.txt 3
expressive	NotreDame_De_Paris.txt 1
expressly	NotreDame_De_Paris.txt 6
expunged	NotreDame_De_Paris.txt 1
exquisite	NotreDame_De_Paris.txt 2
exsurge	NotreDame_De_Paris.txt 1
extant	NotreDame_De_Paris.txt 1
extended	NotreDame_De_Paris.txt 11
extending	NotreDame_De_Paris.txt 1
extends	NotreDame_De_Paris.txt 2
extensively	NotreDame_De_Paris.txt 1
extent	NotreDame_De_Paris.txt 12
exterior	NotreDame_De_Paris.txt 6
exterminate	NotreDame_De_Paris.txt 3
extermination	NotreDame_De_Paris.txt 1
external	NotreDame_De_Paris.txt 8
extinct	NotreDame_De_Paris.txt 2
extinguish	NotreDame_De_Paris.txt 1
extinguished	NotreDame_De_Paris.txt 10
extinguisher	NotreDame_De_Paris.txt 1
extirpate	NotreDame_De_Paris.txt 1
extorted	NotreDame_De_Paris.txt 1
extra	NotreDame_De_Paris.txt 1
extract	NotreDame_De_Paris.txt 4
extracted	NotreDame_De_Paris.txt 2
extracting	NotreDame_De_Paris.txt 2
extraor	NotreDame_De_Paris.txt 1
extraordinarily	NotreDame_De_Paris.txt 2
extraordinary	NotreDame_De_Paris.txt 14
extravagant	NotreDame_De_Paris.txt 2
extreme	NotreDame_De_Paris.txt 6
extremely	NotreDame_De_Paris.txt 4
extremes	NotreDame_De_Paris.txt 2
extremest	NotreDame_De_Paris.txt 1
extremities	NotreDame_De_Paris.txt 5
extremity	NotreDame_De_Paris.txt 13
extricate	NotreDame_De_Paris.txt 1
extricates	NotreDame_De_Paris.txt 1
extricating	NotreDame_De_Paris.txt 4
exultation	NotreDame_De_Paris.txt 1
eye	NotreDame_De_Paris.txt 110
eyebrow	NotreDame_De_Paris.txt 1
eyebrows	NotreDame_De_Paris.txt 2
eyed	NotreDame_De_Paris.txt 14
eyelashes	NotreDame_De_Paris.txt 1
eyelids	NotreDame_De_Paris.txt 7
eyes	NotreDame_De_Paris.txt 242
