c	Miserables.txt 41
ca	Miserables.txt 5
cab	Miserables.txt 12
caballeros	Miserables.txt 1
cabaret	Miserables.txt 5
cabarets	Miserables.txt 1
cabbage	Miserables.txt 2
cabbages	Miserables.txt 2
cabin	Miserables.txt 3
cabinet	Miserables.txt 7
cabinets	Miserables.txt 3
cabins	Miserables.txt 1
cable	Miserables.txt 3
cables	Miserables.txt 1
caboulots	Miserables.txt 1
cabriolet	Miserables.txt 20
cabriolets	Miserables.txt 4
cabs	Miserables.txt 2
cabuc	Miserables.txt 20
cache	Miserables.txt 1
caches	Miserables.txt 1
cachuca	Miserables.txt 1
cadaver	Miserables.txt 1
cadaverous	Miserables.txt 1
cadene	Miserables.txt 1
cadenettes	Miserables.txt 1
cadets	Miserables.txt 1
cadodaches	Miserables.txt 1
cadran	Miserables.txt 5
caeca	Miserables.txt 1
caen	Miserables.txt 1
caesar	Miserables.txt 31
caesarian	Miserables.txt 1
caesarism	Miserables.txt 1
caesars	Miserables.txt 5
caetera	Miserables.txt 3
cafe	Miserables.txt 34
cafes	Miserables.txt 2
cage	Miserables.txt 18
caged	Miserables.txt 1
cages	Miserables.txt 3
cagliostro	Miserables.txt 1
cahors	Miserables.txt 2
caillard	Miserables.txt 1
caillou	Miserables.txt 2
cain	Miserables.txt 3
caiphas	Miserables.txt 2
caisson	Miserables.txt 1
caissons	Miserables.txt 4
caius	Miserables.txt 1
cajole	Miserables.txt 1
cake	Miserables.txt 15
cakes	Miserables.txt 3
calais	Miserables.txt 3
calamities	Miserables.txt 2
calamity	Miserables.txt 3
calas	Miserables.txt 2
calash	Miserables.txt 4
calcareous	Miserables.txt 1
calculate	Miserables.txt 3
calculated	Miserables.txt 15
calculating	Miserables.txt 1
calculation	Miserables.txt 3
calculations	Miserables.txt 8
calculator	Miserables.txt 3
caledonian	Miserables.txt 1
caleur	Miserables.txt 1
calf	Miserables.txt 3
caliban	Miserables.txt 1
calico	Miserables.txt 3
caligula	Miserables.txt 2
caliphs	Miserables.txt 1
call	Miserables.txt 122
called	Miserables.txt 384
calling	Miserables.txt 18
callipyge	Miserables.txt 1
callot	Miserables.txt 1
callous	Miserables.txt 1
callouses	Miserables.txt 1
callow	Miserables.txt 1
calls	Miserables.txt 35
callumore	Miserables.txt 2
calm	Miserables.txt 63
calme	Miserables.txt 1
calmed	Miserables.txt 6
calmer	Miserables.txt 1
calmest	Miserables.txt 3
calming	Miserables.txt 5
calmly	Miserables.txt 11
calmness	Miserables.txt 9
caloric	Miserables.txt 1
calumniate	Miserables.txt 2
calumniator	Miserables.txt 1
calumnies	Miserables.txt 1
calumny	Miserables.txt 2
calvaire	Miserables.txt 26
calvary	Miserables.txt 1
calves	Miserables.txt 3
calvin	Miserables.txt 1
camail	Miserables.txt 1
camaldules	Miserables.txt 1
camargo	Miserables.txt 1
cambaceres	Miserables.txt 1
cambis	Miserables.txt 1
camblin	Miserables.txt 1
cambrai	Miserables.txt 1
cambronne	Miserables.txt 14
cambyse	Miserables.txt 1
came	Miserables.txt 276
camels	Miserables.txt 1
camille	Miserables.txt 4
camoufle	Miserables.txt 2
camouflet	Miserables.txt 1
camouflets	Miserables.txt 1
camp	Miserables.txt 13
campagna	Miserables.txt 2
campaign	Miserables.txt 9
campan	Miserables.txt 1
campaspe	Miserables.txt 1
camphor	Miserables.txt 1
can	Miserables.txt 447
canaan	Miserables.txt 1
canaille	Miserables.txt 4
canal	Miserables.txt 9
canals	Miserables.txt 1
canam	Miserables.txt 1
canaples	Miserables.txt 1
canaries	Miserables.txt 1
canaris	Miserables.txt 1
canary	Miserables.txt 1
cancel	Miserables.txt 1
canche	Miserables.txt 1
candelabra	Miserables.txt 2
candid	Miserables.txt 12
candidate	Miserables.txt 1
candidates	Miserables.txt 1
candide	Miserables.txt 1
candle	Miserables.txt 93
candlemas	Miserables.txt 2
candles	Miserables.txt 35
candlestick	Miserables.txt 9
candlesticks	Miserables.txt 31
candor	Miserables.txt 7
candors	Miserables.txt 1
cane	Miserables.txt 24
canebiere	Miserables.txt 1
canes	Miserables.txt 1
canezou	Miserables.txt 3
canidia	Miserables.txt 1
canister	Miserables.txt 3
cannes	Miserables.txt 4
cannibals	Miserables.txt 1
cannon	Miserables.txt 76
cannonade	Miserables.txt 3
cannonaded	Miserables.txt 1
cannonades	Miserables.txt 2
cannonading	Miserables.txt 1
cannoneer	Miserables.txt 2
cannoneers	Miserables.txt 3
cannons	Miserables.txt 16
cannot	Miserables.txt 110
canon	Miserables.txt 2
canonical	Miserables.txt 1
canonization	Miserables.txt 1
canonized	Miserables.txt 1
canons	Miserables.txt 1
canonship	Miserables.txt 1
canopied	Miserables.txt 1
canopy	Miserables.txt 1
cant	Miserables.txt 2
cantaro	Miserables.txt 1
canteen	Miserables.txt 3
canton	Miserables.txt 3
cantonments	Miserables.txt 1
cantons	Miserables.txt 2
canuel	Miserables.txt 1
canvas	Miserables.txt 4
canvasses	Miserables.txt 1
cap	Miserables.txt 66
capable	Miserables.txt 33
capacity	Miserables.txt 8
caparisoned	Miserables.txt 1
cape	Miserables.txt 5
capel	Miserables.txt 1
capers	Miserables.txt 1
capes	Miserables.txt 2
capet	Miserables.txt 1
capital	Miserables.txt 26
capitals	Miserables.txt 6
capitoul	Miserables.txt 1
capitulate	Miserables.txt 1
capitulated	Miserables.txt 1
capitulation	Miserables.txt 1
capitulations	Miserables.txt 1
capote	Miserables.txt 2
cappadocia	Miserables.txt 1
capped	Miserables.txt 1
caprice	Miserables.txt 6
caprices	Miserables.txt 2
capricious	Miserables.txt 3
capriciously	Miserables.txt 1
capritious	Miserables.txt 1
caps	Miserables.txt 16
capstan	Miserables.txt 2
captain	Miserables.txt 27
captains	Miserables.txt 1
captious	Miserables.txt 1
captivated	Miserables.txt 2
captive	Miserables.txt 1
captivity	Miserables.txt 2
capture	Miserables.txt 3
captured	Miserables.txt 22
captures	Miserables.txt 1
capturing	Miserables.txt 2
capua	Miserables.txt 1
capuchin	Miserables.txt 2
capuchins	Miserables.txt 1
capucins	Miserables.txt 1
car	Miserables.txt 3
carabin	Miserables.txt 1
carabine	Miserables.txt 1
carabineers	Miserables.txt 3
carabines	Miserables.txt 2
caracalla	Miserables.txt 1
caracara	Miserables.txt 1
caractere	Miserables.txt 1
carafe	Miserables.txt 1
carafes	Miserables.txt 2
caraffes	Miserables.txt 1
carats	Miserables.txt 1
caravanseries	Miserables.txt 1
caravella	Miserables.txt 1
carbine	Miserables.txt 3
carbines	Miserables.txt 7
carbonarism	Miserables.txt 1
carbonaro	Miserables.txt 1
carbonneau	Miserables.txt 1
carbuncle	Miserables.txt 2
carbuncles	Miserables.txt 1
carcass	Miserables.txt 1
card	Miserables.txt 28
cardboard	Miserables.txt 6
cardinal	Miserables.txt 21
cardinals	Miserables.txt 3
cardinalship	Miserables.txt 1
cards	Miserables.txt 10
care	Miserables.txt 76
cared	Miserables.txt 5
career	Miserables.txt 4
careful	Miserables.txt 5
carefully	Miserables.txt 18
careless	Miserables.txt 4
carelessly	Miserables.txt 1
careme	Miserables.txt 1
carency	Miserables.txt 1
cares	Miserables.txt 5
caress	Miserables.txt 7
caressed	Miserables.txt 4
caresses	Miserables.txt 7
caressing	Miserables.txt 11
caribbeans	Miserables.txt 1
caricature	Miserables.txt 2
caricatures	Miserables.txt 1
caries	Miserables.txt 1
carignan	Miserables.txt 1
caring	Miserables.txt 4
cariole	Miserables.txt 1
carioles	Miserables.txt 1
carmagnole	Miserables.txt 2
carmagnolet	Miserables.txt 1
carmelite	Miserables.txt 1
carmelites	Miserables.txt 3
carnage	Miserables.txt 8
carnal	Miserables.txt 1
carnations	Miserables.txt 1
carnival	Miserables.txt 6
carnot	Miserables.txt 2
carogne	Miserables.txt 1
carolina	Miserables.txt 1
carolling	Miserables.txt 4
caron	Miserables.txt 1
carosse	Miserables.txt 1
carotid	Miserables.txt 1
carouse	Miserables.txt 1
carpe	Miserables.txt 2
carpenter	Miserables.txt 7
carpenters	Miserables.txt 1
carpentry	Miserables.txt 1
carpes	Miserables.txt 3
carpet	Miserables.txt 8
carpets	Miserables.txt 2
carps	Miserables.txt 3
carquois	Miserables.txt 1
carreaux	Miserables.txt 1
carrefour	Miserables.txt 7
carrel	Miserables.txt 1
carriage	Miserables.txt 109
carriages	Miserables.txt 19
carried	Miserables.txt 101
carrier	Miserables.txt 6
carries	Miserables.txt 4
carrion	Miserables.txt 1
carrosses	Miserables.txt 1
carrot	Miserables.txt 1
carrousel	Miserables.txt 3
carry	Miserables.txt 54
carrying	Miserables.txt 30
cart	Miserables.txt 68
carte	Miserables.txt 1
carter	Miserables.txt 16
carters	Miserables.txt 8
carthage	Miserables.txt 2
carthaginian	Miserables.txt 2
carthusians	Miserables.txt 2
cartloads	Miserables.txt 1
cartouche	Miserables.txt 10
cartouches	Miserables.txt 2
cartridge	Miserables.txt 14
cartridges	Miserables.txt 43
carts	Miserables.txt 9
carve	Miserables.txt 1
carved	Miserables.txt 8
carvel	Miserables.txt 1
caryatid	Miserables.txt 2
caryatids	Miserables.txt 2
caryste	Miserables.txt 1
cascade	Miserables.txt 2
case	Miserables.txt 176
casemates	Miserables.txt 1
casement	Miserables.txt 2
casements	Miserables.txt 1
cases	Miserables.txt 21
cashier	Miserables.txt 8
cashiered	Miserables.txt 2
cashmere	Miserables.txt 1
casimir	Miserables.txt 3
casing	Miserables.txt 1
cask	Miserables.txt 4
casket	Miserables.txt 1
caskets	Miserables.txt 1
casks	Miserables.txt 7
casque	Miserables.txt 1
casques	Miserables.txt 4
cassandras	Miserables.txt 1
casser	Miserables.txt 1
cassette	Miserables.txt 3
cassin	Miserables.txt 3
cassis	Miserables.txt 1
cassock	Miserables.txt 7
cassocks	Miserables.txt 3
cassons	Miserables.txt 1
cast	Miserables.txt 116
castaing	Miserables.txt 2
castanets	Miserables.txt 1
caste	Miserables.txt 2
castelcicala	Miserables.txt 1
casters	Miserables.txt 1
castes	Miserables.txt 1
castile	Miserables.txt 2
castillejo	Miserables.txt 3
casting	Miserables.txt 11
castlereagh	Miserables.txt 1
castra	Miserables.txt 1
castration	Miserables.txt 1
castratus	Miserables.txt 1
casts	Miserables.txt 9
castus	Miserables.txt 2
casus	Miserables.txt 1
cat	Miserables.txt 51
cataclysm	Miserables.txt 1
cataclysms	Miserables.txt 1
catacomb	Miserables.txt 1
catacombs	Miserables.txt 2
catalogue	Miserables.txt 1
catalogued	Miserables.txt 1
cataplasms	Miserables.txt 1
cataract	Miserables.txt 3
catarrh	Miserables.txt 1
catastrophe	Miserables.txt 35
catastrophes	Miserables.txt 11
catastrophies	Miserables.txt 1
catch	Miserables.txt 38
catches	Miserables.txt 6
catching	Miserables.txt 13
catechism	Miserables.txt 1
catechisms	Miserables.txt 1
categorically	Miserables.txt 1
categories	Miserables.txt 1
category	Miserables.txt 2
catena	Miserables.txt 1
caterpillar	Miserables.txt 2
caterpillars	Miserables.txt 2
cathedral	Miserables.txt 20
cathedrals	Miserables.txt 3
catherine	Miserables.txt 17
catholic	Miserables.txt 7
catholics	Miserables.txt 1
cato	Miserables.txt 3
cats	Miserables.txt 10
cattle	Miserables.txt 6
caudine	Miserables.txt 1
caught	Miserables.txt 153
cauldron	Miserables.txt 1
caumartin	Miserables.txt 2
cause	Miserables.txt 59
caused	Miserables.txt 100
causeless	Miserables.txt 2
causes	Miserables.txt 18
causeway	Miserables.txt 2
causeways	Miserables.txt 1
causing	Miserables.txt 5
cauteretz	Miserables.txt 3
cauterized	Miserables.txt 1
caution	Miserables.txt 2
cautious	Miserables.txt 3
cautiously	Miserables.txt 5
cavaignac	Miserables.txt 1
cavalcade	Miserables.txt 1
cavalier	Miserables.txt 1
cavaliere	Miserables.txt 1
cavalry	Miserables.txt 46
cave	Miserables.txt 8
cavern	Miserables.txt 25
caverne	Miserables.txt 1
caverns	Miserables.txt 12
caves	Miserables.txt 1
cavil	Miserables.txt 1
cavities	Miserables.txt 3
cavity	Miserables.txt 6
ce	Miserables.txt 7
cease	Miserables.txt 11
ceased	Miserables.txt 37
ceases	Miserables.txt 2
ceasing	Miserables.txt 7
cede	Miserables.txt 1
ceiled	Miserables.txt 1
ceiling	Miserables.txt 30
ceilings	Miserables.txt 5
cela	Miserables.txt 3
celebrate	Miserables.txt 1
celebrated	Miserables.txt 28
celebration	Miserables.txt 2
celebrations	Miserables.txt 1
celebrity	Miserables.txt 2
celeste	Miserables.txt 1
celestial	Miserables.txt 31
celestine	Miserables.txt 1
celestins	Miserables.txt 7
celigne	Miserables.txt 1
celimene	Miserables.txt 2
cell	Miserables.txt 25
cellar	Miserables.txt 40
cellars	Miserables.txt 7
cellinis	Miserables.txt 1
cells	Miserables.txt 10
celtic	Miserables.txt 3
cement	Miserables.txt 3
cemented	Miserables.txt 1
cemeteries	Miserables.txt 6
cemetery	Miserables.txt 53
cenobites	Miserables.txt 1
cenobitism	Miserables.txt 1
censer	Miserables.txt 1
censier	Miserables.txt 2
censors	Miserables.txt 1
censures	Miserables.txt 1
census	Miserables.txt 2
cent	Miserables.txt 10
centaurs	Miserables.txt 2
centenarian	Miserables.txt 9
centibes	Miserables.txt 1
centime	Miserables.txt 1
centimes	Miserables.txt 6
centimetres	Miserables.txt 1
centipede	Miserables.txt 1
centipedes	Miserables.txt 1
central	Miserables.txt 9
centre	Miserables.txt 49
centred	Miserables.txt 1
centres	Miserables.txt 3
cents	Miserables.txt 1
centuries	Miserables.txt 23
centurions	Miserables.txt 1
century	Miserables.txt 128
ceracchi	Miserables.txt 1
cerebral	Miserables.txt 1
cerecloths	Miserables.txt 2
ceremonies	Miserables.txt 2
ceremony	Miserables.txt 5
cerisoles	Miserables.txt 1
certain	Miserables.txt 295
certainly	Miserables.txt 99
certainty	Miserables.txt 16
certificate	Miserables.txt 4
certificates	Miserables.txt 1
certify	Miserables.txt 1
ces	Miserables.txt 5
cesar	Miserables.txt 6
cess	Miserables.txt 14
cesspool	Miserables.txt 7
cesspools	Miserables.txt 2
cetera	Miserables.txt 1
cette	Miserables.txt 2
chabot	Miserables.txt 1
chabouillet	Miserables.txt 4
chaboulon	Miserables.txt 1
chaeronea	Miserables.txt 1
chaffaut	Miserables.txt 3
chaffinch	Miserables.txt 1
chafing	Miserables.txt 4
chain	Miserables.txt 49
chained	Miserables.txt 7
chains	Miserables.txt 19
chair	Miserables.txt 96
chairs	Miserables.txt 44
chaise	Miserables.txt 6
chaises	Miserables.txt 1
chalard	Miserables.txt 1
chaldaic	Miserables.txt 1
chaldea	Miserables.txt 1
chaliot	Miserables.txt 1
chalk	Miserables.txt 4
chalky	Miserables.txt 1
challenge	Miserables.txt 2
chalon	Miserables.txt 1
chalons	Miserables.txt 1
chamber	Miserables.txt 141
chamberlain	Miserables.txt 2
chambermaid	Miserables.txt 2
chambers	Miserables.txt 26
chambre	Miserables.txt 2
chamois	Miserables.txt 1
champ	Miserables.txt 14
champagne	Miserables.txt 3
champaubert	Miserables.txt 1
champde	Miserables.txt 1
champeaux	Miserables.txt 1
champigny	Miserables.txt 1
championnet	Miserables.txt 1
champmathieu	Miserables.txt 49
champs	Miserables.txt 21
champtercier	Miserables.txt 1
chan	Miserables.txt 2
chance	Miserables.txt 69
chanced	Miserables.txt 34
chancellery	Miserables.txt 1
chances	Miserables.txt 9
chandelier	Miserables.txt 3
chandeliers	Miserables.txt 1
change	Miserables.txt 67
changed	Miserables.txt 43
changer	Miserables.txt 8
changes	Miserables.txt 18
changing	Miserables.txt 7
channel	Miserables.txt 1
channels	Miserables.txt 1
chant	Miserables.txt 7
chantal	Miserables.txt 1
chante	Miserables.txt 1
chanteloup	Miserables.txt 1
chanter	Miserables.txt 1
chanting	Miserables.txt 3
chants	Miserables.txt 1
chanverrerie	Miserables.txt 1
chanvrerie	Miserables.txt 45
chaos	Miserables.txt 20
chapeau	Miserables.txt 2
chapel	Miserables.txt 34
chapelle	Miserables.txt 3
chapels	Miserables.txt 2
chaperon	Miserables.txt 1
chaplain	Miserables.txt 3
chaplaincies	Miserables.txt 1
chaplaincy	Miserables.txt 1
chaplains	Miserables.txt 1
chaplet	Miserables.txt 4
chappedelaine	Miserables.txt 1
chaps	Miserables.txt 1
chapter	Miserables.txt 381
chapters	Miserables.txt 1
chaque	Miserables.txt 1
char	Miserables.txt 1
character	Miserables.txt 26
characteristic	Miserables.txt 17
characteristics	Miserables.txt 2
characterize	Miserables.txt 1
characterized	Miserables.txt 4
characterizes	Miserables.txt 3
characters	Miserables.txt 4
charbonniere	Miserables.txt 1
charcellay	Miserables.txt 1
charcoal	Miserables.txt 13
charenton	Miserables.txt 1
charge	Miserables.txt 36
charged	Miserables.txt 23
charges	Miserables.txt 6
charging	Miserables.txt 1
charing	Miserables.txt 1
chariot	Miserables.txt 7
charioteer	Miserables.txt 1
chariots	Miserables.txt 1
charitable	Miserables.txt 12
charities	Miserables.txt 2
charity	Miserables.txt 32
charlemagne	Miserables.txt 13
charleroi	Miserables.txt 1
charles	Miserables.txt 32
charlet	Miserables.txt 1
charlot	Miserables.txt 6
charlotte	Miserables.txt 5
charm	Miserables.txt 9
charmant	Miserables.txt 2
charme	Miserables.txt 1
charmed	Miserables.txt 1
charmilles	Miserables.txt 1
charming	Miserables.txt 114
charmingly	Miserables.txt 1
charms	Miserables.txt 5
charnier	Miserables.txt 1
charonne	Miserables.txt 4
charras	Miserables.txt 3
chart	Miserables.txt 2
charter	Miserables.txt 20
chartist	Miserables.txt 1
chartres	Miserables.txt 3
charybdis	Miserables.txt 2
chase	Miserables.txt 6
chased	Miserables.txt 7
chasing	Miserables.txt 2
chasse	Miserables.txt 7
chasseurs	Miserables.txt 1
chassez	Miserables.txt 1
chaste	Miserables.txt 13
chastelar	Miserables.txt 3
chastely	Miserables.txt 1
chastise	Miserables.txt 1
chastised	Miserables.txt 3
chastisement	Miserables.txt 6
chastises	Miserables.txt 1
chastity	Miserables.txt 9
chasuble	Miserables.txt 2
chasubles	Miserables.txt 1
chat	Miserables.txt 10
chateau	Miserables.txt 15
chateaubriand	Miserables.txt 8
chateaubriant	Miserables.txt 1
chateaud	Miserables.txt 1
chateauvieux	Miserables.txt 2
chatelet	Miserables.txt 8
chatillon	Miserables.txt 2
chatou	Miserables.txt 3
chatted	Miserables.txt 1
chatter	Miserables.txt 7
chattered	Miserables.txt 6
chatterers	Miserables.txt 2
chattering	Miserables.txt 8
chatters	Miserables.txt 1
chatting	Miserables.txt 5
chauffeurs	Miserables.txt 1
chaumareix	Miserables.txt 1
chaume	Miserables.txt 3
chaumiere	Miserables.txt 2
chaussee	Miserables.txt 4
chauvelin	Miserables.txt 2
chavailles	Miserables.txt 1
cheap	Miserables.txt 6
cheaply	Miserables.txt 1
cheapness	Miserables.txt 2
cheated	Miserables.txt 2
check	Miserables.txt 6
checked	Miserables.txt 1
checker	Miserables.txt 1
checkered	Miserables.txt 1
checkers	Miserables.txt 1
checks	Miserables.txt 2
cheek	Miserables.txt 22
cheeked	Miserables.txt 1
cheeks	Miserables.txt 15
cheer	Miserables.txt 4
cheered	Miserables.txt 4
cheerful	Miserables.txt 6
cheerfully	Miserables.txt 4
cheerfulness	Miserables.txt 5
cheers	Miserables.txt 1
cheese	Miserables.txt 15
cheeses	Miserables.txt 1
chelles	Miserables.txt 13
chemical	Miserables.txt 3
chemin	Miserables.txt 7
chemis	Miserables.txt 1
chemise	Miserables.txt 25
chemises	Miserables.txt 3
chemist	Miserables.txt 3
chemists	Miserables.txt 1
chenier	Miserables.txt 8
chenildieu	Miserables.txt 14
cher	Miserables.txt 2
cherbourg	Miserables.txt 1
cherche	Miserables.txt 1
chereas	Miserables.txt 1
cherish	Miserables.txt 3
cherished	Miserables.txt 15
cherishes	Miserables.txt 4
cherishing	Miserables.txt 1
cherries	Miserables.txt 4
cherub	Miserables.txt 2
cherubim	Miserables.txt 3
cherubin	Miserables.txt 1
cherubino	Miserables.txt 2
cherubs	Miserables.txt 1
chesnelong	Miserables.txt 1
chest	Miserables.txt 23
chestnut	Miserables.txt 16
chestnuts	Miserables.txt 2
chests	Miserables.txt 3
chevalier	Miserables.txt 7
chevaliers	Miserables.txt 2
chevaux	Miserables.txt 3
cheveux	Miserables.txt 1
chevreuse	Miserables.txt 1
chew	Miserables.txt 1
chewed	Miserables.txt 1
chicanery	Miserables.txt 2
chicken	Miserables.txt 7
chickens	Miserables.txt 5
chickweed	Miserables.txt 1
chides	Miserables.txt 1
chief	Miserables.txt 31
chiefly	Miserables.txt 4
chiefs	Miserables.txt 4
chien	Miserables.txt 2
chiffons	Miserables.txt 1
chilblains	Miserables.txt 2
child	Miserables.txt 471
childhood	Miserables.txt 32
childish	Miserables.txt 9
childishness	Miserables.txt 2
childlike	Miserables.txt 1
children	Miserables.txt 235
chill	Miserables.txt 13
chilled	Miserables.txt 17
chilling	Miserables.txt 1
chilly	Miserables.txt 3
chimaera	Miserables.txt 3
chimaeras	Miserables.txt 4
chimera	Miserables.txt 1
chimeras	Miserables.txt 7
chimerical	Miserables.txt 9
chimes	Miserables.txt 2
chimney	Miserables.txt 77
chimneys	Miserables.txt 7
chin	Miserables.txt 25
china	Miserables.txt 3
chinchona	Miserables.txt 2
chinese	Miserables.txt 7
chins	Miserables.txt 1
chique	Miserables.txt 1
chirography	Miserables.txt 2
chirping	Miserables.txt 3
chirpings	Miserables.txt 1
chirurgical	Miserables.txt 1
chisel	Miserables.txt 13
chivalric	Miserables.txt 1
chivalry	Miserables.txt 1
chlamys	Miserables.txt 1
chloe	Miserables.txt 1
chloruretted	Miserables.txt 1
chocolate	Miserables.txt 3
chodruc	Miserables.txt 1
choice	Miserables.txt 27
choir	Miserables.txt 10
choiseul	Miserables.txt 1
choisir	Miserables.txt 1
choisy	Miserables.txt 2
choked	Miserables.txt 4
choking	Miserables.txt 4
cholera	Miserables.txt 6
cholet	Miserables.txt 1
chonodemaire	Miserables.txt 1
choose	Miserables.txt 23
chooses	Miserables.txt 3
choosing	Miserables.txt 1
chop	Miserables.txt 1
chopped	Miserables.txt 2
chopper	Miserables.txt 1
chopping	Miserables.txt 1
chord	Miserables.txt 2
chorister	Miserables.txt 2
choristers	Miserables.txt 1
chorus	Miserables.txt 2
choruses	Miserables.txt 1
chose	Miserables.txt 12
chosen	Miserables.txt 11
chouan	Miserables.txt 2
chouannerie	Miserables.txt 1
choux	Miserables.txt 3
christ	Miserables.txt 28
christenings	Miserables.txt 1
christi	Miserables.txt 2
christian	Miserables.txt 6
christianity	Miserables.txt 2
christmas	Miserables.txt 7
christopher	Miserables.txt 4
christs	Miserables.txt 1
christus	Miserables.txt 2
chromate	Miserables.txt 1
chronic	Miserables.txt 2
chronicled	Miserables.txt 1
chrysalis	Miserables.txt 3
chubby	Miserables.txt 1
church	Miserables.txt 77
churches	Miserables.txt 6
churchill	Miserables.txt 1
churchmen	Miserables.txt 2
churchwarden	Miserables.txt 1
churlish	Miserables.txt 1
churlishly	Miserables.txt 1
cicatrices	Miserables.txt 1
cicero	Miserables.txt 5
ciceronian	Miserables.txt 1
cider	Miserables.txt 1
ciences	Miserables.txt 1
cieux	Miserables.txt 1
cifuentes	Miserables.txt 1
cigar	Miserables.txt 4
cimitiere	Miserables.txt 1
cineres	Miserables.txt 1
cipher	Miserables.txt 4
ciphers	Miserables.txt 4
circingles	Miserables.txt 1
circle	Miserables.txt 24
circles	Miserables.txt 8
circling	Miserables.txt 1
circuit	Miserables.txt 13
circular	Miserables.txt 4
circulated	Miserables.txt 4
circulates	Miserables.txt 1
circulating	Miserables.txt 1
circulation	Miserables.txt 17
circumference	Miserables.txt 3
circumparisian	Miserables.txt 1
circumscribe	Miserables.txt 1
circumscribed	Miserables.txt 3
circumstance	Miserables.txt 15
circumstances	Miserables.txt 17
circumstantial	Miserables.txt 1
circumstantially	Miserables.txt 1
circumvented	Miserables.txt 1
circuses	Miserables.txt 1
cirque	Miserables.txt 1
cistern	Miserables.txt 4
citadel	Miserables.txt 6
citadels	Miserables.txt 3
citadines	Miserables.txt 1
citeaux	Miserables.txt 9
cited	Miserables.txt 4
cities	Miserables.txt 15
citified	Miserables.txt 1
citizen	Miserables.txt 29
citizens	Miserables.txt 22
city	Miserables.txt 91
civic	Miserables.txt 1
civil	Miserables.txt 24
civilian	Miserables.txt 1
civilization	Miserables.txt 68
civilizations	Miserables.txt 4
civilized	Miserables.txt 8
civilizing	Miserables.txt 1
civilly	Miserables.txt 1
civrieux	Miserables.txt 1
cl	Miserables.txt 5
clacs	Miserables.txt 1
clad	Miserables.txt 32
claim	Miserables.txt 9
claimants	Miserables.txt 1
claimed	Miserables.txt 7
claiming	Miserables.txt 1
claire	Miserables.txt 2
clairvaux	Miserables.txt 3
clairvoyance	Miserables.txt 1
clamber	Miserables.txt 1
clamor	Miserables.txt 12
clamorous	Miserables.txt 2
clamors	Miserables.txt 4
clamped	Miserables.txt 2
clan	Miserables.txt 1
clang	Miserables.txt 1
clank	Miserables.txt 1
clanked	Miserables.txt 2
clanking	Miserables.txt 2
clap	Miserables.txt 7
clapped	Miserables.txt 5
clapping	Miserables.txt 4
claps	Miserables.txt 4
claque	Miserables.txt 2
claquesous	Miserables.txt 21
clarence	Miserables.txt 1
clarified	Miserables.txt 1
clarifying	Miserables.txt 1
clarionet	Miserables.txt 1
clarions	Miserables.txt 1
clash	Miserables.txt 6
clashed	Miserables.txt 3
clashes	Miserables.txt 1
clashing	Miserables.txt 4
clasp	Miserables.txt 4
clasped	Miserables.txt 24
clasping	Miserables.txt 2
clasps	Miserables.txt 3
class	Miserables.txt 23
classed	Miserables.txt 4
classes	Miserables.txt 17
classic	Miserables.txt 14
classical	Miserables.txt 5
classification	Miserables.txt 1
classifications	Miserables.txt 2
classified	Miserables.txt 3
clatter	Miserables.txt 5
clattered	Miserables.txt 1
claude	Miserables.txt 8
claudian	Miserables.txt 1
claudius	Miserables.txt 1
clausel	Miserables.txt 3
claustrale	Miserables.txt 1
claustration	Miserables.txt 3
clavaire	Miserables.txt 1
claw	Miserables.txt 7
claws	Miserables.txt 14
clay	Miserables.txt 6
clayey	Miserables.txt 5
clays	Miserables.txt 1
clean	Miserables.txt 13
cleaned	Miserables.txt 3
cleaner	Miserables.txt 1
cleaning	Miserables.txt 5
cleanliness	Miserables.txt 3
cleanly	Miserables.txt 1
cleanse	Miserables.txt 1
cleansed	Miserables.txt 1
clear	Miserables.txt 49
cleared	Miserables.txt 7
clearer	Miserables.txt 2
clearing	Miserables.txt 6
clearings	Miserables.txt 2
clearly	Miserables.txt 32
clearness	Miserables.txt 8
clef	Miserables.txt 1
clelie	Miserables.txt 1
clemency	Miserables.txt 5
clement	Miserables.txt 1
clenched	Miserables.txt 13
clenches	Miserables.txt 1
cleopatra	Miserables.txt 4
clergy	Miserables.txt 1
clerical	Miserables.txt 2
clerk	Miserables.txt 10
clerks	Miserables.txt 3
clermont	Miserables.txt 3
clever	Miserables.txt 24
cleverest	Miserables.txt 1
cleverly	Miserables.txt 6
cleverness	Miserables.txt 6
clew	Miserables.txt 1
clic	Miserables.txt 1
clichy	Miserables.txt 1
click	Miserables.txt 4
client	Miserables.txt 2
clients	Miserables.txt 1
cliff	Miserables.txt 2
cliffs	Miserables.txt 1
climax	Miserables.txt 2
climb	Miserables.txt 23
climbed	Miserables.txt 13
climbing	Miserables.txt 13
climbs	Miserables.txt 1
climes	Miserables.txt 1
cling	Miserables.txt 9
clinging	Miserables.txt 6
clings	Miserables.txt 5
clinical	Miserables.txt 1
clinics	Miserables.txt 1
clinked	Miserables.txt 1
clinton	Miserables.txt 4
cloak	Miserables.txt 10
cloaks	Miserables.txt 2
clocheperce	Miserables.txt 4
clocher	Miserables.txt 1
clock	Miserables.txt 178
clocks	Miserables.txt 2
clog	Miserables.txt 1
clogged	Miserables.txt 2
clogs	Miserables.txt 2
cloister	Miserables.txt 39
cloistered	Miserables.txt 8
cloisters	Miserables.txt 4
cloots	Miserables.txt 1
close	Miserables.txt 134
closed	Miserables.txt 139
closely	Miserables.txt 14
closer	Miserables.txt 4
closes	Miserables.txt 4
closet	Miserables.txt 4
closets	Miserables.txt 1
closing	Miserables.txt 8
closings	Miserables.txt 1
clot	Miserables.txt 3
cloth	Miserables.txt 50
clothe	Miserables.txt 5
clothed	Miserables.txt 19
clothes	Miserables.txt 51
clothing	Miserables.txt 15
cloths	Miserables.txt 3
clotted	Miserables.txt 1
cloud	Miserables.txt 65
clouded	Miserables.txt 6
cloudlets	Miserables.txt 1
clouds	Miserables.txt 51
cloudy	Miserables.txt 1
clover	Miserables.txt 1
clovis	Miserables.txt 1
clown	Miserables.txt 2
clowns	Miserables.txt 3
club	Miserables.txt 11
clubbist	Miserables.txt 1
clubs	Miserables.txt 7
clue	Miserables.txt 2
clump	Miserables.txt 7
clumps	Miserables.txt 4
clumsily	Miserables.txt 1
clumsy	Miserables.txt 2
clung	Miserables.txt 14
cluny	Miserables.txt 2
clusians	Miserables.txt 1
clusium	Miserables.txt 5
cluster	Miserables.txt 3
clustered	Miserables.txt 1
clusters	Miserables.txt 4
clutch	Miserables.txt 4
clutched	Miserables.txt 3
clutches	Miserables.txt 5
clutching	Miserables.txt 1
co	Miserables.txt 5
coach	Miserables.txt 33
coaches	Miserables.txt 7
coachman	Miserables.txt 36
coachmen	Miserables.txt 2
coagulated	Miserables.txt 1
coagulation	Miserables.txt 1
coal	Miserables.txt 2
coalition	Miserables.txt 1
coals	Miserables.txt 3
coarse	Miserables.txt 48
coarsely	Miserables.txt 1
coarsest	Miserables.txt 1
coast	Miserables.txt 3
coat	Miserables.txt 145
coating	Miserables.txt 2
coats	Miserables.txt 10
cobbler	Miserables.txt 4
coblentz	Miserables.txt 2
cobra	Miserables.txt 1
coche	Miserables.txt 1
cochefilet	Miserables.txt 1
cochepaille	Miserables.txt 14
cochere	Miserables.txt 10
cocheres	Miserables.txt 2
cochlearia	Miserables.txt 1
cock	Miserables.txt 7
cockade	Miserables.txt 9
cockchafer	Miserables.txt 1
cockchafers	Miserables.txt 1
cocked	Miserables.txt 3
cocking	Miserables.txt 1
cockney	Miserables.txt 1
cocks	Miserables.txt 5
coco	Miserables.txt 2
cocoa	Miserables.txt 1
cocoanuts	Miserables.txt 1
cocorico	Miserables.txt 2
code	Miserables.txt 13
codes	Miserables.txt 2
codfish	Miserables.txt 1
coecum	Miserables.txt 1
coesre	Miserables.txt 1
coeur	Miserables.txt 5
coeurs	Miserables.txt 1
coffee	Miserables.txt 3
coffer	Miserables.txt 12
coffers	Miserables.txt 1
coffin	Miserables.txt 71
coffins	Miserables.txt 2
cogitabuntur	Miserables.txt 2
cogna	Miserables.txt 1
cognes	Miserables.txt 1
cogolludo	Miserables.txt 1
cohabit	Miserables.txt 1
cohort	Miserables.txt 3
coiffer	Miserables.txt 1
coiffes	Miserables.txt 1
coiled	Miserables.txt 3
coin	Miserables.txt 21
coinage	Miserables.txt 2
coincided	Miserables.txt 2
coincidence	Miserables.txt 6
coined	Miserables.txt 1
coing	Miserables.txt 4
coining	Miserables.txt 1
coins	Miserables.txt 3
col	Miserables.txt 1
colabre	Miserables.txt 1
colas	Miserables.txt 1
colbacks	Miserables.txt 1
colbas	Miserables.txt 5
colbert	Miserables.txt 2
cold	Miserables.txt 170
colder	Miserables.txt 4
coldest	Miserables.txt 1
coldly	Miserables.txt 12
coldness	Miserables.txt 6
colic	Miserables.txt 1
coligny	Miserables.txt 3
coliseum	Miserables.txt 1
collaboration	Miserables.txt 2
collaborator	Miserables.txt 2
collapse	Miserables.txt 1
collar	Miserables.txt 33
collard	Miserables.txt 2
collared	Miserables.txt 2
collaring	Miserables.txt 1
collars	Miserables.txt 1
colle	Miserables.txt 1
colleague	Miserables.txt 1
colleagues	Miserables.txt 1
collect	Miserables.txt 9
collected	Miserables.txt 16
collecting	Miserables.txt 12
collection	Miserables.txt 13
collective	Miserables.txt 4
collector	Miserables.txt 5
collectors	Miserables.txt 1
collects	Miserables.txt 3
college	Miserables.txt 7
colleges	Miserables.txt 2
collegia	Miserables.txt 1
collegians	Miserables.txt 1
collided	Miserables.txt 1
collisions	Miserables.txt 3
colloquy	Miserables.txt 6
colnet	Miserables.txt 1
colombes	Miserables.txt 1
colonel	Miserables.txt 69
colonelle	Miserables.txt 2
colonels	Miserables.txt 3
colonnade	Miserables.txt 1
color	Miserables.txt 11
colored	Miserables.txt 17
coloring	Miserables.txt 2
colorless	Miserables.txt 1
colors	Miserables.txt 11
colossal	Miserables.txt 24
colossi	Miserables.txt 1
colossus	Miserables.txt 12
columbines	Miserables.txt 2
columbus	Miserables.txt 5
column	Miserables.txt 33
columns	Miserables.txt 13
colville	Miserables.txt 2
com	Miserables.txt 1
comanche	Miserables.txt 1
comb	Miserables.txt 2
combat	Miserables.txt 53
combatant	Miserables.txt 7
combatants	Miserables.txt 31
combated	Miserables.txt 4
combating	Miserables.txt 3
combativeness	Miserables.txt 1
combats	Miserables.txt 5
combed	Miserables.txt 3
combeferre	Miserables.txt 88
combination	Miserables.txt 7
combinations	Miserables.txt 7
combine	Miserables.txt 4
combined	Miserables.txt 29
combines	Miserables.txt 3
combining	Miserables.txt 1
combs	Miserables.txt 1
combustibles	Miserables.txt 3
come	Miserables.txt 559
comedian	Miserables.txt 6
comedy	Miserables.txt 5
comer	Miserables.txt 16
comers	Miserables.txt 5
comes	Miserables.txt 110
comet	Miserables.txt 4
comets	Miserables.txt 1
comfort	Miserables.txt 6
comfortable	Miserables.txt 7
comfortably	Miserables.txt 3
comforted	Miserables.txt 1
comforter	Miserables.txt 1
comforting	Miserables.txt 1
comfortor	Miserables.txt 2
comforts	Miserables.txt 1
comic	Miserables.txt 5
comical	Miserables.txt 1
coming	Miserables.txt 99
comings	Miserables.txt 3
comique	Miserables.txt 1
comma	Miserables.txt 1
command	Miserables.txt 26
commandant	Miserables.txt 3
commanded	Miserables.txt 16
commander	Miserables.txt 7
commanders	Miserables.txt 1
commanding	Miserables.txt 2
commands	Miserables.txt 5
comme	Miserables.txt 3
commence	Miserables.txt 1
commenced	Miserables.txt 2
commencement	Miserables.txt 2
commences	Miserables.txt 3
commending	Miserables.txt 1
comment	Miserables.txt 3
commentaries	Miserables.txt 4
commentary	Miserables.txt 1
commentated	Miserables.txt 1
commented	Miserables.txt 2
commenting	Miserables.txt 1
comments	Miserables.txt 1
commerce	Miserables.txt 6
commercial	Miserables.txt 2
comminations	Miserables.txt 1
commingled	Miserables.txt 1
commiseration	Miserables.txt 2
commissaire	Miserables.txt 1
commissary	Miserables.txt 11
commission	Miserables.txt 8
commissioned	Miserables.txt 2
commissioner	Miserables.txt 3
commissioners	Miserables.txt 2
commissions	Miserables.txt 3
commit	Miserables.txt 12
commits	Miserables.txt 2
committed	Miserables.txt 55
committee	Miserables.txt 6
committing	Miserables.txt 8
commode	Miserables.txt 14
commodus	Miserables.txt 1
common	Miserables.txt 36
commonly	Miserables.txt 2
commonplace	Miserables.txt 3
commotion	Miserables.txt 9
commotions	Miserables.txt 1
commune	Miserables.txt 4
communed	Miserables.txt 1
communes	Miserables.txt 2
communicabit	Miserables.txt 1
communicate	Miserables.txt 5
communicated	Miserables.txt 11
communicates	Miserables.txt 5
communicating	Miserables.txt 6
communication	Miserables.txt 11
communing	Miserables.txt 1
communion	Miserables.txt 6
communism	Miserables.txt 1
communists	Miserables.txt 1
communities	Miserables.txt 5
community	Miserables.txt 28
commutation	Miserables.txt 1
commute	Miserables.txt 2
compact	Miserables.txt 5
companies	Miserables.txt 5
companion	Miserables.txt 4
companions	Miserables.txt 15
company	Miserables.txt 27
comparable	Miserables.txt 1
comparatively	Miserables.txt 1
compare	Miserables.txt 2
compared	Miserables.txt 11
compares	Miserables.txt 1
comparing	Miserables.txt 4
comparison	Miserables.txt 8
comparisons	Miserables.txt 2
compartment	Miserables.txt 7
compartments	Miserables.txt 9
compass	Miserables.txt 5
compassed	Miserables.txt 2
compasses	Miserables.txt 1
compassion	Miserables.txt 16
compassionate	Miserables.txt 5
compatibility	Miserables.txt 1
compatible	Miserables.txt 2
compel	Miserables.txt 4
compelled	Miserables.txt 2
compellers	Miserables.txt 1
compelling	Miserables.txt 1
compels	Miserables.txt 1
compensation	Miserables.txt 2
competent	Miserables.txt 1
competition	Miserables.txt 2
competitions	Miserables.txt 1
compilation	Miserables.txt 1
compiled	Miserables.txt 1
compiling	Miserables.txt 1
complacency	Miserables.txt 1
complain	Miserables.txt 8
complained	Miserables.txt 4
complaining	Miserables.txt 2
complains	Miserables.txt 2
complaint	Miserables.txt 8
complaints	Miserables.txt 2
complaisance	Miserables.txt 5
complaisant	Miserables.txt 1
complementary	Miserables.txt 1
complemented	Miserables.txt 1
complementing	Miserables.txt 1
complements	Miserables.txt 1
complete	Miserables.txt 63
completed	Miserables.txt 31
completely	Miserables.txt 24
completes	Miserables.txt 2
completing	Miserables.txt 2
complex	Miserables.txt 2
complexion	Miserables.txt 4
complexioned	Miserables.txt 1
compliance	Miserables.txt 5
complicate	Miserables.txt 1
complicated	Miserables.txt 32
complicates	Miserables.txt 1
complication	Miserables.txt 3
complications	Miserables.txt 4
complicity	Miserables.txt 3
compliment	Miserables.txt 3
complimenting	Miserables.txt 1
compliments	Miserables.txt 5
comply	Miserables.txt 6
complying	Miserables.txt 3
comported	Miserables.txt 1
comports	Miserables.txt 1
compose	Miserables.txt 3
composed	Miserables.txt 74
composing	Miserables.txt 1
composite	Miserables.txt 4
composition	Miserables.txt 6
composure	Miserables.txt 7
compounded	Miserables.txt 2
comprehend	Miserables.txt 14
comprehended	Miserables.txt 12
comprehending	Miserables.txt 5
comprehends	Miserables.txt 3
comprehensive	Miserables.txt 2
compressed	Miserables.txt 1
compresses	Miserables.txt 2
compressing	Miserables.txt 1
compression	Miserables.txt 2
comprised	Miserables.txt 3
comprises	Miserables.txt 1
comprising	Miserables.txt 1
compromise	Miserables.txt 1
compromised	Miserables.txt 8
compromises	Miserables.txt 3
comptions	Miserables.txt 1
compulsory	Miserables.txt 2
compunctions	Miserables.txt 1
computer	Miserables.txt 2
computers	Miserables.txt 2
comrade	Miserables.txt 16
comrades	Miserables.txt 22
comte	Miserables.txt 26
comtes	Miserables.txt 1
comtesse	Miserables.txt 5
comtois	Miserables.txt 1
concave	Miserables.txt 1
conceal	Miserables.txt 35
concealed	Miserables.txt 75
concealing	Miserables.txt 11
concealment	Miserables.txt 2
conceals	Miserables.txt 5
concede	Miserables.txt 1
conceded	Miserables.txt 3
concedes	Miserables.txt 2
conceit	Miserables.txt 1
conceived	Miserables.txt 10
conceives	Miserables.txt 1
concentrate	Miserables.txt 1
concentrated	Miserables.txt 6
concentration	Miserables.txt 2
concentric	Miserables.txt 4
concept	Miserables.txt 2
conception	Miserables.txt 3
concern	Miserables.txt 12
concerned	Miserables.txt 33
concerning	Miserables.txt 7
concerns	Miserables.txt 18
concert	Miserables.txt 4
concerts	Miserables.txt 1
concession	Miserables.txt 5
concessions	Miserables.txt 4
conch	Miserables.txt 1
concierge	Miserables.txt 1
conciergerie	Miserables.txt 5
conciliating	Miserables.txt 1
concise	Miserables.txt 1
conciseness	Miserables.txt 1
conclave	Miserables.txt 1
conclavist	Miserables.txt 2
conclude	Miserables.txt 3
concluded	Miserables.txt 13
concluding	Miserables.txt 2
conclusion	Miserables.txt 13
conclusive	Miserables.txt 1
conclusus	Miserables.txt 1
concocted	Miserables.txt 1
concomitant	Miserables.txt 1
concord	Miserables.txt 4
concordance	Miserables.txt 1
concorde	Miserables.txt 1
concrete	Miserables.txt 4
concretion	Miserables.txt 1
concretions	Miserables.txt 1
concubine	Miserables.txt 2
concussion	Miserables.txt 2
conde	Miserables.txt 4
condemn	Miserables.txt 5
condemnation	Miserables.txt 13
condemnations	Miserables.txt 2
condemned	Miserables.txt 65
condemning	Miserables.txt 3
condemns	Miserables.txt 3
condensation	Miserables.txt 1
condense	Miserables.txt 2
condensed	Miserables.txt 6
condit	Miserables.txt 1
condition	Miserables.txt 32
conditions	Miserables.txt 15
condones	Miserables.txt 1
condor	Miserables.txt 1
condorcet	Miserables.txt 4
condottiere	Miserables.txt 1
conducive	Miserables.txt 1
conduct	Miserables.txt 18
conducted	Miserables.txt 15
conductor	Miserables.txt 3
conducts	Miserables.txt 1
conduit	Miserables.txt 2
conduits	Miserables.txt 1
confederation	Miserables.txt 1
confer	Miserables.txt 1
conferences	Miserables.txt 2
conferred	Miserables.txt 8
conferring	Miserables.txt 2
confers	Miserables.txt 3
confess	Miserables.txt 9
confessed	Miserables.txt 9
confesses	Miserables.txt 1
confessing	Miserables.txt 2
confession	Miserables.txt 15
confessional	Miserables.txt 1
confessor	Miserables.txt 3
confessors	Miserables.txt 1
confidant	Miserables.txt 1
confide	Miserables.txt 4
confided	Miserables.txt 10
confidence	Miserables.txt 43
confidences	Miserables.txt 1
confident	Miserables.txt 2
confidential	Miserables.txt 2
confiding	Miserables.txt 1
configuration	Miserables.txt 1
confine	Miserables.txt 21
confined	Miserables.txt 15
confinement	Miserables.txt 9
confines	Miserables.txt 3
confining	Miserables.txt 1
confirmation	Miserables.txt 1
confirmed	Miserables.txt 3
confirms	Miserables.txt 1
confiscate	Miserables.txt 1
confiscated	Miserables.txt 1
confiscating	Miserables.txt 1
confiscation	Miserables.txt 1
conflagration	Miserables.txt 14
conflagrations	Miserables.txt 1
conflict	Miserables.txt 33
conflicted	Miserables.txt 1
conflicting	Miserables.txt 3
conflicts	Miserables.txt 5
conformed	Miserables.txt 4
conforming	Miserables.txt 1
confound	Miserables.txt 5
confounded	Miserables.txt 9
confounding	Miserables.txt 2
confront	Miserables.txt 1
confrontation	Miserables.txt 3
confronted	Miserables.txt 3
confronting	Miserables.txt 1
confronts	Miserables.txt 2
confused	Miserables.txt 39
confusedly	Miserables.txt 18
confusing	Miserables.txt 1
confusion	Miserables.txt 25
congealed	Miserables.txt 1
congealing	Miserables.txt 1
congealment	Miserables.txt 1
congealments	Miserables.txt 1
congeals	Miserables.txt 1
congratulate	Miserables.txt 3
congratulated	Miserables.txt 2
congratulating	Miserables.txt 2
congratulations	Miserables.txt 1
congregation	Miserables.txt 8
congregations	Miserables.txt 3
congress	Miserables.txt 4
congrio	Miserables.txt 1
conical	Miserables.txt 1
conjecture	Miserables.txt 8
conjectured	Miserables.txt 1
conjectures	Miserables.txt 19
conjecturing	Miserables.txt 1
conjugal	Miserables.txt 1
conjunction	Miserables.txt 5
conjunctions	Miserables.txt 2
conjunctures	Miserables.txt 2
conjuration	Miserables.txt 1
conjure	Miserables.txt 3
connected	Miserables.txt 32
connecting	Miserables.txt 2
connection	Miserables.txt 25
connections	Miserables.txt 1
connivance	Miserables.txt 3
connoisseur	Miserables.txt 1
connoisseurs	Miserables.txt 1
conque	Miserables.txt 1
conquer	Miserables.txt 7
conquered	Miserables.txt 19
conquering	Miserables.txt 4
conqueror	Miserables.txt 6
conquerors	Miserables.txt 8
conquers	Miserables.txt 1
conquest	Miserables.txt 10
conquests	Miserables.txt 2
conscience	Miserables.txt 98
consciences	Miserables.txt 8
conscientious	Miserables.txt 4
conscientiously	Miserables.txt 4
conscious	Miserables.txt 59
consciously	Miserables.txt 2
consciousness	Miserables.txt 14
conscript	Miserables.txt 5
consecrated	Miserables.txt 5
consecrates	Miserables.txt 3
consecration	Miserables.txt 2
consecutive	Miserables.txt 1
conseil	Miserables.txt 1
consent	Miserables.txt 21
consented	Miserables.txt 5
consenting	Miserables.txt 2
consents	Miserables.txt 1
consequence	Miserables.txt 23
consequences	Miserables.txt 8
consequential	Miserables.txt 1
consequently	Miserables.txt 14
conservateur	Miserables.txt 2
conservation	Miserables.txt 1
conservative	Miserables.txt 1
conserver	Miserables.txt 1
conservet	Miserables.txt 1
consider	Miserables.txt 13
considerable	Miserables.txt 18
consideration	Miserables.txt 29
considerations	Miserables.txt 1
considered	Miserables.txt 20
considering	Miserables.txt 3
consigned	Miserables.txt 2
consigning	Miserables.txt 1
consist	Miserables.txt 3
consisted	Miserables.txt 32
consistency	Miserables.txt 1
consistent	Miserables.txt 1
consisting	Miserables.txt 4
consists	Miserables.txt 18
consolation	Miserables.txt 6
consolations	Miserables.txt 1
console	Miserables.txt 4
consoled	Miserables.txt 3
consoler	Miserables.txt 1
consoles	Miserables.txt 1
consolidate	Miserables.txt 1
consolidated	Miserables.txt 2
consonants	Miserables.txt 1
consort	Miserables.txt 1
conspiracies	Miserables.txt 1
conspiracy	Miserables.txt 1
conspired	Miserables.txt 3
constant	Miserables.txt 10
constantine	Miserables.txt 2
constantinople	Miserables.txt 1
constantius	Miserables.txt 1
constantly	Miserables.txt 22
constants	Miserables.txt 1
constellations	Miserables.txt 8
consternation	Miserables.txt 12
constituent	Miserables.txt 2
constitute	Miserables.txt 10
constituted	Miserables.txt 29
constitutes	Miserables.txt 8
constituting	Miserables.txt 1
constitution	Miserables.txt 3
constitutional	Miserables.txt 7
constitutiones	Miserables.txt 1
constitutionnel	Miserables.txt 1
constrain	Miserables.txt 1
constrained	Miserables.txt 5
constrains	Miserables.txt 1
constraint	Miserables.txt 3
constrictor	Miserables.txt 1
construct	Miserables.txt 6
constructed	Miserables.txt 19
constructing	Miserables.txt 2
construction	Miserables.txt 16
constructions	Miserables.txt 5
constructor	Miserables.txt 1
constructs	Miserables.txt 2
consul	Miserables.txt 2
consule	Miserables.txt 1
consult	Miserables.txt 4
consultation	Miserables.txt 3
consulted	Miserables.txt 9
consulting	Miserables.txt 3
consume	Miserables.txt 3
consumed	Miserables.txt 4
consumer	Miserables.txt 1
consumes	Miserables.txt 1
consummate	Miserables.txt 1
consummated	Miserables.txt 1
consummates	Miserables.txt 1
consummating	Miserables.txt 1
consummation	Miserables.txt 1
consumption	Miserables.txt 2
contact	Miserables.txt 21
contagion	Miserables.txt 4
contagious	Miserables.txt 1
contain	Miserables.txt 27
contained	Miserables.txt 54
containing	Miserables.txt 13
contains	Miserables.txt 25
conte	Miserables.txt 1
contemplait	Miserables.txt 1
contemplate	Miserables.txt 13
contemplated	Miserables.txt 12
contemplates	Miserables.txt 4
contemplating	Miserables.txt 11
contemplation	Miserables.txt 33
contemplations	Miserables.txt 1
contemplator	Miserables.txt 1
contemplators	Miserables.txt 2
contemporaries	Miserables.txt 2
contemporary	Miserables.txt 8
contempt	Miserables.txt 2
contend	Miserables.txt 1
contended	Miserables.txt 1
contending	Miserables.txt 1
content	Miserables.txt 24
contented	Miserables.txt 25
contenting	Miserables.txt 3
contentment	Miserables.txt 2
contents	Miserables.txt 10
contest	Miserables.txt 2
contested	Miserables.txt 1
contesting	Miserables.txt 1
contiguous	Miserables.txt 3
continent	Miserables.txt 4
continents	Miserables.txt 1
contingency	Miserables.txt 1
contingent	Miserables.txt 2
continual	Miserables.txt 5
continually	Miserables.txt 10
continuation	Miserables.txt 9
continue	Miserables.txt 21
continued	Miserables.txt 127
continuer	Miserables.txt 1
continues	Miserables.txt 3
continuing	Miserables.txt 4
continuity	Miserables.txt 2
continuous	Miserables.txt 3
contort	Miserables.txt 1
contortions	Miserables.txt 1
contour	Miserables.txt 1
contours	Miserables.txt 1
contra	Miserables.txt 1
contraband	Miserables.txt 2
contract	Miserables.txt 12
contracted	Miserables.txt 16
contracting	Miserables.txt 2
contraction	Miserables.txt 3
contractor	Miserables.txt 4
contractors	Miserables.txt 1
contracts	Miserables.txt 2
contradict	Miserables.txt 2
contradicted	Miserables.txt 2
contradicting	Miserables.txt 2
contradiction	Miserables.txt 6
contradictions	Miserables.txt 4
contradictory	Miserables.txt 1
contradistinction	Miserables.txt 1
contrary	Miserables.txt 32
contrast	Miserables.txt 8
contrasted	Miserables.txt 5
contrasting	Miserables.txt 1
contrasts	Miserables.txt 1
contrat	Miserables.txt 2
contribute	Miserables.txt 3
contributed	Miserables.txt 7
contributions	Miserables.txt 3
contrive	Miserables.txt 10
contrived	Miserables.txt 10
control	Miserables.txt 6
controlled	Miserables.txt 2
controversy	Miserables.txt 2
contumacious	Miserables.txt 1
contumacy	Miserables.txt 1
convalesce	Miserables.txt 1
convalescence	Miserables.txt 5
convalescent	Miserables.txt 4
convalescents	Miserables.txt 1
convalescing	Miserables.txt 1
convene	Miserables.txt 1
convened	Miserables.txt 2
convenient	Miserables.txt 8
convent	Miserables.txt 156
convention	Miserables.txt 23
conventional	Miserables.txt 1
conventionalities	Miserables.txt 1
conventionary	Miserables.txt 15
convents	Miserables.txt 11
converge	Miserables.txt 4
converges	Miserables.txt 2
converging	Miserables.txt 1
conversation	Miserables.txt 34
conversations	Miserables.txt 10
converse	Miserables.txt 5
conversed	Miserables.txt 8
converses	Miserables.txt 1
conversing	Miserables.txt 8
conversion	Miserables.txt 2
convert	Miserables.txt 3
converted	Miserables.txt 26
converting	Miserables.txt 5
converts	Miserables.txt 4
convex	Miserables.txt 1
convey	Miserables.txt 9
conveyance	Miserables.txt 1
conveyed	Miserables.txt 5
conveys	Miserables.txt 1
convict	Miserables.txt 121
conviction	Miserables.txt 23
convictions	Miserables.txt 5
convicts	Miserables.txt 22
convince	Miserables.txt 2
convinced	Miserables.txt 14
convincing	Miserables.txt 2
convoke	Miserables.txt 1
convokes	Miserables.txt 1
convolvulus	Miserables.txt 3
convoy	Miserables.txt 3
convulsing	Miserables.txt 1
convulsion	Miserables.txt 6
convulsions	Miserables.txt 7
convulsive	Miserables.txt 3
convulsively	Miserables.txt 12
conzie	Miserables.txt 1
coo	Miserables.txt 2
cooing	Miserables.txt 2
cook	Miserables.txt 18
cooke	Miserables.txt 1
cooked	Miserables.txt 2
cooking	Miserables.txt 6
cooks	Miserables.txt 3
cool	Miserables.txt 6
cooled	Miserables.txt 2
cooling	Miserables.txt 2
coolness	Miserables.txt 3
cooper	Miserables.txt 1
coopers	Miserables.txt 1
coordinated	Miserables.txt 1
cope	Miserables.txt 3
copeau	Miserables.txt 1
copied	Miserables.txt 4
copies	Miserables.txt 13
coping	Miserables.txt 4
copper	Miserables.txt 17
copperas	Miserables.txt 1
copperplates	Miserables.txt 2
coppersmith	Miserables.txt 4
coppice	Miserables.txt 1
cops	Miserables.txt 1
copses	Miserables.txt 2
copy	Miserables.txt 22
copying	Miserables.txt 5
copyright	Miserables.txt 15
coquers	Miserables.txt 1
coquetry	Miserables.txt 10
coquette	Miserables.txt 2
coquettes	Miserables.txt 1
coquettish	Miserables.txt 8
coral	Miserables.txt 1
corbeau	Miserables.txt 4
corbeaux	Miserables.txt 2
corbel	Miserables.txt 1
corbiere	Miserables.txt 1
corcelles	Miserables.txt 1
cord	Miserables.txt 10
corda	Miserables.txt 2
cordage	Miserables.txt 1
corday	Miserables.txt 1
corderie	Miserables.txt 1
cordial	Miserables.txt 7
cordiality	Miserables.txt 4
cordially	Miserables.txt 3
cordon	Miserables.txt 2
cords	Miserables.txt 9
core	Miserables.txt 2
cores	Miserables.txt 1
corinth	Miserables.txt 6
corinthe	Miserables.txt 29
corinthians	Miserables.txt 1
corinthum	Miserables.txt 1
cork	Miserables.txt 1
corks	Miserables.txt 2
corkscrew	Miserables.txt 1
corn	Miserables.txt 9
corneae	Miserables.txt 1
corneille	Miserables.txt 7
corner	Miserables.txt 185
cornered	Miserables.txt 4
corners	Miserables.txt 35
cornet	Miserables.txt 1
cornice	Miserables.txt 4
cornices	Miserables.txt 1
corns	Miserables.txt 1
cornwallis	Miserables.txt 1
corollaries	Miserables.txt 1
corollary	Miserables.txt 1
coromandel	Miserables.txt 3
coronation	Miserables.txt 4
coronet	Miserables.txt 2
corpora	Miserables.txt 1
corporal	Miserables.txt 7
corporation	Miserables.txt 1
corps	Miserables.txt 11
corpse	Miserables.txt 37
corpses	Miserables.txt 30
corpulent	Miserables.txt 1
corpus	Miserables.txt 1
correct	Miserables.txt 15
corrected	Miserables.txt 5
correction	Miserables.txt 1
correctional	Miserables.txt 1
corrective	Miserables.txt 2
correctly	Miserables.txt 9
corrects	Miserables.txt 1
correspond	Miserables.txt 4
correspondence	Miserables.txt 4
corresponding	Miserables.txt 6
corresponds	Miserables.txt 4
corridor	Miserables.txt 48
corridors	Miserables.txt 4
corrosive	Miserables.txt 1
corrupt	Miserables.txt 5
corrupted	Miserables.txt 1
corruption	Miserables.txt 8
corsage	Miserables.txt 2
corsages	Miserables.txt 1
corselet	Miserables.txt 1
corsets	Miserables.txt 1
corsica	Miserables.txt 3
corsican	Miserables.txt 4
cortege	Miserables.txt 1
cosette	Miserables.txt 1022
cosettes	Miserables.txt 1
cosmic	Miserables.txt 2
cosmogonic	Miserables.txt 1
cosmogony	Miserables.txt 1
cosmopolitan	Miserables.txt 1
cosmos	Miserables.txt 2
cossacks	Miserables.txt 1
cossette	Miserables.txt 2
cossonerie	Miserables.txt 1
cost	Miserables.txt 29
costing	Miserables.txt 2
costly	Miserables.txt 5
costs	Miserables.txt 13
costume	Miserables.txt 17
costumer	Miserables.txt 2
costumes	Miserables.txt 1
cot	Miserables.txt 1
coterie	Miserables.txt 1
coteries	Miserables.txt 3
cotiret	Miserables.txt 1
coton	Miserables.txt 1
cottage	Miserables.txt 9
cotte	Miserables.txt 1
cottin	Miserables.txt 1
cotton	Miserables.txt 11
cottons	Miserables.txt 1
cotyledons	Miserables.txt 1
couch	Miserables.txt 3
couched	Miserables.txt 4
coucou	Miserables.txt 1
coucous	Miserables.txt 1
cough	Miserables.txt 14
coughed	Miserables.txt 6
coughing	Miserables.txt 4
cougourde	Miserables.txt 8
could	Miserables.txt 678
couldn	Miserables.txt 2
couloubroux	Miserables.txt 1
coulpe	Miserables.txt 6
council	Miserables.txt 16
councillor	Miserables.txt 4
councillors	Miserables.txt 1
councils	Miserables.txt 2
counsel	Miserables.txt 25
counselled	Miserables.txt 5
counselling	Miserables.txt 3
counsellor	Miserables.txt 1
counsellors	Miserables.txt 1
counsels	Miserables.txt 8
count	Miserables.txt 22
counted	Miserables.txt 18
countenance	Miserables.txt 42
countenances	Miserables.txt 6
counter	Miserables.txt 20
counterfeit	Miserables.txt 3
counterfeiter	Miserables.txt 1
counterfeiters	Miserables.txt 2
counterfeiting	Miserables.txt 1
counterfeits	Miserables.txt 2
countermanding	Miserables.txt 1
countermarches	Miserables.txt 1
counterpane	Miserables.txt 2
counterparts	Miserables.txt 1
countersign	Miserables.txt 2
countersigns	Miserables.txt 1
countesses	Miserables.txt 1
counting	Miserables.txt 9
countries	Miserables.txt 2
country	Miserables.txt 114
countryside	Miserables.txt 2
counts	Miserables.txt 6
county	Miserables.txt 1
coup	Miserables.txt 2
coupdesabot	Miserables.txt 2
coupe	Miserables.txt 7
coupelevent	Miserables.txt 2
couple	Miserables.txt 25
coupled	Miserables.txt 2
couples	Miserables.txt 7
couplet	Miserables.txt 8
couplets	Miserables.txt 5
coupling	Miserables.txt 3
coups	Miserables.txt 3
cour	Miserables.txt 5
courage	Miserables.txt 23
courageous	Miserables.txt 10
courageously	Miserables.txt 1
courages	Miserables.txt 1
coural	Miserables.txt 1
courbevoie	Miserables.txt 1
courfeyrac	Miserables.txt 183
courier	Miserables.txt 1
cournand	Miserables.txt 2
cournet	Miserables.txt 5
courrier	Miserables.txt 3
cours	Miserables.txt 1
course	Miserables.txt 129
coursed	Miserables.txt 1
courser	Miserables.txt 1
courses	Miserables.txt 4
court	Miserables.txt 71
courteous	Miserables.txt 2
courtesan	Miserables.txt 3
courtesies	Miserables.txt 1
courtesy	Miserables.txt 3
courthouse	Miserables.txt 1
courtier	Miserables.txt 1
courtiers	Miserables.txt 2
courtille	Miserables.txt 2
courtin	Miserables.txt 1
courting	Miserables.txt 2
courts	Miserables.txt 11
courtyard	Miserables.txt 40
courtyards	Miserables.txt 2
cousin	Miserables.txt 12
cousins	Miserables.txt 1
coussergues	Miserables.txt 1
coustou	Miserables.txt 1
coutard	Miserables.txt 1
couverte	Miserables.txt 1
cove	Miserables.txt 7
cover	Miserables.txt 28
covered	Miserables.txt 90
covering	Miserables.txt 6
coverlet	Miserables.txt 6
coverlid	Miserables.txt 1
covers	Miserables.txt 7
covert	Miserables.txt 1
covet	Miserables.txt 1
coveted	Miserables.txt 1
covetousness	Miserables.txt 1
covey	Miserables.txt 3
cow	Miserables.txt 4
coward	Miserables.txt 6
cowardice	Miserables.txt 4
cowardliness	Miserables.txt 1
cowardly	Miserables.txt 9
cowards	Miserables.txt 5
cowering	Miserables.txt 3
cows	Miserables.txt 7
crab	Miserables.txt 2
crabbed	Miserables.txt 2
crac	Miserables.txt 2
crack	Miserables.txt 14
cracked	Miserables.txt 20
cracking	Miserables.txt 4
crackling	Miserables.txt 5
cracks	Miserables.txt 9
cracovie	Miserables.txt 1
cradle	Miserables.txt 6
cradles	Miserables.txt 2
craft	Miserables.txt 3
crafty	Miserables.txt 7
crammed	Miserables.txt 2
cramped	Miserables.txt 3
crane	Miserables.txt 1
craned	Miserables.txt 2
craning	Miserables.txt 1
crannies	Miserables.txt 3
craon	Miserables.txt 1
crape	Miserables.txt 7
crash	Miserables.txt 2
crashes	Miserables.txt 1
crater	Miserables.txt 3
craters	Miserables.txt 3
cravat	Miserables.txt 26
cravatless	Miserables.txt 1
cravats	Miserables.txt 2
cravatte	Miserables.txt 5
crawl	Miserables.txt 11
crawled	Miserables.txt 12
crawling	Miserables.txt 5
crawls	Miserables.txt 7
crazy	Miserables.txt 4
creak	Miserables.txt 1
creaked	Miserables.txt 1
creaking	Miserables.txt 3
creases	Miserables.txt 1
create	Miserables.txt 17
created	Miserables.txt 41
creates	Miserables.txt 9
creating	Miserables.txt 10
creation	Miserables.txt 31
creative	Miserables.txt 1
creator	Miserables.txt 4
creature	Miserables.txt 69
creatures	Miserables.txt 43
crebleu	Miserables.txt 1
crecy	Miserables.txt 1
credeville	Miserables.txt 1
credible	Miserables.txt 1
credit	Miserables.txt 15
credited	Miserables.txt 1
creditor	Miserables.txt 5
creditors	Miserables.txt 5
credo	Miserables.txt 1
creep	Miserables.txt 3
creeping	Miserables.txt 1
crenelated	Miserables.txt 1
crenellated	Miserables.txt 1
creole	Miserables.txt 1
crepe	Miserables.txt 1
crept	Miserables.txt 6
crequi	Miserables.txt 1
crequy	Miserables.txt 1
crescendo	Miserables.txt 1
crest	Miserables.txt 28
crested	Miserables.txt 1
crests	Miserables.txt 4
cretatus	Miserables.txt 1
cretet	Miserables.txt 1
crevice	Miserables.txt 5
crevices	Miserables.txt 5
crew	Miserables.txt 4
crib	Miserables.txt 2
criblant	Miserables.txt 1
cric	Miserables.txt 1
cricket	Miserables.txt 3
cried	Miserables.txt 122
crier	Miserables.txt 1
cries	Miserables.txt 23
crillon	Miserables.txt 1
crime	Miserables.txt 76
crimes	Miserables.txt 19
criminal	Miserables.txt 20
criminality	Miserables.txt 1
criminals	Miserables.txt 3
crimped	Miserables.txt 2
crimson	Miserables.txt 7
crinchon	Miserables.txt 1
crinoline	Miserables.txt 1
cripple	Miserables.txt 1
crippled	Miserables.txt 2
crippling	Miserables.txt 1
crises	Miserables.txt 4
crisis	Miserables.txt 16
crisp	Miserables.txt 1
critical	Miserables.txt 11
criticise	Miserables.txt 2
criticised	Miserables.txt 1
criticism	Miserables.txt 5
critics	Miserables.txt 2
croak	Miserables.txt 1
crockery	Miserables.txt 2
crocks	Miserables.txt 1
crocodile	Miserables.txt 2
croesus	Miserables.txt 1
crois	Miserables.txt 1
croix	Miserables.txt 2
cromwell	Miserables.txt 4
crook	Miserables.txt 1
crooked	Miserables.txt 6
crop	Miserables.txt 2
cropped	Miserables.txt 2
cropping	Miserables.txt 2
crops	Miserables.txt 2
crosier	Miserables.txt 1
cross	Miserables.txt 107
crossed	Miserables.txt 37
crosses	Miserables.txt 2
crossing	Miserables.txt 14
crossings	Miserables.txt 1
crossroads	Miserables.txt 2
crossways	Miserables.txt 1
crosswise	Miserables.txt 1
crotchets	Miserables.txt 1
crouch	Miserables.txt 3
crouched	Miserables.txt 6
crouching	Miserables.txt 16
croulebarbe	Miserables.txt 3
croup	Miserables.txt 1
crovaient	Miserables.txt 1
crow	Miserables.txt 5
crowd	Miserables.txt 62
crowded	Miserables.txt 3
crowds	Miserables.txt 1
crowell	Miserables.txt 1
crown	Miserables.txt 26
crowned	Miserables.txt 21
crownest	Miserables.txt 1
crowning	Miserables.txt 1
crowns	Miserables.txt 8
crows	Miserables.txt 4
cruches	Miserables.txt 1
crucible	Miserables.txt 3
crucified	Miserables.txt 2
crucifix	Miserables.txt 15
crucifixes	Miserables.txt 1
crucifixion	Miserables.txt 13
crudities	Miserables.txt 2
crudity	Miserables.txt 1
cruel	Miserables.txt 6
cruelly	Miserables.txt 1
cruelty	Miserables.txt 2
cruises	Miserables.txt 1
cruising	Miserables.txt 1
crumble	Miserables.txt 5
crumbled	Miserables.txt 9
crumbles	Miserables.txt 4
crumbling	Miserables.txt 15
crumbs	Miserables.txt 1
crumpled	Miserables.txt 2
crunch	Miserables.txt 2
crupper	Miserables.txt 5
cruppers	Miserables.txt 1
crus	Miserables.txt 1
crusade	Miserables.txt 2
crusades	Miserables.txt 1
crush	Miserables.txt 9
crushed	Miserables.txt 31
crushes	Miserables.txt 4
crushing	Miserables.txt 21
crust	Miserables.txt 1
crusts	Miserables.txt 1
crusty	Miserables.txt 1
crutch	Miserables.txt 2
crutches	Miserables.txt 1
crux	Miserables.txt 1
cry	Miserables.txt 75
crying	Miserables.txt 26
crypt	Miserables.txt 4
crystal	Miserables.txt 6
cuartin	Miserables.txt 1
cub	Miserables.txt 1
cubic	Miserables.txt 1
cuckoo	Miserables.txt 3
cuckoos	Miserables.txt 1
cudgel	Miserables.txt 40
cudgelling	Miserables.txt 2
cudgellings	Miserables.txt 1
cudgels	Miserables.txt 5
cue	Miserables.txt 1
cuff	Miserables.txt 3
cuffed	Miserables.txt 1
cuffs	Miserables.txt 1
cugnet	Miserables.txt 1
cuirass	Miserables.txt 4
cuirasses	Miserables.txt 5
cuirassier	Miserables.txt 3
cuirassiers	Miserables.txt 33
cuirrassiers	Miserables.txt 1
cuirs	Miserables.txt 1
cujas	Miserables.txt 1
cul	Miserables.txt 9
culinary	Miserables.txt 1
culminate	Miserables.txt 1
culminating	Miserables.txt 8
culottes	Miserables.txt 2
culpable	Miserables.txt 6
culprit	Miserables.txt 5
culprits	Miserables.txt 1
cultivate	Miserables.txt 4
cultivated	Miserables.txt 7
cultivates	Miserables.txt 1
cultivation	Miserables.txt 2
cultivator	Miserables.txt 1
cultivators	Miserables.txt 1
culture	Miserables.txt 5
culvert	Miserables.txt 2
cum	Miserables.txt 2
cumberland	Miserables.txt 1
cumbrous	Miserables.txt 1
cumulate	Miserables.txt 1
cunette	Miserables.txt 4
cunning	Miserables.txt 14
cunningly	Miserables.txt 2
cup	Miserables.txt 8
cupboard	Miserables.txt 21
cupboards	Miserables.txt 2
cupid	Miserables.txt 3
cupids	Miserables.txt 2
cups	Miserables.txt 2
curacies	Miserables.txt 1
curacy	Miserables.txt 2
curate	Miserables.txt 4
curates	Miserables.txt 1
curb	Miserables.txt 1
curculio	Miserables.txt 1
curdling	Miserables.txt 2
cure	Miserables.txt 54
cured	Miserables.txt 6
cures	Miserables.txt 4
curfew	Miserables.txt 1
curiosities	Miserables.txt 2
curiosity	Miserables.txt 30
curious	Miserables.txt 36
curiously	Miserables.txt 1
curled	Miserables.txt 8
curling	Miserables.txt 1
curls	Miserables.txt 3
curmudgeon	Miserables.txt 1
currant	Miserables.txt 2
currency	Miserables.txt 1
current	Miserables.txt 9
currents	Miserables.txt 6
currit	Miserables.txt 1
curse	Miserables.txt 4
cursed	Miserables.txt 9
cursing	Miserables.txt 2
cursores	Miserables.txt 1
cursorily	Miserables.txt 1
curt	Miserables.txt 9
curtain	Miserables.txt 16
curtained	Miserables.txt 1
curtains	Miserables.txt 17
curtillus	Miserables.txt 1
curtsey	Miserables.txt 1
curvature	Miserables.txt 1
curve	Miserables.txt 9
curved	Miserables.txt 3
curves	Miserables.txt 2
curving	Miserables.txt 2
cushions	Miserables.txt 2
custodierit	Miserables.txt 1
custodiunt	Miserables.txt 1
custom	Miserables.txt 19
customary	Miserables.txt 9
customer	Miserables.txt 1
customers	Miserables.txt 4
customs	Miserables.txt 4
cut	Miserables.txt 116
cuticle	Miserables.txt 1
cutlet	Miserables.txt 4
cuts	Miserables.txt 14
cutter	Miserables.txt 2
cutters	Miserables.txt 1
cutting	Miserables.txt 11
cuvier	Miserables.txt 1
cy	Miserables.txt 1
cybele	Miserables.txt 1
cyclopean	Miserables.txt 3
cyclops	Miserables.txt 1
cydathenaeum	Miserables.txt 1
cygne	Miserables.txt 10
cygnes	Miserables.txt 1
cylinder	Miserables.txt 1
cylinders	Miserables.txt 1
cyllene	Miserables.txt 1
cynic	Miserables.txt 2
cynical	Miserables.txt 3
cynically	Miserables.txt 1
cynicism	Miserables.txt 4
cyphers	Miserables.txt 1
cypress	Miserables.txt 2
cyr	Miserables.txt 1
cyrus	Miserables.txt 1
cythera	Miserables.txt 1
czarina	Miserables.txt 1
