s	Miserables.txt 2083
sa	Miserables.txt 7
sabin	Miserables.txt 1
sabines	Miserables.txt 2
sabinus	Miserables.txt 1
sabot	Miserables.txt 2
sabots	Miserables.txt 1
sabran	Miserables.txt 2
sabre	Miserables.txt 8
sabred	Miserables.txt 1
sabres	Miserables.txt 8
sabri	Miserables.txt 2
sac	Miserables.txt 9
sack	Miserables.txt 7
sacks	Miserables.txt 6
sacra	Miserables.txt 1
sacrait	Miserables.txt 1
sacrament	Miserables.txt 22
sacramental	Miserables.txt 1
sacred	Miserables.txt 49
sacrifice	Miserables.txt 30
sacrificed	Miserables.txt 8
sacrifices	Miserables.txt 3
sacrificing	Miserables.txt 5
sacrilege	Miserables.txt 3
sacristan	Miserables.txt 1
sacristans	Miserables.txt 1
sacristy	Miserables.txt 4
sad	Miserables.txt 85
sadden	Miserables.txt 1
saddened	Miserables.txt 4
sadder	Miserables.txt 3
saddle	Miserables.txt 8
saddler	Miserables.txt 1
saddles	Miserables.txt 1
sadly	Miserables.txt 11
sadness	Miserables.txt 30
safe	Miserables.txt 14
safely	Miserables.txt 1
safest	Miserables.txt 2
safety	Miserables.txt 14
sagacious	Miserables.txt 9
sagacity	Miserables.txt 5
sage	Miserables.txt 12
sages	Miserables.txt 3
sagittaire	Miserables.txt 1
saguet	Miserables.txt 1
said	Miserables.txt 1796
saidst	Miserables.txt 1
sail	Miserables.txt 3
sailed	Miserables.txt 1
sailing	Miserables.txt 2
sailor	Miserables.txt 6
sailors	Miserables.txt 6
sails	Miserables.txt 3
saint	Miserables.txt 401
sainte	Miserables.txt 65
sainted	Miserables.txt 11
saintete	Miserables.txt 1
saintly	Miserables.txt 1
saintonge	Miserables.txt 3
saints	Miserables.txt 13
sainval	Miserables.txt 2
saisie	Miserables.txt 1
sake	Miserables.txt 35
sakoski	Miserables.txt 1
salaberry	Miserables.txt 1
salad	Miserables.txt 1
salads	Miserables.txt 2
salamanca	Miserables.txt 2
salamanders	Miserables.txt 1
salaries	Miserables.txt 2
salary	Miserables.txt 9
sale	Miserables.txt 7
sales	Miserables.txt 2
salient	Miserables.txt 1
saliva	Miserables.txt 4
salle	Miserables.txt 2
sallies	Miserables.txt 1
sally	Miserables.txt 2
salon	Miserables.txt 21
salone	Miserables.txt 1
salons	Miserables.txt 8
salpetriere	Miserables.txt 14
salt	Miserables.txt 13
saltpetre	Miserables.txt 3
salts	Miserables.txt 3
salus	Miserables.txt 1
salutary	Miserables.txt 1
salutation	Miserables.txt 1
salute	Miserables.txt 21
saluted	Miserables.txt 9
salutes	Miserables.txt 3
saluting	Miserables.txt 2
salvation	Miserables.txt 7
salvator	Miserables.txt 1
salvos	Miserables.txt 1
sambre	Miserables.txt 1
same	Miserables.txt 504
sameness	Miserables.txt 1
samos	Miserables.txt 1
samson	Miserables.txt 1
sanctification	Miserables.txt 1
sanctified	Miserables.txt 1
sanctifies	Miserables.txt 1
sanctify	Miserables.txt 1
sanction	Miserables.txt 2
sanctities	Miserables.txt 1
sanctity	Miserables.txt 7
sanctuary	Miserables.txt 3
sancy	Miserables.txt 4
sand	Miserables.txt 33
sanded	Miserables.txt 1
sands	Miserables.txt 2
sandy	Miserables.txt 2
sang	Miserables.txt 20
sanglier	Miserables.txt 1
sanglote	Miserables.txt 1
sanitary	Miserables.txt 3
sank	Miserables.txt 12
sans	Miserables.txt 5
sansculottes	Miserables.txt 1
sanson	Miserables.txt 1
sante	Miserables.txt 2
santi	Miserables.txt 1
santons	Miserables.txt 1
saone	Miserables.txt 1
sap	Miserables.txt 3
saperlotte	Miserables.txt 1
sapience	Miserables.txt 1
sapientiae	Miserables.txt 1
sapper	Miserables.txt 1
sappers	Miserables.txt 5
sapristi	Miserables.txt 5
saqui	Miserables.txt 1
saragossa	Miserables.txt 3
sarcasm	Miserables.txt 7
sarcasms	Miserables.txt 4
sardanapalus	Miserables.txt 1
sardinia	Miserables.txt 1
sargent	Miserables.txt 1
sarmatians	Miserables.txt 1
sarpejou	Miserables.txt 1
sasenaye	Miserables.txt 1
sash	Miserables.txt 3
sashes	Miserables.txt 1
sass	Miserables.txt 1
sat	Miserables.txt 46
satan	Miserables.txt 6
satanic	Miserables.txt 1
satanical	Miserables.txt 1
sated	Miserables.txt 1
satellite	Miserables.txt 1
satellites	Miserables.txt 1
sates	Miserables.txt 1
satiated	Miserables.txt 2
satiety	Miserables.txt 1
satin	Miserables.txt 10
satire	Miserables.txt 1
satires	Miserables.txt 1
satisfaction	Miserables.txt 18
satisfi	Miserables.txt 1
satisfied	Miserables.txt 39
satisfies	Miserables.txt 1
satisfy	Miserables.txt 3
satisfying	Miserables.txt 2
satnois	Miserables.txt 1
saturated	Miserables.txt 5
saturday	Miserables.txt 1
saturnalia	Miserables.txt 2
satyr	Miserables.txt 2
sauce	Miserables.txt 1
saucepan	Miserables.txt 2
saucer	Miserables.txt 1
sauces	Miserables.txt 1
sauget	Miserables.txt 1
saulve	Miserables.txt 1
saulx	Miserables.txt 1
saumon	Miserables.txt 1
saunter	Miserables.txt 2
sauntered	Miserables.txt 1
sauvage	Miserables.txt 1
sauval	Miserables.txt 1
sauvons	Miserables.txt 3
savage	Miserables.txt 34
savagery	Miserables.txt 1
savages	Miserables.txt 7
savannas	Miserables.txt 1
savant	Miserables.txt 1
save	Miserables.txt 47
saved	Miserables.txt 52
saves	Miserables.txt 6
savigny	Miserables.txt 3
saving	Miserables.txt 12
savings	Miserables.txt 1
savior	Miserables.txt 4
saviors	Miserables.txt 1
saviour	Miserables.txt 2
saviours	Miserables.txt 1
savonne	Miserables.txt 1
savor	Miserables.txt 1
savored	Miserables.txt 1
savory	Miserables.txt 2
savoy	Miserables.txt 1
savoyard	Miserables.txt 7
savoyards	Miserables.txt 3
saw	Miserables.txt 280
sawbones	Miserables.txt 1
sawdust	Miserables.txt 2
sawed	Miserables.txt 3
sawing	Miserables.txt 1
sawyers	Miserables.txt 1
saxe	Miserables.txt 2
saxon	Miserables.txt 1
say	Miserables.txt 601
saying	Miserables.txt 165
sayings	Miserables.txt 8
says	Miserables.txt 111
scab	Miserables.txt 1
scabbard	Miserables.txt 3
scabbards	Miserables.txt 1
scabby	Miserables.txt 1
scabra	Miserables.txt 1
scaffold	Miserables.txt 21
scaffolding	Miserables.txt 2
scaffoldings	Miserables.txt 3
scale	Miserables.txt 21
scaled	Miserables.txt 10
scales	Miserables.txt 7
scaling	Miserables.txt 7
scalloping	Miserables.txt 1
scamp	Miserables.txt 18
scampered	Miserables.txt 1
scamps	Miserables.txt 2
scan	Miserables.txt 1
scandal	Miserables.txt 3
scandalized	Miserables.txt 3
scandinavian	Miserables.txt 1
scanned	Miserables.txt 4
scanning	Miserables.txt 3
scans	Miserables.txt 1
scantling	Miserables.txt 2
scanty	Miserables.txt 2
scape	Miserables.txt 2
scapegrace	Miserables.txt 1
scapin	Miserables.txt 2
scapulary	Miserables.txt 1
scar	Miserables.txt 9
scarcely	Miserables.txt 1
scare	Miserables.txt 3
scared	Miserables.txt 1
scares	Miserables.txt 1
scarf	Miserables.txt 5
scarlet	Miserables.txt 8
scarred	Miserables.txt 3
scarron	Miserables.txt 1
scars	Miserables.txt 5
scatter	Miserables.txt 1
scattered	Miserables.txt 16
scattering	Miserables.txt 3
scaufflaer	Miserables.txt 1
scaufflaire	Miserables.txt 18
scavenger	Miserables.txt 2
scavengers	Miserables.txt 1
sceaux	Miserables.txt 1
scene	Miserables.txt 23
scenery	Miserables.txt 1
scenes	Miserables.txt 14
scent	Miserables.txt 21
scented	Miserables.txt 4
scenting	Miserables.txt 4
scents	Miserables.txt 2
sceptic	Miserables.txt 5
scepticism	Miserables.txt 1
sceptre	Miserables.txt 13
schapka	Miserables.txt 1
schiller	Miserables.txt 2
schinderhannes	Miserables.txt 2
schistose	Miserables.txt 1
schoenbrunn	Miserables.txt 1
scholar	Miserables.txt 2
scholars	Miserables.txt 6
scholastic	Miserables.txt 1
school	Miserables.txt 71
schoolboy	Miserables.txt 1
schoolgirl	Miserables.txt 1
schoolgirls	Miserables.txt 1
schoolmaster	Miserables.txt 7
schoolmasters	Miserables.txt 1
schools	Miserables.txt 9
science	Miserables.txt 43
sciences	Miserables.txt 1
scientific	Miserables.txt 3
scientifically	Miserables.txt 1
scintillation	Miserables.txt 1
scion	Miserables.txt 1
scissors	Miserables.txt 6
scoff	Miserables.txt 5
scoffed	Miserables.txt 1
scoffer	Miserables.txt 2
scoffing	Miserables.txt 1
scoffs	Miserables.txt 2
scolastique	Miserables.txt 1
scold	Miserables.txt 5
scolded	Miserables.txt 4
scolding	Miserables.txt 2
scoldings	Miserables.txt 1
scolds	Miserables.txt 1
sconces	Miserables.txt 1
scope	Miserables.txt 1
scorched	Miserables.txt 4
scorches	Miserables.txt 1
score	Miserables.txt 9
scorn	Miserables.txt 9
scorned	Miserables.txt 4
scorpion	Miserables.txt 2
scotch	Miserables.txt 4
scotchman	Miserables.txt 1
scotchmen	Miserables.txt 1
scotland	Miserables.txt 2
scott	Miserables.txt 1
scoundrel	Miserables.txt 10
scoundrels	Miserables.txt 2
scourge	Miserables.txt 4
scourges	Miserables.txt 1
scout	Miserables.txt 1
scouts	Miserables.txt 4
scowls	Miserables.txt 1
scramble	Miserables.txt 1
scrap	Miserables.txt 13
scrape	Miserables.txt 9
scraped	Miserables.txt 4
scraping	Miserables.txt 1
scraps	Miserables.txt 6
scratch	Miserables.txt 7
scratched	Miserables.txt 7
scratches	Miserables.txt 3
scratching	Miserables.txt 5
scrawl	Miserables.txt 2
scrawled	Miserables.txt 2
scrawling	Miserables.txt 1
scream	Miserables.txt 6
screamed	Miserables.txt 5
screaming	Miserables.txt 1
screech	Miserables.txt 2
screen	Miserables.txt 8
screened	Miserables.txt 3
screens	Miserables.txt 1
screw	Miserables.txt 10
screwed	Miserables.txt 3
screwing	Miserables.txt 2
screws	Miserables.txt 1
scribble	Miserables.txt 2
scribblers	Miserables.txt 1
scribere	Miserables.txt 1
scrimp	Miserables.txt 1
scripture	Miserables.txt 1
scriptures	Miserables.txt 1
scrivener	Miserables.txt 1
scriveners	Miserables.txt 1
scrubbed	Miserables.txt 1
scrubbing	Miserables.txt 1
scruple	Miserables.txt 5
scruples	Miserables.txt 11
scrupulous	Miserables.txt 3
scrupulously	Miserables.txt 2
scrutinize	Miserables.txt 4
scrutinized	Miserables.txt 20
scrutinizes	Miserables.txt 3
scrutinizing	Miserables.txt 12
scrutiny	Miserables.txt 3
scuderi	Miserables.txt 1
scullion	Miserables.txt 3
sculptor	Miserables.txt 2
sculptors	Miserables.txt 1
sculptural	Miserables.txt 2
sculptured	Miserables.txt 1
scum	Miserables.txt 1
scurf	Miserables.txt 1
scuttles	Miserables.txt 1
scylla	Miserables.txt 2
scythia	Miserables.txt 1
se	Miserables.txt 7
sea	Miserables.txt 44
seafaring	Miserables.txt 1
seal	Miserables.txt 4
sealed	Miserables.txt 9
sealing	Miserables.txt 2
seals	Miserables.txt 6
seam	Miserables.txt 2
seams	Miserables.txt 5
seamstresses	Miserables.txt 1
seaport	Miserables.txt 1
sear	Miserables.txt 1
search	Miserables.txt 47
searched	Miserables.txt 20
searcher	Miserables.txt 1
searchers	Miserables.txt 1
searching	Miserables.txt 9
searchingly	Miserables.txt 1
seas	Miserables.txt 1
seashore	Miserables.txt 4
season	Miserables.txt 28
seasoned	Miserables.txt 7
seasoning	Miserables.txt 2
seasons	Miserables.txt 6
seat	Miserables.txt 27
seated	Miserables.txt 123
seating	Miserables.txt 2
seatless	Miserables.txt 3
seats	Miserables.txt 5
seaweed	Miserables.txt 1
sebastian	Miserables.txt 1
sec	Miserables.txt 4
secluded	Miserables.txt 1
seclusion	Miserables.txt 2
second	Miserables.txt 206
secondary	Miserables.txt 4
seconded	Miserables.txt 1
secondly	Miserables.txt 5
seconds	Miserables.txt 17
secrecy	Miserables.txt 2
secret	Miserables.txt 84
secretary	Miserables.txt 9
secreting	Miserables.txt 1
secretiveness	Miserables.txt 1
secretly	Miserables.txt 4
secrets	Miserables.txt 19
section	Miserables.txt 15
sectionaries	Miserables.txt 1
sections	Miserables.txt 8
sects	Miserables.txt 1
secular	Miserables.txt 1
secure	Miserables.txt 5
securely	Miserables.txt 4
security	Miserables.txt 11
sedition	Miserables.txt 1
seditionem	Miserables.txt 1
seditious	Miserables.txt 3
seduced	Miserables.txt 1
see	Miserables.txt 543
seed	Miserables.txt 5
seedling	Miserables.txt 1
seeds	Miserables.txt 1
seeing	Miserables.txt 68
seek	Miserables.txt 26
seeker	Miserables.txt 3
seekers	Miserables.txt 2
seeking	Miserables.txt 37
seeks	Miserables.txt 12
seem	Miserables.txt 56
seemed	Miserables.txt 402
seeming	Miserables.txt 6
seems	Miserables.txt 88
seen	Miserables.txt 384
sees	Miserables.txt 49
seethe	Miserables.txt 2
seething	Miserables.txt 3
segesta	Miserables.txt 1
seigneur	Miserables.txt 3
seigniorial	Miserables.txt 1
seignor	Miserables.txt 2
seignorial	Miserables.txt 2
seignors	Miserables.txt 1
seine	Miserables.txt 45
seize	Miserables.txt 24
seized	Miserables.txt 132
seizes	Miserables.txt 9
seizing	Miserables.txt 8
seizure	Miserables.txt 4
select	Miserables.txt 2
selected	Miserables.txt 8
selects	Miserables.txt 1
self	Miserables.txt 60
selfish	Miserables.txt 4
selfishness	Miserables.txt 3
sell	Miserables.txt 24
selle	Miserables.txt 1
seller	Miserables.txt 8
selling	Miserables.txt 2
sells	Miserables.txt 5
selves	Miserables.txt 1
semaine	Miserables.txt 1
semblance	Miserables.txt 2
semi	Miserables.txt 3
semicircle	Miserables.txt 1
seminarists	Miserables.txt 1
seminary	Miserables.txt 10
semper	Miserables.txt 1
senate	Miserables.txt 3
senator	Miserables.txt 14
senatorial	Miserables.txt 1
senators	Miserables.txt 2
senault	Miserables.txt 2
send	Miserables.txt 26
sending	Miserables.txt 7
sends	Miserables.txt 10
senez	Miserables.txt 2
senile	Miserables.txt 4
senility	Miserables.txt 1
senior	Miserables.txt 3
seniority	Miserables.txt 1
senlis	Miserables.txt 2
senoras	Miserables.txt 1
sens	Miserables.txt 1
sensation	Miserables.txt 14
sensations	Miserables.txt 5
sense	Miserables.txt 60
senseless	Miserables.txt 6
senses	Miserables.txt 9
sensibilities	Miserables.txt 1
sensible	Miserables.txt 6
sensitive	Miserables.txt 2
sensual	Miserables.txt 1
sensualities	Miserables.txt 2
sensuality	Miserables.txt 2
sensuous	Miserables.txt 1
sent	Miserables.txt 65
sentence	Miserables.txt 16
sentenced	Miserables.txt 1
sentences	Miserables.txt 3
sententious	Miserables.txt 2
sentient	Miserables.txt 3
sentiment	Miserables.txt 18
sentimental	Miserables.txt 2
sentimentalism	Miserables.txt 1
sentiments	Miserables.txt 12
sentinel	Miserables.txt 14
sentinels	Miserables.txt 17
sentry	Miserables.txt 4
separate	Miserables.txt 13
separated	Miserables.txt 38
separately	Miserables.txt 2
separates	Miserables.txt 10
separating	Miserables.txt 1
separation	Miserables.txt 6
separations	Miserables.txt 1
sept	Miserables.txt 1
september	Miserables.txt 9
septembrist	Miserables.txt 2
sepulchral	Miserables.txt 12
sepulchre	Miserables.txt 31
sepulchres	Miserables.txt 2
sepulture	Miserables.txt 4
sequel	Miserables.txt 4
sequence	Miserables.txt 2
seraglio	Miserables.txt 1
seraglios	Miserables.txt 1
seraphic	Miserables.txt 2
seraphim	Miserables.txt 3
serene	Miserables.txt 19
serenely	Miserables.txt 2
serenity	Miserables.txt 22
serent	Miserables.txt 1
serfs	Miserables.txt 1
serge	Miserables.txt 9
sergeant	Miserables.txt 48
sergeants	Miserables.txt 3
sergents	Miserables.txt 1
serges	Miserables.txt 1
series	Miserables.txt 7
serieux	Miserables.txt 1
serious	Miserables.txt 78
seriously	Miserables.txt 12
sermon	Miserables.txt 8
sermons	Miserables.txt 4
serpent	Miserables.txt 6
serpents	Miserables.txt 2
serre	Miserables.txt 1
serried	Miserables.txt 2
servait	Miserables.txt 1
servandoni	Miserables.txt 2
servant	Miserables.txt 43
servants	Miserables.txt 16
serve	Miserables.txt 27
served	Miserables.txt 89
serves	Miserables.txt 7
service	Miserables.txt 77
serviceable	Miserables.txt 1
services	Miserables.txt 12
servile	Miserables.txt 1
serving	Miserables.txt 11
servisse	Miserables.txt 1
servitor	Miserables.txt 2
servitors	Miserables.txt 1
servitude	Miserables.txt 10
ses	Miserables.txt 4
sesame	Miserables.txt 1
session	Miserables.txt 4
set	Miserables.txt 235
sets	Miserables.txt 20
sette	Miserables.txt 1
setting	Miserables.txt 35
settle	Miserables.txt 6
settled	Miserables.txt 22
settlement	Miserables.txt 2
seu	Miserables.txt 1
seven	Miserables.txt 116
seventeen	Miserables.txt 14
seventeenth	Miserables.txt 6
seventh	Miserables.txt 18
seventhly	Miserables.txt 1
seventy	Miserables.txt 11
sever	Miserables.txt 1
several	Miserables.txt 77
severe	Miserables.txt 47
severed	Miserables.txt 2
severely	Miserables.txt 8
severing	Miserables.txt 1
severities	Miserables.txt 3
severity	Miserables.txt 17
sevres	Miserables.txt 4
sew	Miserables.txt 1
sewed	Miserables.txt 10
sewer	Miserables.txt 165
sewerman	Miserables.txt 3
sewermen	Miserables.txt 6
sewers	Miserables.txt 28
sewing	Miserables.txt 4
sewn	Miserables.txt 2
sex	Miserables.txt 8
sexes	Miserables.txt 3
seye	Miserables.txt 1
seymour	Miserables.txt 1
shabby	Miserables.txt 3
shade	Miserables.txt 30
shaded	Miserables.txt 2
shades	Miserables.txt 17
shadow	Miserables.txt 143
shadows	Miserables.txt 111
shadowy	Miserables.txt 8
shady	Miserables.txt 3
shaft	Miserables.txt 4
shafts	Miserables.txt 3
shagreen	Miserables.txt 2
shake	Miserables.txt 9
shakedown	Miserables.txt 1
shaken	Miserables.txt 13
shakes	Miserables.txt 5
shakespeare	Miserables.txt 4
shaking	Miserables.txt 11
shako	Miserables.txt 3
shakos	Miserables.txt 4
shakspeare	Miserables.txt 1
shall	Miserables.txt 347
shallots	Miserables.txt 1
shallow	Miserables.txt 1
shalt	Miserables.txt 2
sham	Miserables.txt 1
shame	Miserables.txt 23
shameful	Miserables.txt 3
shameless	Miserables.txt 2
shamelessness	Miserables.txt 1
shames	Miserables.txt 1
shan	Miserables.txt 1
shanty	Miserables.txt 4
shape	Miserables.txt 18
shaped	Miserables.txt 1
shapeless	Miserables.txt 17
shapelessness	Miserables.txt 1
share	Miserables.txt 21
shared	Miserables.txt 16
shares	Miserables.txt 5
sharing	Miserables.txt 4
sharp	Miserables.txt 11
sharpening	Miserables.txt 1
sharpest	Miserables.txt 1
sharply	Miserables.txt 4
sharpness	Miserables.txt 3
sharpshooter	Miserables.txt 1
sharpshooters	Miserables.txt 3
shattered	Miserables.txt 5
shave	Miserables.txt 1
shaved	Miserables.txt 4
shaven	Miserables.txt 4
shaves	Miserables.txt 1
shaving	Miserables.txt 5
shavings	Miserables.txt 3
shawl	Miserables.txt 14
shawls	Miserables.txt 1
she	Miserables.txt 2449
sheaf	Miserables.txt 1
shears	Miserables.txt 2
sheath	Miserables.txt 5
sheathing	Miserables.txt 1
sheaves	Miserables.txt 1
shed	Miserables.txt 25
shedding	Miserables.txt 1
sheds	Miserables.txt 7
sheep	Miserables.txt 11
sheer	Miserables.txt 4
sheet	Miserables.txt 49
sheets	Miserables.txt 23
shelf	Miserables.txt 3
shell	Miserables.txt 8
shellac	Miserables.txt 1
shells	Miserables.txt 6
shelter	Miserables.txt 26
sheltered	Miserables.txt 9
sheltering	Miserables.txt 2
shelves	Miserables.txt 1
shepherd	Miserables.txt 11
shepherdess	Miserables.txt 2
shepherds	Miserables.txt 2
sheriff	Miserables.txt 2
shield	Miserables.txt 2
shielding	Miserables.txt 2
shifter	Miserables.txt 1
shifting	Miserables.txt 1
shine	Miserables.txt 2
shiner	Miserables.txt 1
shiners	Miserables.txt 1
shines	Miserables.txt 3
shining	Miserables.txt 14
ship	Miserables.txt 23
ships	Miserables.txt 5
shipwreck	Miserables.txt 13
shipwrecked	Miserables.txt 2
shipwrecks	Miserables.txt 2
shirking	Miserables.txt 1
shirt	Miserables.txt 27
shirts	Miserables.txt 5
shiver	Miserables.txt 10
shivered	Miserables.txt 14
shivering	Miserables.txt 16
shivers	Miserables.txt 4
shoals	Miserables.txt 1
shock	Miserables.txt 51
shocked	Miserables.txt 7
shocks	Miserables.txt 19
shod	Miserables.txt 8
shoe	Miserables.txt 11
shoes	Miserables.txt 71
shone	Miserables.txt 13
shook	Miserables.txt 35
shoot	Miserables.txt 6
shooting	Miserables.txt 5
shoots	Miserables.txt 5
shop	Miserables.txt 138
shopful	Miserables.txt 1
shopkeeper	Miserables.txt 3
shopkeepers	Miserables.txt 2
shops	Miserables.txt 24
shore	Miserables.txt 21
shored	Miserables.txt 2
shores	Miserables.txt 2
shoring	Miserables.txt 1
shorn	Miserables.txt 3
short	Miserables.txt 133
shortened	Miserables.txt 2
shortens	Miserables.txt 1
shorter	Miserables.txt 7
shortest	Miserables.txt 4
shortly	Miserables.txt 6
shot	Miserables.txt 102
shots	Miserables.txt 18
should	Miserables.txt 566
shoulder	Miserables.txt 46
shouldered	Miserables.txt 2
shoulders	Miserables.txt 58
shouldst	Miserables.txt 1
shout	Miserables.txt 25
shouted	Miserables.txt 72
shouting	Miserables.txt 25
shouts	Miserables.txt 26
shoved	Miserables.txt 1
shovel	Miserables.txt 21
shovelful	Miserables.txt 8
shovels	Miserables.txt 1
show	Miserables.txt 42
showed	Miserables.txt 19
shower	Miserables.txt 13
showered	Miserables.txt 1
showering	Miserables.txt 1
showers	Miserables.txt 5
showing	Miserables.txt 11
shown	Miserables.txt 10
shows	Miserables.txt 12
shrewdness	Miserables.txt 1
shriek	Miserables.txt 9
shrieked	Miserables.txt 8
shrieks	Miserables.txt 5
shrill	Miserables.txt 4
shrine	Miserables.txt 1
shrines	Miserables.txt 1
shrivelled	Miserables.txt 2
shroud	Miserables.txt 8
shrouded	Miserables.txt 2
shrouds	Miserables.txt 1
shrove	Miserables.txt 14
shrub	Miserables.txt 5
shrubbery	Miserables.txt 4
shrubs	Miserables.txt 5
shrug	Miserables.txt 5
shrugged	Miserables.txt 9
shrugs	Miserables.txt 3
shudder	Miserables.txt 32
shuddered	Miserables.txt 32
shuddering	Miserables.txt 8
shun	Miserables.txt 2
shunned	Miserables.txt 1
shut	Miserables.txt 65
shuts	Miserables.txt 1
shutter	Miserables.txt 12
shutters	Miserables.txt 24
shutting	Miserables.txt 6
shuttlecock	Miserables.txt 3
shy	Miserables.txt 8
shyness	Miserables.txt 3
si	Miserables.txt 8
siam	Miserables.txt 1
siberia	Miserables.txt 1
siborne	Miserables.txt 1
sibyl	Miserables.txt 1
sibylline	Miserables.txt 1
sic	Miserables.txt 1
sicambres	Miserables.txt 1
sicard	Miserables.txt 1
sicile	Miserables.txt 4
sicily	Miserables.txt 5
sick	Miserables.txt 33
sickle	Miserables.txt 1
sickly	Miserables.txt 10
sickness	Miserables.txt 2
side	Miserables.txt 300
sideboard	Miserables.txt 6
sided	Miserables.txt 2
sidelong	Miserables.txt 3
sidereal	Miserables.txt 1
sides	Miserables.txt 51
sidewalks	Miserables.txt 2
sideways	Miserables.txt 1
siege	Miserables.txt 2
sieges	Miserables.txt 1
siempre	Miserables.txt 1
sienna	Miserables.txt 2
sieu	Miserables.txt 1
sieur	Miserables.txt 7
sieyes	Miserables.txt 2
sift	Miserables.txt 1
sigh	Miserables.txt 11
sighed	Miserables.txt 9
sighing	Miserables.txt 3
sighings	Miserables.txt 1
sighs	Miserables.txt 3
sight	Miserables.txt 138
sighted	Miserables.txt 2
sightedness	Miserables.txt 2
sighting	Miserables.txt 1
sightless	Miserables.txt 1
sign	Miserables.txt 89
signal	Miserables.txt 12
signals	Miserables.txt 2
signature	Miserables.txt 12
signatures	Miserables.txt 1
signboard	Miserables.txt 2
signed	Miserables.txt 21
signer	Miserables.txt 1
signers	Miserables.txt 1
signes	Miserables.txt 1
significance	Miserables.txt 9
significant	Miserables.txt 13
signified	Miserables.txt 9
signifies	Miserables.txt 18
signify	Miserables.txt 8
signifying	Miserables.txt 3
signing	Miserables.txt 5
signs	Miserables.txt 11
signum	Miserables.txt 1
siguenza	Miserables.txt 1
silanion	Miserables.txt 1
silence	Miserables.txt 162
silences	Miserables.txt 1
silencing	Miserables.txt 1
silent	Miserables.txt 51
silently	Miserables.txt 19
silenus	Miserables.txt 2
silhouette	Miserables.txt 3
silhouettes	Miserables.txt 6
silk	Miserables.txt 12
silken	Miserables.txt 2
silks	Miserables.txt 1
silkworm	Miserables.txt 1
sill	Miserables.txt 4
sillette	Miserables.txt 1
sills	Miserables.txt 1
silly	Miserables.txt 7
silva	Miserables.txt 1
silver	Miserables.txt 69
silvered	Miserables.txt 1
silversmith	Miserables.txt 1
silverware	Miserables.txt 5
silvery	Miserables.txt 1
silvestrins	Miserables.txt 1
similar	Miserables.txt 14
similarities	Miserables.txt 1
similarity	Miserables.txt 1
simmering	Miserables.txt 1
simon	Miserables.txt 6
simonians	Miserables.txt 1
simore	Miserables.txt 1
simpaties	Miserables.txt 1
simpering	Miserables.txt 1
simple	Miserables.txt 88
simplement	Miserables.txt 1
simplest	Miserables.txt 7
simpleton	Miserables.txt 1
simpletons	Miserables.txt 2
simplice	Miserables.txt 32
simplicity	Miserables.txt 9
simplified	Miserables.txt 2
simplifying	Miserables.txt 1
simply	Miserables.txt 51
simulacra	Miserables.txt 1
simulates	Miserables.txt 1
simulating	Miserables.txt 2
simultaneous	Miserables.txt 3
simultaneously	Miserables.txt 10
sin	Miserables.txt 9
sinai	Miserables.txt 1
since	Miserables.txt 239
sincere	Miserables.txt 10
sincerely	Miserables.txt 6
sincerity	Miserables.txt 5
sine	Miserables.txt 1
sinecures	Miserables.txt 1
sing	Miserables.txt 26
singed	Miserables.txt 2
singer	Miserables.txt 1
singers	Miserables.txt 1
singing	Miserables.txt 40
single	Miserables.txt 113
singly	Miserables.txt 1
sings	Miserables.txt 9
singular	Miserables.txt 86
singularities	Miserables.txt 2
singularity	Miserables.txt 2
singularly	Miserables.txt 9
sinister	Miserables.txt 52
sinite	Miserables.txt 1
sink	Miserables.txt 10
sinking	Miserables.txt 9
sinks	Miserables.txt 9
sinned	Miserables.txt 1
sinner	Miserables.txt 4
sins	Miserables.txt 4
sint	Miserables.txt 1
sinuosities	Miserables.txt 1
sinuous	Miserables.txt 1
sinve	Miserables.txt 1
sipped	Miserables.txt 1
sir	Miserables.txt 179
sire	Miserables.txt 10
sirius	Miserables.txt 1
sirloin	Miserables.txt 1
sirven	Miserables.txt 1
sister	Miserables.txt 159
sisteron	Miserables.txt 1
sisters	Miserables.txt 36
sisyphus	Miserables.txt 2
sit	Miserables.txt 21
site	Miserables.txt 6
sitting	Miserables.txt 26
sittings	Miserables.txt 4
situated	Miserables.txt 38
situation	Miserables.txt 70
situations	Miserables.txt 7
six	Miserables.txt 247
sixteen	Miserables.txt 18
sixteenth	Miserables.txt 9
sixth	Miserables.txt 21
sixthly	Miserables.txt 1
sixtieth	Miserables.txt 1
sixtine	Miserables.txt 1
sixty	Miserables.txt 50
size	Miserables.txt 17
sized	Miserables.txt 1
sizes	Miserables.txt 3
skein	Miserables.txt 2
skeleton	Miserables.txt 12
skeletons	Miserables.txt 3
sketch	Miserables.txt 9
sketched	Miserables.txt 16
sketches	Miserables.txt 3
skies	Miserables.txt 2
skiffs	Miserables.txt 1
skilful	Miserables.txt 13
skilfully	Miserables.txt 4
skill	Miserables.txt 10
skilled	Miserables.txt 1
skim	Miserables.txt 2
skimmed	Miserables.txt 1
skimmer	Miserables.txt 1
skin	Miserables.txt 21
skins	Miserables.txt 3
skip	Miserables.txt 2
skipped	Miserables.txt 3
skipping	Miserables.txt 3
skirmish	Miserables.txt 3
skirmished	Miserables.txt 1
skirmisher	Miserables.txt 1
skirmishers	Miserables.txt 1
skirmishes	Miserables.txt 2
skirt	Miserables.txt 12
skirted	Miserables.txt 7
skirting	Miserables.txt 5
skirts	Miserables.txt 5
skittles	Miserables.txt 1
skull	Miserables.txt 12
skullcaps	Miserables.txt 1
skulls	Miserables.txt 3
sky	Miserables.txt 76
skylight	Miserables.txt 2
skylights	Miserables.txt 1
slab	Miserables.txt 4
slabs	Miserables.txt 4
slack	Miserables.txt 5
slackened	Miserables.txt 7
slackening	Miserables.txt 1
slain	Miserables.txt 8
slammed	Miserables.txt 3
slander	Miserables.txt 1
slanderer	Miserables.txt 1
slanders	Miserables.txt 1
slang	Miserables.txt 104
slangs	Miserables.txt 1
slant	Miserables.txt 1
slanting	Miserables.txt 4
slap	Miserables.txt 4
slapped	Miserables.txt 4
slashed	Miserables.txt 5
slasher	Miserables.txt 3
slashers	Miserables.txt 2
slashes	Miserables.txt 1
slashing	Miserables.txt 1
slat	Miserables.txt 1
slate	Miserables.txt 1
slaters	Miserables.txt 1
slates	Miserables.txt 2
slats	Miserables.txt 3
slaughter	Miserables.txt 3
slaughtered	Miserables.txt 1
slaughtering	Miserables.txt 1
slave	Miserables.txt 23
slavery	Miserables.txt 6
slaves	Miserables.txt 6
slayer	Miserables.txt 2
slaying	Miserables.txt 1
slays	Miserables.txt 1
sleep	Miserables.txt 92
sleepers	Miserables.txt 1
sleeping	Miserables.txt 28
sleepless	Miserables.txt 5
sleeplessness	Miserables.txt 3
sleeps	Miserables.txt 5
sleepy	Miserables.txt 3
sleeve	Miserables.txt 9
sleeves	Miserables.txt 9
sleight	Miserables.txt 1
slender	Miserables.txt 13
slept	Miserables.txt 29
sleuth	Miserables.txt 1
slew	Miserables.txt 4
slice	Miserables.txt 5
slid	Miserables.txt 2
slide	Miserables.txt 6
slides	Miserables.txt 7
sliding	Miserables.txt 3
slight	Miserables.txt 13
slightest	Miserables.txt 15
slightingly	Miserables.txt 1
slightly	Miserables.txt 6
slily	Miserables.txt 1
slim	Miserables.txt 1
slime	Miserables.txt 5
sling	Miserables.txt 8
slip	Miserables.txt 18
slipped	Miserables.txt 26
slipper	Miserables.txt 3
slippers	Miserables.txt 4
slippery	Miserables.txt 3
slipping	Miserables.txt 7
slips	Miserables.txt 2
slobbers	Miserables.txt 1
slope	Miserables.txt 34
slopes	Miserables.txt 9
sloping	Miserables.txt 4
slothful	Miserables.txt 1
slouch	Miserables.txt 1
slouching	Miserables.txt 1
slough	Miserables.txt 3
slovenly	Miserables.txt 1
slow	Miserables.txt 15
slowly	Miserables.txt 86
slowness	Miserables.txt 6
sluggish	Miserables.txt 2
slugs	Miserables.txt 1
sluices	Miserables.txt 2
slumber	Miserables.txt 20
slumbered	Miserables.txt 1
slumbering	Miserables.txt 3
slumbers	Miserables.txt 4
slung	Miserables.txt 2
sly	Miserables.txt 10
slyly	Miserables.txt 2
smacked	Miserables.txt 3
smacks	Miserables.txt 1
small	Miserables.txt 148
smaller	Miserables.txt 13
smallest	Miserables.txt 8
smallness	Miserables.txt 3
smash	Miserables.txt 6
smashed	Miserables.txt 3
smasher	Miserables.txt 1
smeared	Miserables.txt 2
smell	Miserables.txt 14
smelled	Miserables.txt 3
smelling	Miserables.txt 5
smells	Miserables.txt 5
smile	Miserables.txt 130
smiled	Miserables.txt 39
smiles	Miserables.txt 11
smiling	Miserables.txt 36
smilingly	Miserables.txt 1
smirched	Miserables.txt 1
smith	Miserables.txt 1
smitten	Miserables.txt 3
smock	Miserables.txt 2
smohain	Miserables.txt 1
smoke	Miserables.txt 58
smoked	Miserables.txt 7
smokers	Miserables.txt 1
smokes	Miserables.txt 2
smoking	Miserables.txt 17
smoky	Miserables.txt 1
smooth	Miserables.txt 5
smoothed	Miserables.txt 4
smoothing	Miserables.txt 1
smote	Miserables.txt 4
smothered	Miserables.txt 1
smouldered	Miserables.txt 1
smouldering	Miserables.txt 3
smuggler	Miserables.txt 2
smugglers	Miserables.txt 1
snails	Miserables.txt 1
snake	Miserables.txt 1
snap	Miserables.txt 2
snapdragons	Miserables.txt 1
snapped	Miserables.txt 3
snapping	Miserables.txt 2
snappishness	Miserables.txt 1
snare	Miserables.txt 4
snares	Miserables.txt 3
snarled	Miserables.txt 1
snatched	Miserables.txt 4
snatches	Miserables.txt 1
snatching	Miserables.txt 2
sneak	Miserables.txt 2
sneaking	Miserables.txt 1
sneer	Miserables.txt 2
sneered	Miserables.txt 1
sneers	Miserables.txt 1
sneeze	Miserables.txt 4
sneezed	Miserables.txt 1
sniffles	Miserables.txt 1
sniffling	Miserables.txt 1
snip	Miserables.txt 1
snooze	Miserables.txt 1
snore	Miserables.txt 1
snored	Miserables.txt 2
snores	Miserables.txt 1
snoring	Miserables.txt 2
snout	Miserables.txt 2
snouts	Miserables.txt 1
snow	Miserables.txt 41
snowball	Miserables.txt 1
snowing	Miserables.txt 2
snows	Miserables.txt 1
snowstorm	Miserables.txt 1
snowy	Miserables.txt 1
snubbed	Miserables.txt 1
snuff	Miserables.txt 10
snuffed	Miserables.txt 2
snuffing	Miserables.txt 1
snug	Miserables.txt 1
snyder	Miserables.txt 1
so	Miserables.txt 1190
soak	Miserables.txt 2
soaked	Miserables.txt 15
soanen	Miserables.txt 1
soap	Miserables.txt 4
soaped	Miserables.txt 1
soar	Miserables.txt 5
soared	Miserables.txt 2
soaring	Miserables.txt 6
soars	Miserables.txt 2
sob	Miserables.txt 11
sobbed	Miserables.txt 3
sobbing	Miserables.txt 8
sober	Miserables.txt 8
soberly	Miserables.txt 1
sobriquet	Miserables.txt 9
sobs	Miserables.txt 13
social	Miserables.txt 98
socialism	Miserables.txt 2
socialists	Miserables.txt 2
socially	Miserables.txt 1
societies	Miserables.txt 9
society	Miserables.txt 144
socinius	Miserables.txt 1
sockets	Miserables.txt 4
socks	Miserables.txt 2
socrates	Miserables.txt 5
sodom	Miserables.txt 1
sods	Miserables.txt 1
sofa	Miserables.txt 5
soft	Miserables.txt 13
soften	Miserables.txt 5
softened	Miserables.txt 8
softening	Miserables.txt 2
softer	Miserables.txt 1
softly	Miserables.txt 21
softness	Miserables.txt 1
soignes	Miserables.txt 4
soil	Miserables.txt 38
soiled	Miserables.txt 9
soiling	Miserables.txt 1
soils	Miserables.txt 2
soir	Miserables.txt 3
soize	Miserables.txt 1
sojourn	Miserables.txt 4
sol	Miserables.txt 2
solaced	Miserables.txt 1
solaces	Miserables.txt 1
solacing	Miserables.txt 1
solar	Miserables.txt 2
sold	Miserables.txt 22
soldered	Miserables.txt 2
soldering	Miserables.txt 1
soldier	Miserables.txt 66
soldierly	Miserables.txt 1
soldiers	Miserables.txt 66
soldiery	Miserables.txt 2
sole	Miserables.txt 21
solely	Miserables.txt 2
solem	Miserables.txt 1
solemn	Miserables.txt 25
solemnity	Miserables.txt 9
solemnly	Miserables.txt 4
soles	Miserables.txt 4
solicit	Miserables.txt 4
solicitation	Miserables.txt 1
solicited	Miserables.txt 1
solicitude	Miserables.txt 2
solid	Miserables.txt 26
solidarity	Miserables.txt 1
solidification	Miserables.txt 1
solidify	Miserables.txt 1
solidity	Miserables.txt 4
solidly	Miserables.txt 3
soliloquized	Miserables.txt 1
soliloquy	Miserables.txt 3
soliman	Miserables.txt 1
solitary	Miserables.txt 36
solitude	Miserables.txt 27
solitudes	Miserables.txt 5
solles	Miserables.txt 1
solliciter	Miserables.txt 1
solo	Miserables.txt 2
solomon	Miserables.txt 4
solstice	Miserables.txt 1
solus	Miserables.txt 2
solution	Miserables.txt 12
solutions	Miserables.txt 1
solve	Miserables.txt 7
solved	Miserables.txt 8
solves	Miserables.txt 1
sombre	Miserables.txt 79
sombreness	Miserables.txt 1
some	Miserables.txt 786
somebody	Miserables.txt 1
somerel	Miserables.txt 1
somerset	Miserables.txt 6
something	Miserables.txt 365
sometimes	Miserables.txt 233
somewhat	Miserables.txt 38
somewhere	Miserables.txt 21
sommes	Miserables.txt 1
somnambulism	Miserables.txt 4
somnambulist	Miserables.txt 1
somnambulists	Miserables.txt 1
somnolence	Miserables.txt 1
somnolent	Miserables.txt 2
son	Miserables.txt 80
sonbise	Miserables.txt 1
song	Miserables.txt 28
songs	Miserables.txt 23
sonnerie	Miserables.txt 1
sonnet	Miserables.txt 1
sonorous	Miserables.txt 7
sonorousness	Miserables.txt 1
sons	Miserables.txt 10
sont	Miserables.txt 4
soon	Miserables.txt 92
sooner	Miserables.txt 18
soot	Miserables.txt 2
sooth	Miserables.txt 7
soothed	Miserables.txt 1
soothes	Miserables.txt 1
soothing	Miserables.txt 2
soothsayers	Miserables.txt 1
sooty	Miserables.txt 1
sophism	Miserables.txt 1
sophisms	Miserables.txt 4
sophists	Miserables.txt 1
sorbonne	Miserables.txt 5
sorcerer	Miserables.txt 2
sordid	Miserables.txt 5
sore	Miserables.txt 3
sorely	Miserables.txt 2
sores	Miserables.txt 2
sorgabon	Miserables.txt 1
sorgue	Miserables.txt 1
sorgueuers	Miserables.txt 1
sorrow	Miserables.txt 21
sorrowful	Miserables.txt 4
sorrowing	Miserables.txt 1
sorrows	Miserables.txt 4
sorry	Miserables.txt 18
sorsum	Miserables.txt 1
sort	Miserables.txt 448
sortant	Miserables.txt 1
sorts	Miserables.txt 55
sosiety	Miserables.txt 1
sou	Miserables.txt 69
soubise	Miserables.txt 1
soufflet	Miserables.txt 1
sought	Miserables.txt 48
soul	Miserables.txt 303
soulange	Miserables.txt 1
soulless	Miserables.txt 1
souls	Miserables.txt 85
soult	Miserables.txt 7
soumise	Miserables.txt 1
sound	Miserables.txt 128
sounded	Miserables.txt 12
sounding	Miserables.txt 7
soundly	Miserables.txt 4
sounds	Miserables.txt 9
soup	Miserables.txt 11
souper	Miserables.txt 1
soupirs	Miserables.txt 1
souple	Miserables.txt 1
sour	Miserables.txt 1
source	Miserables.txt 12
sources	Miserables.txt 4
sourdis	Miserables.txt 3
soured	Miserables.txt 1
souris	Miserables.txt 1
sous	Miserables.txt 113
south	Miserables.txt 18
southern	Miserables.txt 5
southwest	Miserables.txt 1
souvenir	Miserables.txt 8
souvenirs	Miserables.txt 14
sovereign	Miserables.txt 22
sovereigns	Miserables.txt 1
sovereignties	Miserables.txt 2
sovereignty	Miserables.txt 19
sow	Miserables.txt 4
sowing	Miserables.txt 3
sown	Miserables.txt 3
soy	Miserables.txt 1
soye	Miserables.txt 3
space	Miserables.txt 66
spaced	Miserables.txt 1
spaces	Miserables.txt 5
spacious	Miserables.txt 2
spada	Miserables.txt 1
spade	Miserables.txt 2
spain	Miserables.txt 17
spangles	Miserables.txt 1
spaniard	Miserables.txt 5
spaniards	Miserables.txt 1
spanish	Miserables.txt 25
spare	Miserables.txt 7
spared	Miserables.txt 3
sparely	Miserables.txt 5
spares	Miserables.txt 1
sparing	Miserables.txt 5
spark	Miserables.txt 22
sparkle	Miserables.txt 1
sparkled	Miserables.txt 5
sparkles	Miserables.txt 2
sparkling	Miserables.txt 6
sparks	Miserables.txt 9
sparrow	Miserables.txt 3
sparrows	Miserables.txt 6
sparsely	Miserables.txt 1
sparta	Miserables.txt 2
spartacus	Miserables.txt 2
spartan	Miserables.txt 5
spartans	Miserables.txt 2
spasms	Miserables.txt 1
spatchcocked	Miserables.txt 1
spattered	Miserables.txt 2
spattering	Miserables.txt 1
spatters	Miserables.txt 1
spawn	Miserables.txt 1
speak	Miserables.txt 170
speaker	Miserables.txt 1
speaking	Miserables.txt 73
speaks	Miserables.txt 15
spear	Miserables.txt 2
special	Miserables.txt 42
specialized	Miserables.txt 1
specialties	Miserables.txt 1
specialty	Miserables.txt 5
specie	Miserables.txt 1
species	Miserables.txt 28
specific	Miserables.txt 2
specified	Miserables.txt 2
specimen	Miserables.txt 3
specimens	Miserables.txt 3
specious	Miserables.txt 2
speck	Miserables.txt 5
speckled	Miserables.txt 1
specs	Miserables.txt 1
spectacle	Miserables.txt 22
spectacles	Miserables.txt 19
spectator	Miserables.txt 7
spectators	Miserables.txt 15
spectral	Miserables.txt 6
spectre	Miserables.txt 31
spectres	Miserables.txt 22
speculating	Miserables.txt 1
speculation	Miserables.txt 2
speculations	Miserables.txt 1
speculator	Miserables.txt 1
sped	Miserables.txt 2
speech	Miserables.txt 26
speeches	Miserables.txt 2
speechless	Miserables.txt 6
speed	Miserables.txt 20
speedily	Miserables.txt 23
speedy	Miserables.txt 2
spell	Miserables.txt 9
spelled	Miserables.txt 1
spencer	Miserables.txt 1
spend	Miserables.txt 7
spending	Miserables.txt 2
spends	Miserables.txt 2
spendthrift	Miserables.txt 2
spent	Miserables.txt 19
spewed	Miserables.txt 1
sphere	Miserables.txt 5
spheres	Miserables.txt 1
sphinx	Miserables.txt 7
sphinxes	Miserables.txt 2
spiced	Miserables.txt 3
spider	Miserables.txt 12
spiders	Miserables.txt 12
spied	Miserables.txt 8
spies	Miserables.txt 7
spike	Miserables.txt 3
spiked	Miserables.txt 2
spilled	Miserables.txt 1
spin	Miserables.txt 1
spinal	Miserables.txt 2
spine	Miserables.txt 1
spines	Miserables.txt 2
spinning	Miserables.txt 5
spinoza	Miserables.txt 1
spinster	Miserables.txt 14
spiral	Miserables.txt 5
spirals	Miserables.txt 1
spire	Miserables.txt 2
spirit	Miserables.txt 59
spirits	Miserables.txt 17
spiritual	Miserables.txt 6
spit	Miserables.txt 16
spitchcocked	Miserables.txt 1
spite	Miserables.txt 56
spits	Miserables.txt 1
spitted	Miserables.txt 1
spitting	Miserables.txt 2
spittle	Miserables.txt 1
splash	Miserables.txt 2
splashed	Miserables.txt 3
splashing	Miserables.txt 1
spleen	Miserables.txt 3
splendid	Miserables.txt 28
splendidly	Miserables.txt 6
splendor	Miserables.txt 22
splendors	Miserables.txt 4
splinter	Miserables.txt 1
splinters	Miserables.txt 1
split	Miserables.txt 3
splits	Miserables.txt 1
splitting	Miserables.txt 4
spoil	Miserables.txt 2
spoiled	Miserables.txt 8
spoiling	Miserables.txt 1
spoke	Miserables.txt 78
spoken	Miserables.txt 43
spokes	Miserables.txt 4
sponge	Miserables.txt 3
sponges	Miserables.txt 1
sponging	Miserables.txt 1
spongy	Miserables.txt 1
spontaneous	Miserables.txt 3
spontaneously	Miserables.txt 1
spook	Miserables.txt 1
spoon	Miserables.txt 5
spoonful	Miserables.txt 2
spoons	Miserables.txt 7
sport	Miserables.txt 8
sporting	Miserables.txt 1
sportsman	Miserables.txt 1
sportsmen	Miserables.txt 1
spot	Miserables.txt 93
spotless	Miserables.txt 1
spots	Miserables.txt 18
spotted	Miserables.txt 5
spouse	Miserables.txt 7
spout	Miserables.txt 2
spouted	Miserables.txt 1
sprained	Miserables.txt 1
sprang	Miserables.txt 42
sprawled	Miserables.txt 1
spray	Miserables.txt 1
sprays	Miserables.txt 1
spread	Miserables.txt 44
spreading	Miserables.txt 7
spreads	Miserables.txt 5
sprig	Miserables.txt 1
spring	Miserables.txt 79
springing	Miserables.txt 3
springs	Miserables.txt 10
springtide	Miserables.txt 1
springtime	Miserables.txt 8
sprinkled	Miserables.txt 4
sprinkler	Miserables.txt 1
sprinkles	Miserables.txt 1
sprinkling	Miserables.txt 1
sprouting	Miserables.txt 2
spruce	Miserables.txt 1
sprung	Miserables.txt 13
spun	Miserables.txt 5
spurned	Miserables.txt 1
spurred	Miserables.txt 1
spurs	Miserables.txt 6
spurted	Miserables.txt 1
spy	Miserables.txt 35
spying	Miserables.txt 7
squabble	Miserables.txt 1
squad	Miserables.txt 7
squadron	Miserables.txt 15
squadrons	Miserables.txt 8
squads	Miserables.txt 4
squalid	Miserables.txt 1
squalling	Miserables.txt 2
squalls	Miserables.txt 1
squander	Miserables.txt 2
square	Miserables.txt 84
squarely	Miserables.txt 7
squares	Miserables.txt 21
squat	Miserables.txt 2
squeak	Miserables.txt 1
squeaked	Miserables.txt 1
squeeze	Miserables.txt 1
squelch	Miserables.txt 1
squelette	Miserables.txt 1
squint	Miserables.txt 1
st	Miserables.txt 10
stabbed	Miserables.txt 2
stability	Miserables.txt 1
stable	Miserables.txt 19
stableman	Miserables.txt 4
stablemen	Miserables.txt 1
stables	Miserables.txt 3
stael	Miserables.txt 1
staff	Miserables.txt 14
staffs	Miserables.txt 1
stag	Miserables.txt 3
stage	Miserables.txt 24
stages	Miserables.txt 2
stagger	Miserables.txt 3
staggered	Miserables.txt 1
staggering	Miserables.txt 1
stagnant	Miserables.txt 3
stagnating	Miserables.txt 2
stagnation	Miserables.txt 3
stain	Miserables.txt 3
stained	Miserables.txt 6
stair	Miserables.txt 1
staircase	Miserables.txt 55
staircases	Miserables.txt 3
stairs	Miserables.txt 50
stairway	Miserables.txt 1
stake	Miserables.txt 4
stakes	Miserables.txt 3
stalactites	Miserables.txt 2
stale	Miserables.txt 3
stalk	Miserables.txt 2
stalked	Miserables.txt 2
stalking	Miserables.txt 2
stalks	Miserables.txt 2
stall	Miserables.txt 7
stalls	Miserables.txt 9
stammer	Miserables.txt 7
stammered	Miserables.txt 27
stammerer	Miserables.txt 1
stammering	Miserables.txt 4
stammerings	Miserables.txt 1
stammers	Miserables.txt 1
stamp	Miserables.txt 6
stamped	Miserables.txt 25
stand	Miserables.txt 37
standard	Miserables.txt 6
standards	Miserables.txt 2
standing	Miserables.txt 74
stands	Miserables.txt 26
staphyla	Miserables.txt 1
staple	Miserables.txt 1
star	Miserables.txt 40
starboard	Miserables.txt 3
starched	Miserables.txt 1
stare	Miserables.txt 5
stared	Miserables.txt 67
stares	Miserables.txt 1
staring	Miserables.txt 31
stark	Miserables.txt 2
starless	Miserables.txt 2
starlight	Miserables.txt 1
starred	Miserables.txt 1
starry	Miserables.txt 4
stars	Miserables.txt 67
start	Miserables.txt 32
started	Miserables.txt 25
starting	Miserables.txt 7
startled	Miserables.txt 3
startling	Miserables.txt 9
starts	Miserables.txt 3
starve	Miserables.txt 1
starving	Miserables.txt 2
stat	Miserables.txt 1
state	Miserables.txt 146
stated	Miserables.txt 22
stately	Miserables.txt 1
statement	Miserables.txt 4
statements	Miserables.txt 2
states	Miserables.txt 16
statesman	Miserables.txt 11
statesmen	Miserables.txt 6
statics	Miserables.txt 2
stating	Miserables.txt 1
station	Miserables.txt 19
stationed	Miserables.txt 9
stationer	Miserables.txt 1
stations	Miserables.txt 6
statisticians	Miserables.txt 1
statistics	Miserables.txt 5
statu	Miserables.txt 1
statue	Miserables.txt 25
statues	Miserables.txt 8
stature	Miserables.txt 20
statures	Miserables.txt 1
status	Miserables.txt 9
staub	Miserables.txt 1
staved	Miserables.txt 2
stay	Miserables.txt 31
stayed	Miserables.txt 5
stays	Miserables.txt 2
stead	Miserables.txt 6
steadily	Miserables.txt 8
steady	Miserables.txt 4
steal	Miserables.txt 7
stealable	Miserables.txt 2
stealer	Miserables.txt 2
stealing	Miserables.txt 6
steals	Miserables.txt 1
stealthily	Miserables.txt 2
stealthy	Miserables.txt 1
steam	Miserables.txt 4
steamboat	Miserables.txt 2
steamers	Miserables.txt 1
steaming	Miserables.txt 1
steel	Miserables.txt 16
steeled	Miserables.txt 1
steels	Miserables.txt 2
steep	Miserables.txt 10
steeped	Miserables.txt 2
steeple	Miserables.txt 2
steered	Miserables.txt 1
steering	Miserables.txt 1
stella	Miserables.txt 2
stellar	Miserables.txt 1
stem	Miserables.txt 1
stenographic	Miserables.txt 1
step	Miserables.txt 105
stephanus	Miserables.txt 1
stephen	Miserables.txt 1
stepped	Miserables.txt 35
stepping	Miserables.txt 4
steps	Miserables.txt 97
sterile	Miserables.txt 2
stern	Miserables.txt 3
stew	Miserables.txt 3
steward	Miserables.txt 1
stewards	Miserables.txt 1
stewed	Miserables.txt 1
stewpan	Miserables.txt 1
stewpans	Miserables.txt 1
stews	Miserables.txt 1
stick	Miserables.txt 24
stickers	Miserables.txt 1
sticking	Miserables.txt 2
sticks	Miserables.txt 4
sticky	Miserables.txt 1
stiff	Miserables.txt 8
stiffened	Miserables.txt 6
stiffens	Miserables.txt 1
stiffly	Miserables.txt 1
stiffness	Miserables.txt 1
stifle	Miserables.txt 4
stifled	Miserables.txt 10
stifling	Miserables.txt 8
stigmatized	Miserables.txt 1
still	Miserables.txt 518
stilled	Miserables.txt 1
stilted	Miserables.txt 1
stilts	Miserables.txt 1
stimulated	Miserables.txt 1
stingy	Miserables.txt 2
stink	Miserables.txt 1
stipend	Miserables.txt 1
stipulate	Miserables.txt 1
stir	Miserables.txt 31
stirred	Miserables.txt 16
stirring	Miserables.txt 11
stirrup	Miserables.txt 2
stirrups	Miserables.txt 1
stirs	Miserables.txt 5
stitcher	Miserables.txt 2
stitchers	Miserables.txt 1
stitching	Miserables.txt 1
stock	Miserables.txt 10
stockholm	Miserables.txt 1
stocking	Miserables.txt 5
stockingless	Miserables.txt 1
stockings	Miserables.txt 30
stocks	Miserables.txt 6
stoical	Miserables.txt 6
stoically	Miserables.txt 1
stoker	Miserables.txt 1
stole	Miserables.txt 6
stolen	Miserables.txt 34
stomach	Miserables.txt 26
stomacher	Miserables.txt 1
stomachs	Miserables.txt 3
stone	Miserables.txt 157
stoned	Miserables.txt 4
stones	Miserables.txt 104
stoning	Miserables.txt 1
stony	Miserables.txt 1
stood	Miserables.txt 154
stool	Miserables.txt 6
stools	Miserables.txt 1
stoop	Miserables.txt 2
stooped	Miserables.txt 4
stooping	Miserables.txt 4
stop	Miserables.txt 47
stoppage	Miserables.txt 2
stopped	Miserables.txt 51
stopping	Miserables.txt 6
stops	Miserables.txt 6
store	Miserables.txt 1
stored	Miserables.txt 1
storehouses	Miserables.txt 1
stores	Miserables.txt 2
storied	Miserables.txt 1
stories	Miserables.txt 20
storm	Miserables.txt 29
stormed	Miserables.txt 1
storms	Miserables.txt 4
stormy	Miserables.txt 14
story	Miserables.txt 64
stout	Miserables.txt 16
stoutest	Miserables.txt 2
stoutly	Miserables.txt 2
stove	Miserables.txt 22
stoves	Miserables.txt 4
straggler	Miserables.txt 1
stragglers	Miserables.txt 2
straggling	Miserables.txt 1
straight	Miserables.txt 55
straighten	Miserables.txt 2
straightened	Miserables.txt 16
straightening	Miserables.txt 5
straightens	Miserables.txt 2
straightforward	Miserables.txt 3
straightway	Miserables.txt 1
strain	Miserables.txt 2
strained	Miserables.txt 9
strainer	Miserables.txt 2
straining	Miserables.txt 2
strains	Miserables.txt 1
strait	Miserables.txt 1
straitened	Miserables.txt 1
straits	Miserables.txt 2
strand	Miserables.txt 3
stranded	Miserables.txt 3
strands	Miserables.txt 2
strange	Miserables.txt 122
strangely	Miserables.txt 15
strangeness	Miserables.txt 1
stranger	Miserables.txt 87
strangers	Miserables.txt 12
strangest	Miserables.txt 2
strangle	Miserables.txt 1
strangled	Miserables.txt 3
strangling	Miserables.txt 4
straps	Miserables.txt 4
strasburg	Miserables.txt 2
strata	Miserables.txt 3
strategic	Miserables.txt 4
strategical	Miserables.txt 1
strategists	Miserables.txt 1
strategy	Miserables.txt 13
straw	Miserables.txt 57
strawberries	Miserables.txt 3
straws	Miserables.txt 1
stray	Miserables.txt 5
strayed	Miserables.txt 5
straying	Miserables.txt 4
streak	Miserables.txt 1
streaked	Miserables.txt 3
streaking	Miserables.txt 1
stream	Miserables.txt 22
streamed	Miserables.txt 1
streaming	Miserables.txt 1
streams	Miserables.txt 1
street	Miserables.txt 339
streetful	Miserables.txt 1
streets	Miserables.txt 122
strength	Miserables.txt 53
strengthen	Miserables.txt 1
strengthened	Miserables.txt 2
strengthening	Miserables.txt 1
strengthens	Miserables.txt 2
stress	Miserables.txt 1
stretch	Miserables.txt 11
stretched	Miserables.txt 28
stretches	Miserables.txt 9
stretching	Miserables.txt 3
strewed	Miserables.txt 1
strewn	Miserables.txt 7
stricken	Miserables.txt 7
strict	Miserables.txt 8
strictly	Miserables.txt 8
stride	Miserables.txt 6
strident	Miserables.txt 3
strides	Miserables.txt 18
striding	Miserables.txt 3
strife	Miserables.txt 3
strike	Miserables.txt 23
strikes	Miserables.txt 17
striking	Miserables.txt 23
string	Miserables.txt 6
strings	Miserables.txt 3
strip	Miserables.txt 7
stripe	Miserables.txt 1
stripped	Miserables.txt 5
stripping	Miserables.txt 2
strips	Miserables.txt 2
strive	Miserables.txt 1
strives	Miserables.txt 2
striving	Miserables.txt 4
strode	Miserables.txt 8
stroke	Miserables.txt 16
strokes	Miserables.txt 7
stroll	Miserables.txt 15
strolled	Miserables.txt 6
stroller	Miserables.txt 1
strolling	Miserables.txt 12
strolls	Miserables.txt 11
strong	Miserables.txt 47
stronger	Miserables.txt 8
strongest	Miserables.txt 4
stronghold	Miserables.txt 1
strongholds	Miserables.txt 1
strongly	Miserables.txt 9
strongylion	Miserables.txt 2
strophe	Miserables.txt 2
strophes	Miserables.txt 1
strove	Miserables.txt 5
struck	Miserables.txt 96
structure	Miserables.txt 2
structures	Miserables.txt 1
struggle	Miserables.txt 28
struggled	Miserables.txt 6
struggles	Miserables.txt 3
struggling	Miserables.txt 6
strut	Miserables.txt 1
strutted	Miserables.txt 1
stuarts	Miserables.txt 2
stubble	Miserables.txt 1
stubborn	Miserables.txt 2
stubbornness	Miserables.txt 1
stuck	Miserables.txt 8
studded	Miserables.txt 10
student	Miserables.txt 12
studentesses	Miserables.txt 1
students	Miserables.txt 23
studied	Miserables.txt 16
studies	Miserables.txt 11
studio	Miserables.txt 1
studios	Miserables.txt 2
studious	Miserables.txt 1
study	Miserables.txt 39
studying	Miserables.txt 4
stuff	Miserables.txt 18
stuffed	Miserables.txt 8
stuffs	Miserables.txt 2
stumble	Miserables.txt 1
stumbled	Miserables.txt 1
stump	Miserables.txt 3
stumps	Miserables.txt 7
stunned	Miserables.txt 4
stunted	Miserables.txt 1
stupefaction	Miserables.txt 9
stupefied	Miserables.txt 21
stupefying	Miserables.txt 1
stupendous	Miserables.txt 1
stupid	Miserables.txt 62
stupider	Miserables.txt 1
stupidity	Miserables.txt 12
stupidly	Miserables.txt 7
stupids	Miserables.txt 2
stupor	Miserables.txt 14
sturdy	Miserables.txt 1
stuttered	Miserables.txt 1
style	Miserables.txt 29
styled	Miserables.txt 1
styx	Miserables.txt 1
suavity	Miserables.txt 4
sub	Miserables.txt 10
subacetate	Miserables.txt 1
subdued	Miserables.txt 6
subervic	Miserables.txt 1
subiaco	Miserables.txt 1
subjacent	Miserables.txt 3
subject	Miserables.txt 70
subjected	Miserables.txt 10
subjection	Miserables.txt 2
subjects	Miserables.txt 9
subjugate	Miserables.txt 1
subjugated	Miserables.txt 2
subjugates	Miserables.txt 1
sublimated	Miserables.txt 1
sublimation	Miserables.txt 2
sublime	Miserables.txt 44
sublimely	Miserables.txt 1
sublimities	Miserables.txt 1
sublimity	Miserables.txt 6
submerged	Miserables.txt 4
submersion	Miserables.txt 1
submission	Miserables.txt 4
submit	Miserables.txt 5
submits	Miserables.txt 1
submitted	Miserables.txt 3
submitting	Miserables.txt 3
subordinate	Miserables.txt 2
subordinated	Miserables.txt 3
subordinates	Miserables.txt 4
subordinating	Miserables.txt 1
suborn	Miserables.txt 1
subscribe	Miserables.txt 1
subscribed	Miserables.txt 1
subscriber	Miserables.txt 1
subscription	Miserables.txt 1
subsequent	Miserables.txt 2
subsequently	Miserables.txt 1
subsided	Miserables.txt 1
subsist	Miserables.txt 1
subsisted	Miserables.txt 1
subsistence	Miserables.txt 1
subsists	Miserables.txt 1
subsoil	Miserables.txt 3
substance	Miserables.txt 6
substantial	Miserables.txt 1
substantives	Miserables.txt 1
substitute	Miserables.txt 6
substituted	Miserables.txt 1
substituting	Miserables.txt 2
substitution	Miserables.txt 3
substratum	Miserables.txt 2
subterranean	Miserables.txt 36
subtle	Miserables.txt 2
subtract	Miserables.txt 1
suburb	Miserables.txt 3
suburban	Miserables.txt 2
suburbs	Miserables.txt 19
subversive	Miserables.txt 2
succeed	Miserables.txt 16
succeeded	Miserables.txt 82
succeeding	Miserables.txt 7
succeeds	Miserables.txt 3
success	Miserables.txt 40
successes	Miserables.txt 2
successful	Miserables.txt 8
successfully	Miserables.txt 1
succession	Miserables.txt 20
successive	Miserables.txt 15
successively	Miserables.txt 2
successor	Miserables.txt 1
succor	Miserables.txt 22
succored	Miserables.txt 2
succoring	Miserables.txt 1
such	Miserables.txt 427
suchet	Miserables.txt 2
suck	Miserables.txt 1
sucking	Miserables.txt 2
sucks	Miserables.txt 1
suction	Miserables.txt 1
sud	Miserables.txt 1
sudden	Miserables.txt 32
suddenly	Miserables.txt 137
sue	Miserables.txt 1
suffer	Miserables.txt 30
sufferance	Miserables.txt 1
suffered	Miserables.txt 36
sufferer	Miserables.txt 1
sufferers	Miserables.txt 2
suffering	Miserables.txt 58
sufferings	Miserables.txt 10
suffers	Miserables.txt 12
suffice	Miserables.txt 15
sufficed	Miserables.txt 30
suffices	Miserables.txt 26
sufficiency	Miserables.txt 1
sufficient	Miserables.txt 36
sufficiently	Miserables.txt 26
suffocated	Miserables.txt 1
suffocates	Miserables.txt 1
suffocating	Miserables.txt 1
suffocation	Miserables.txt 7
suffrage	Miserables.txt 5
suffren	Miserables.txt 1
suffuse	Miserables.txt 1
sugar	Miserables.txt 8
sugared	Miserables.txt 1
suggested	Miserables.txt 9
suggestion	Miserables.txt 1
suggestions	Miserables.txt 1
suggestive	Miserables.txt 1
suggests	Miserables.txt 2
suicide	Miserables.txt 15
suicides	Miserables.txt 1
suis	Miserables.txt 3
suisse	Miserables.txt 1
suit	Miserables.txt 16
suitable	Miserables.txt 7
suitably	Miserables.txt 1
suite	Miserables.txt 2
suited	Miserables.txt 13
suits	Miserables.txt 4
suivra	Miserables.txt 1
sulfuretted	Miserables.txt 1
sulked	Miserables.txt 1
sulking	Miserables.txt 1
sulks	Miserables.txt 2
sullen	Miserables.txt 2
sulphur	Miserables.txt 2
sulpice	Miserables.txt 8
sultan	Miserables.txt 2
sultana	Miserables.txt 2
sum	Miserables.txt 44
summa	Miserables.txt 1
summary	Miserables.txt 3
summed	Miserables.txt 11
summer	Miserables.txt 44
summertide	Miserables.txt 1
summing	Miserables.txt 2
summit	Miserables.txt 24
summits	Miserables.txt 2
summon	Miserables.txt 9
summoned	Miserables.txt 25
summons	Miserables.txt 6
sumptuousness	Miserables.txt 1
sums	Miserables.txt 8
sun	Miserables.txt 118
sunbeams	Miserables.txt 2
sunburned	Miserables.txt 1
sunburnt	Miserables.txt 2
sunday	Miserables.txt 17
sundays	Miserables.txt 7
sundown	Miserables.txt 3
sung	Miserables.txt 6
sunk	Miserables.txt 8
sunken	Miserables.txt 5
sunless	Miserables.txt 1
sunlight	Miserables.txt 16
sunny	Miserables.txt 4
sunrise	Miserables.txt 4
sunrises	Miserables.txt 1
sunset	Miserables.txt 3
sunsets	Miserables.txt 1
sunshine	Miserables.txt 8
sup	Miserables.txt 3
super	Miserables.txt 1
superannuated	Miserables.txt 2
superb	Miserables.txt 14
superbly	Miserables.txt 2
superficial	Miserables.txt 7
superficially	Miserables.txt 1
superfluities	Miserables.txt 1
superfluous	Miserables.txt 11
superhuman	Miserables.txt 8
superintended	Miserables.txt 1
superintendence	Miserables.txt 1
superintendent	Miserables.txt 6
superintendents	Miserables.txt 2
superintending	Miserables.txt 2
superior	Miserables.txt 25
superioris	Miserables.txt 1
superiority	Miserables.txt 5
superiors	Miserables.txt 2
supernatural	Miserables.txt 4
superposed	Miserables.txt 10
superposes	Miserables.txt 1
superscription	Miserables.txt 3
superseded	Miserables.txt 2
superstition	Miserables.txt 6
superstitions	Miserables.txt 9
superstitious	Miserables.txt 1
supervened	Miserables.txt 3
supervise	Miserables.txt 1
supervising	Miserables.txt 2
supervision	Miserables.txt 5
supped	Miserables.txt 7
supper	Miserables.txt 25
supping	Miserables.txt 1
supple	Miserables.txt 4
supplementary	Miserables.txt 1
suppleness	Miserables.txt 2
supplicating	Miserables.txt 5
supplication	Miserables.txt 1
supplications	Miserables.txt 1
supplied	Miserables.txt 2
supplies	Miserables.txt 2
supply	Miserables.txt 5
supplying	Miserables.txt 2
support	Miserables.txt 28
supported	Miserables.txt 18
supporters	Miserables.txt 1
supporting	Miserables.txt 10
supports	Miserables.txt 4
suppose	Miserables.txt 20
supposed	Miserables.txt 28
supposes	Miserables.txt 1
supposing	Miserables.txt 9
supposition	Miserables.txt 2
suppositions	Miserables.txt 4
suppress	Miserables.txt 7
suppressed	Miserables.txt 10
suppresses	Miserables.txt 2
suppressing	Miserables.txt 1
suppression	Miserables.txt 3
suppressions	Miserables.txt 1
suppuration	Miserables.txt 1
supremacy	Miserables.txt 3
supreme	Miserables.txt 54
supremely	Miserables.txt 2
sur	Miserables.txt 81
surcharge	Miserables.txt 2
sure	Miserables.txt 77
surely	Miserables.txt 13
surene	Miserables.txt 3
sureness	Miserables.txt 1
suresnes	Miserables.txt 1
surface	Miserables.txt 39
surfaces	Miserables.txt 1
surged	Miserables.txt 1
surgeon	Miserables.txt 4
surgical	Miserables.txt 1
surin	Miserables.txt 1
surlababi	Miserables.txt 1
surmise	Miserables.txt 2
surmised	Miserables.txt 2
surmises	Miserables.txt 3
surmising	Miserables.txt 1
surmounted	Miserables.txt 17
surname	Miserables.txt 2
surnamed	Miserables.txt 7
surnames	Miserables.txt 1
surpassed	Miserables.txt 3
surpasses	Miserables.txt 2
surplice	Miserables.txt 2
surprise	Miserables.txt 41
surprised	Miserables.txt 20
surprises	Miserables.txt 3
surprising	Miserables.txt 18
surrender	Miserables.txt 6
surrendered	Miserables.txt 2
surrendering	Miserables.txt 2
surrey	Miserables.txt 1
surround	Miserables.txt 2
surrounded	Miserables.txt 44
surrounding	Miserables.txt 7
surroundings	Miserables.txt 2
surrounds	Miserables.txt 4
surtout	Miserables.txt 1
surtouts	Miserables.txt 1
surveillance	Miserables.txt 6
survey	Miserables.txt 7
surveyed	Miserables.txt 15
surveying	Miserables.txt 11
surveys	Miserables.txt 1
survincent	Miserables.txt 1
survive	Miserables.txt 5
survived	Miserables.txt 7
survives	Miserables.txt 2
survivors	Miserables.txt 2
sus	Miserables.txt 1
susceptibilities	Miserables.txt 1
susceptibility	Miserables.txt 1
susceptible	Miserables.txt 1
suslababo	Miserables.txt 1
suspect	Miserables.txt 12
suspected	Miserables.txt 19
suspecting	Miserables.txt 10
suspects	Miserables.txt 1
suspend	Miserables.txt 1
suspended	Miserables.txt 28
suspender	Miserables.txt 4
suspenders	Miserables.txt 2
suspends	Miserables.txt 3
suspendu	Miserables.txt 1
suspense	Miserables.txt 2
suspension	Miserables.txt 1
suspicion	Miserables.txt 17
suspicions	Miserables.txt 1
suspicious	Miserables.txt 24
sustain	Miserables.txt 1
sustained	Miserables.txt 10
sustaining	Miserables.txt 1
sustains	Miserables.txt 1
sutler	Miserables.txt 3
sutlers	Miserables.txt 2
suzette	Miserables.txt 2
suzon	Miserables.txt 1
swaddled	Miserables.txt 1
swaddling	Miserables.txt 2
swagger	Miserables.txt 1
swallow	Miserables.txt 8
swallowed	Miserables.txt 15
swallower	Miserables.txt 1
swallowing	Miserables.txt 4
swallows	Miserables.txt 4
swam	Miserables.txt 3
swamp	Miserables.txt 2
swan	Miserables.txt 5
swans	Miserables.txt 20
swantibore	Miserables.txt 1
swarm	Miserables.txt 8
swarmed	Miserables.txt 5
swarming	Miserables.txt 12
swarms	Miserables.txt 4
swathe	Miserables.txt 1
swathed	Miserables.txt 2
swathing	Miserables.txt 1
sway	Miserables.txt 1
swayed	Miserables.txt 5
swaying	Miserables.txt 1
swear	Miserables.txt 14
swearing	Miserables.txt 1
swears	Miserables.txt 1
sweat	Miserables.txt 6
sweating	Miserables.txt 2
sweats	Miserables.txt 4
sweden	Miserables.txt 1
swedenborg	Miserables.txt 1
sweep	Miserables.txt 10
sweeper	Miserables.txt 1
sweeping	Miserables.txt 11
sweeps	Miserables.txt 2
sweet	Miserables.txt 62
sweeter	Miserables.txt 2
sweetest	Miserables.txt 2
sweetish	Miserables.txt 1
sweetly	Miserables.txt 8
sweetness	Miserables.txt 14
swell	Miserables.txt 4
swelled	Miserables.txt 5
swelling	Miserables.txt 8
swellings	Miserables.txt 1
swells	Miserables.txt 1
swept	Miserables.txt 17
swerve	Miserables.txt 2
swerved	Miserables.txt 1
swiftly	Miserables.txt 2
swim	Miserables.txt 1
swimmers	Miserables.txt 2
swimming	Miserables.txt 4
swims	Miserables.txt 1
swindler	Miserables.txt 1
swing	Miserables.txt 9
swinging	Miserables.txt 3
swings	Miserables.txt 2
swiss	Miserables.txt 1
switch	Miserables.txt 1
switzerland	Miserables.txt 4
swollen	Miserables.txt 3
swoon	Miserables.txt 5
swooning	Miserables.txt 3
swoons	Miserables.txt 1
swooped	Miserables.txt 1
sword	Miserables.txt 99
swords	Miserables.txt 30
swordsman	Miserables.txt 1
swore	Miserables.txt 4
sworn	Miserables.txt 5
swung	Miserables.txt 9
sybaris	Miserables.txt 2
sybarites	Miserables.txt 1
sycamores	Miserables.txt 2
syene	Miserables.txt 1
sylla	Miserables.txt 3
syllable	Miserables.txt 13
syllables	Miserables.txt 4
syllogism	Miserables.txt 2
syllogisms	Miserables.txt 2
sylphs	Miserables.txt 1
sylvanie	Miserables.txt 1
symbol	Miserables.txt 9
symbolical	Miserables.txt 2
symbolism	Miserables.txt 1
symbols	Miserables.txt 2
symmetrical	Miserables.txt 4
symmetrically	Miserables.txt 1
symmetry	Miserables.txt 4
sympathetic	Miserables.txt 4
sympathies	Miserables.txt 2
sympathizing	Miserables.txt 1
sympathy	Miserables.txt 5
symphony	Miserables.txt 3
symptom	Miserables.txt 6
symptoms	Miserables.txt 8
synagogue	Miserables.txt 1
synod	Miserables.txt 2
synonym	Miserables.txt 2
synonymous	Miserables.txt 3
syntax	Miserables.txt 1
synthetic	Miserables.txt 1
syracuse	Miserables.txt 1
syria	Miserables.txt 1
syrian	Miserables.txt 1
syringes	Miserables.txt 2
system	Miserables.txt 21
systems	Miserables.txt 5
