r	NotreDame_De_Paris.txt 4
ra	NotreDame_De_Paris.txt 1
rabbi	NotreDame_De_Paris.txt 1
rabble	NotreDame_De_Paris.txt 19
rabelais	NotreDame_De_Paris.txt 2
rabidness	NotreDame_De_Paris.txt 1
rabine	NotreDame_De_Paris.txt 1
race	NotreDame_De_Paris.txt 15
racer	NotreDame_De_Paris.txt 1
races	NotreDame_De_Paris.txt 4
racine	NotreDame_De_Paris.txt 1
rack	NotreDame_De_Paris.txt 2
racks	NotreDame_De_Paris.txt 1
radiance	NotreDame_De_Paris.txt 5
radiant	NotreDame_De_Paris.txt 7
radiantly	NotreDame_De_Paris.txt 1
radiating	NotreDame_De_Paris.txt 1
radical	NotreDame_De_Paris.txt 1
radin	NotreDame_De_Paris.txt 2
radish	NotreDame_De_Paris.txt 1
radius	NotreDame_De_Paris.txt 2
radolphus	NotreDame_De_Paris.txt 1
rag	NotreDame_De_Paris.txt 5
rage	NotreDame_De_Paris.txt 22
raged	NotreDame_De_Paris.txt 1
rages	NotreDame_De_Paris.txt 1
ragged	NotreDame_De_Paris.txt 5
raging	NotreDame_De_Paris.txt 1
rags	NotreDame_De_Paris.txt 14
raguier	NotreDame_De_Paris.txt 1
railing	NotreDame_De_Paris.txt 7
railleries	NotreDame_De_Paris.txt 1
raillery	NotreDame_De_Paris.txt 2
rain	NotreDame_De_Paris.txt 14
rained	NotreDame_De_Paris.txt 3
rainy	NotreDame_De_Paris.txt 1
raise	NotreDame_De_Paris.txt 13
raised	NotreDame_De_Paris.txt 86
raises	NotreDame_De_Paris.txt 1
raising	NotreDame_De_Paris.txt 12
rakes	NotreDame_De_Paris.txt 1
ralda	NotreDame_De_Paris.txt 1
rallied	NotreDame_De_Paris.txt 3
rallying	NotreDame_De_Paris.txt 1
ram	NotreDame_De_Paris.txt 9
ramifications	NotreDame_De_Paris.txt 2
ramonchamp	NotreDame_De_Paris.txt 1
ramparts	NotreDame_De_Paris.txt 1
rams	NotreDame_De_Paris.txt 1
ran	NotreDame_De_Paris.txt 41
ranch	NotreDame_De_Paris.txt 1
rancid	NotreDame_De_Paris.txt 1
rancor	NotreDame_De_Paris.txt 2
rang	NotreDame_De_Paris.txt 14
range	NotreDame_De_Paris.txt 1
ranged	NotreDame_De_Paris.txt 8
rank	NotreDame_De_Paris.txt 2
ranks	NotreDame_De_Paris.txt 7
ransack	NotreDame_De_Paris.txt 1
ransacked	NotreDame_De_Paris.txt 2
ransacking	NotreDame_De_Paris.txt 2
rape	NotreDame_De_Paris.txt 1
raphael	NotreDame_De_Paris.txt 4
rapid	NotreDame_De_Paris.txt 7
rapidity	NotreDame_De_Paris.txt 3
rapidly	NotreDame_De_Paris.txt 11
rapier	NotreDame_De_Paris.txt 1
rapine	NotreDame_De_Paris.txt 1
rapture	NotreDame_De_Paris.txt 4
raptures	NotreDame_De_Paris.txt 2
rarde	NotreDame_De_Paris.txt 2
rare	NotreDame_De_Paris.txt 20
rarely	NotreDame_De_Paris.txt 4
rarer	NotreDame_De_Paris.txt 2
rarest	NotreDame_De_Paris.txt 1
rarity	NotreDame_De_Paris.txt 1
rascal	NotreDame_De_Paris.txt 7
rascally	NotreDame_De_Paris.txt 2
rascals	NotreDame_De_Paris.txt 4
rash	NotreDame_De_Paris.txt 1
rat	NotreDame_De_Paris.txt 18
rate	NotreDame_De_Paris.txt 1
rather	NotreDame_De_Paris.txt 37
rats	NotreDame_De_Paris.txt 2
rattle	NotreDame_De_Paris.txt 5
rattled	NotreDame_De_Paris.txt 2
rault	NotreDame_De_Paris.txt 1
ravages	NotreDame_De_Paris.txt 2
ravaillac	NotreDame_De_Paris.txt 3
raved	NotreDame_De_Paris.txt 1
raven	NotreDame_De_Paris.txt 3
ravens	NotreDame_De_Paris.txt 3
ravine	NotreDame_De_Paris.txt 2
raving	NotreDame_De_Paris.txt 1
ravishing	NotreDame_De_Paris.txt 3
ray	NotreDame_De_Paris.txt 31
raymond	NotreDame_De_Paris.txt 1
rays	NotreDame_De_Paris.txt 7
razing	NotreDame_De_Paris.txt 1
re	NotreDame_De_Paris.txt 52
reach	NotreDame_De_Paris.txt 14
reached	NotreDame_De_Paris.txt 43
reaching	NotreDame_De_Paris.txt 3
react	NotreDame_De_Paris.txt 1
reaction	NotreDame_De_Paris.txt 1
read	NotreDame_De_Paris.txt 30
readable	NotreDame_De_Paris.txt 2
reader	NotreDame_De_Paris.txt 72
readers	NotreDame_De_Paris.txt 12
readily	NotreDame_De_Paris.txt 5
readiness	NotreDame_De_Paris.txt 2
reading	NotreDame_De_Paris.txt 15
readjusted	NotreDame_De_Paris.txt 1
reads	NotreDame_De_Paris.txt 2
ready	NotreDame_De_Paris.txt 16
real	NotreDame_De_Paris.txt 9
realities	NotreDame_De_Paris.txt 1
reality	NotreDame_De_Paris.txt 13
realized	NotreDame_De_Paris.txt 2
realizing	NotreDame_De_Paris.txt 1
really	NotreDame_De_Paris.txt 21
realm	NotreDame_De_Paris.txt 1
reanimated	NotreDame_De_Paris.txt 1
reap	NotreDame_De_Paris.txt 1
reaped	NotreDame_De_Paris.txt 1
reaping	NotreDame_De_Paris.txt 1
reappear	NotreDame_De_Paris.txt 2
reappeared	NotreDame_De_Paris.txt 2
reappears	NotreDame_De_Paris.txt 1
rear	NotreDame_De_Paris.txt 7
reared	NotreDame_De_Paris.txt 6
rearguard	NotreDame_De_Paris.txt 1
rearrangement	NotreDame_De_Paris.txt 1
rears	NotreDame_De_Paris.txt 1
reascended	NotreDame_De_Paris.txt 1
reason	NotreDame_De_Paris.txt 22
reasonable	NotreDame_De_Paris.txt 1
reasoning	NotreDame_De_Paris.txt 3
reasons	NotreDame_De_Paris.txt 6
reassured	NotreDame_De_Paris.txt 4
rebec	NotreDame_De_Paris.txt 1
rebecs	NotreDame_De_Paris.txt 3
rebel	NotreDame_De_Paris.txt 1
rebellion	NotreDame_De_Paris.txt 2
rebounded	NotreDame_De_Paris.txt 1
rebuild	NotreDame_De_Paris.txt 1
rebuilding	NotreDame_De_Paris.txt 1
rebus	NotreDame_De_Paris.txt 1
rebuses	NotreDame_De_Paris.txt 1
recall	NotreDame_De_Paris.txt 7
recalled	NotreDame_De_Paris.txt 17
recalling	NotreDame_De_Paris.txt 1
recalls	NotreDame_De_Paris.txt 1
recapitulate	NotreDame_De_Paris.txt 1
recaptured	NotreDame_De_Paris.txt 1
recast	NotreDame_De_Paris.txt 1
receipt	NotreDame_De_Paris.txt 2
receive	NotreDame_De_Paris.txt 14
received	NotreDame_De_Paris.txt 23
receivership	NotreDame_De_Paris.txt 2
receiving	NotreDame_De_Paris.txt 4
recent	NotreDame_De_Paris.txt 1
receptacle	NotreDame_De_Paris.txt 1
reception	NotreDame_De_Paris.txt 3
recipient	NotreDame_De_Paris.txt 1
recital	NotreDame_De_Paris.txt 1
recite	NotreDame_De_Paris.txt 1
recklessly	NotreDame_De_Paris.txt 1
reckon	NotreDame_De_Paris.txt 2
reckoned	NotreDame_De_Paris.txt 2
reckoning	NotreDame_De_Paris.txt 9
reclaim	NotreDame_De_Paris.txt 2
reclassing	NotreDame_De_Paris.txt 1
reclining	NotreDame_De_Paris.txt 1
recluse	NotreDame_De_Paris.txt 50
recluses	NotreDame_De_Paris.txt 2
recognition	NotreDame_De_Paris.txt 1
recognizable	NotreDame_De_Paris.txt 4
recognize	NotreDame_De_Paris.txt 19
recognized	NotreDame_De_Paris.txt 30
recognizing	NotreDame_De_Paris.txt 5
recoiled	NotreDame_De_Paris.txt 5
recollect	NotreDame_De_Paris.txt 1
recollection	NotreDame_De_Paris.txt 2
recommended	NotreDame_De_Paris.txt 1
recompense	NotreDame_De_Paris.txt 1
reconcile	NotreDame_De_Paris.txt 1
reconciled	NotreDame_De_Paris.txt 2
reconciliation	NotreDame_De_Paris.txt 1
reconstruct	NotreDame_De_Paris.txt 3
reconstructed	NotreDame_De_Paris.txt 1
records	NotreDame_De_Paris.txt 2
recover	NotreDame_De_Paris.txt 2
recovered	NotreDame_De_Paris.txt 8
recovering	NotreDame_De_Paris.txt 3
recovers	NotreDame_De_Paris.txt 1
recreation	NotreDame_De_Paris.txt 2
recreations	NotreDame_De_Paris.txt 1
recruited	NotreDame_De_Paris.txt 2
recteur	NotreDame_De_Paris.txt 3
rector	NotreDame_De_Paris.txt 15
recur	NotreDame_De_Paris.txt 1
recurred	NotreDame_De_Paris.txt 4
recurring	NotreDame_De_Paris.txt 1
red	NotreDame_De_Paris.txt 69
redden	NotreDame_De_Paris.txt 1
reddened	NotreDame_De_Paris.txt 5
reddest	NotreDame_De_Paris.txt 1
reddish	NotreDame_De_Paris.txt 4
redeem	NotreDame_De_Paris.txt 1
redeemed	NotreDame_De_Paris.txt 1
redistribute	NotreDame_De_Paris.txt 1
redistributing	NotreDame_De_Paris.txt 2
redistribution	NotreDame_De_Paris.txt 2
redness	NotreDame_De_Paris.txt 3
redouble	NotreDame_De_Paris.txt 4
redoubled	NotreDame_De_Paris.txt 12
redoubling	NotreDame_De_Paris.txt 2
redoubtable	NotreDame_De_Paris.txt 4
reds	NotreDame_De_Paris.txt 1
reduced	NotreDame_De_Paris.txt 3
reed	NotreDame_De_Paris.txt 2
reefs	NotreDame_De_Paris.txt 2
reeking	NotreDame_De_Paris.txt 1
reestablished	NotreDame_De_Paris.txt 1
refectories	NotreDame_De_Paris.txt 1
refectory	NotreDame_De_Paris.txt 1
refer	NotreDame_De_Paris.txt 1
reference	NotreDame_De_Paris.txt 1
references	NotreDame_De_Paris.txt 2
refers	NotreDame_De_Paris.txt 1
refinement	NotreDame_De_Paris.txt 2
reflect	NotreDame_De_Paris.txt 4
reflected	NotreDame_De_Paris.txt 7
reflecting	NotreDame_De_Paris.txt 5
reflection	NotreDame_De_Paris.txt 12
reflections	NotreDame_De_Paris.txt 4
reflects	NotreDame_De_Paris.txt 1
reform	NotreDame_De_Paris.txt 2
refraction	NotreDame_De_Paris.txt 2
refractory	NotreDame_De_Paris.txt 1
refrain	NotreDame_De_Paris.txt 8
refreshment	NotreDame_De_Paris.txt 2
refreshments	NotreDame_De_Paris.txt 1
refuge	NotreDame_De_Paris.txt 21
refugee	NotreDame_De_Paris.txt 1
refund	NotreDame_De_Paris.txt 10
refusal	NotreDame_De_Paris.txt 1
refuse	NotreDame_De_Paris.txt 3
refused	NotreDame_De_Paris.txt 7
regain	NotreDame_De_Paris.txt 1
regained	NotreDame_De_Paris.txt 4
regaining	NotreDame_De_Paris.txt 2
regale	NotreDame_De_Paris.txt 1
regaled	NotreDame_De_Paris.txt 1
regaling	NotreDame_De_Paris.txt 1
regalis	NotreDame_De_Paris.txt 1
regard	NotreDame_De_Paris.txt 4
regarde	NotreDame_De_Paris.txt 2
regarding	NotreDame_De_Paris.txt 4
reges	NotreDame_De_Paris.txt 1
regime	NotreDame_De_Paris.txt 1
regiment	NotreDame_De_Paris.txt 1
regions	NotreDame_De_Paris.txt 1
register	NotreDame_De_Paris.txt 6
registered	NotreDame_De_Paris.txt 3
registers	NotreDame_De_Paris.txt 1
registrar	NotreDame_De_Paris.txt 1
registration	NotreDame_De_Paris.txt 1
registries	NotreDame_De_Paris.txt 1
regnault	NotreDame_De_Paris.txt 1
regret	NotreDame_De_Paris.txt 11
regretted	NotreDame_De_Paris.txt 1
regretting	NotreDame_De_Paris.txt 1
regular	NotreDame_De_Paris.txt 9
regularibus	NotreDame_De_Paris.txt 1
regularity	NotreDame_De_Paris.txt 1
regularly	NotreDame_De_Paris.txt 1
regulated	NotreDame_De_Paris.txt 1
regulating	NotreDame_De_Paris.txt 3
regulations	NotreDame_De_Paris.txt 1
regulators	NotreDame_De_Paris.txt 1
reign	NotreDame_De_Paris.txt 8
reigned	NotreDame_De_Paris.txt 1
reims	NotreDame_De_Paris.txt 25
reins	NotreDame_De_Paris.txt 1
reintegration	NotreDame_De_Paris.txt 1
reject	NotreDame_De_Paris.txt 3
rejecta	NotreDame_De_Paris.txt 1
rejected	NotreDame_De_Paris.txt 3
rejoice	NotreDame_De_Paris.txt 1
rejoiced	NotreDame_De_Paris.txt 1
rejoices	NotreDame_De_Paris.txt 1
rejoicings	NotreDame_De_Paris.txt 1
rejoin	NotreDame_De_Paris.txt 1
rejoined	NotreDame_De_Paris.txt 4
relate	NotreDame_De_Paris.txt 2
related	NotreDame_De_Paris.txt 1
relates	NotreDame_De_Paris.txt 1
relation	NotreDame_De_Paris.txt 2
relationship	NotreDame_De_Paris.txt 1
relatives	NotreDame_De_Paris.txt 1
relax	NotreDame_De_Paris.txt 1
relaxation	NotreDame_De_Paris.txt 3
relaxed	NotreDame_De_Paris.txt 1
relaxing	NotreDame_De_Paris.txt 1
release	NotreDame_De_Paris.txt 9
released	NotreDame_De_Paris.txt 7
releasing	NotreDame_De_Paris.txt 3
relegated	NotreDame_De_Paris.txt 1
relic	NotreDame_De_Paris.txt 1
relics	NotreDame_De_Paris.txt 1
relief	NotreDame_De_Paris.txt 10
reliefs	NotreDame_De_Paris.txt 2
relieved	NotreDame_De_Paris.txt 5
religion	NotreDame_De_Paris.txt 13
religions	NotreDame_De_Paris.txt 1
religious	NotreDame_De_Paris.txt 12
reliquaries	NotreDame_De_Paris.txt 2
reliquary	NotreDame_De_Paris.txt 1
reluctance	NotreDame_De_Paris.txt 1
remain	NotreDame_De_Paris.txt 24
remainder	NotreDame_De_Paris.txt 2
remained	NotreDame_De_Paris.txt 100
remaining	NotreDame_De_Paris.txt 3
remains	NotreDame_De_Paris.txt 18
remark	NotreDame_De_Paris.txt 8
remarkable	NotreDame_De_Paris.txt 5
remarkably	NotreDame_De_Paris.txt 1
remarked	NotreDame_De_Paris.txt 13
remarking	NotreDame_De_Paris.txt 1
remarks	NotreDame_De_Paris.txt 6
rembrandt	NotreDame_De_Paris.txt 3
remedies	NotreDame_De_Paris.txt 2
remedy	NotreDame_De_Paris.txt 2
remember	NotreDame_De_Paris.txt 13
remembered	NotreDame_De_Paris.txt 11
remembers	NotreDame_De_Paris.txt 2
remind	NotreDame_De_Paris.txt 2
reminded	NotreDame_De_Paris.txt 5
reminding	NotreDame_De_Paris.txt 1
reminds	NotreDame_De_Paris.txt 2
reminiscences	NotreDame_De_Paris.txt 3
remnant	NotreDame_De_Paris.txt 5
remorse	NotreDame_De_Paris.txt 1
remounted	NotreDame_De_Paris.txt 1
removal	NotreDame_De_Paris.txt 1
remove	NotreDame_De_Paris.txt 1
removed	NotreDame_De_Paris.txt 10
removeth	NotreDame_De_Paris.txt 1
removing	NotreDame_De_Paris.txt 5
remy	NotreDame_De_Paris.txt 3
renaissance	NotreDame_De_Paris.txt 11
renamed	NotreDame_De_Paris.txt 1
renauld	NotreDame_De_Paris.txt 1
rend	NotreDame_De_Paris.txt 1
render	NotreDame_De_Paris.txt 8
rendered	NotreDame_De_Paris.txt 26
rendering	NotreDame_De_Paris.txt 1
renders	NotreDame_De_Paris.txt 5
rendezvous	NotreDame_De_Paris.txt 6
rending	NotreDame_De_Paris.txt 2
renew	NotreDame_De_Paris.txt 1
renewal	NotreDame_De_Paris.txt 1
renewed	NotreDame_De_Paris.txt 2
rennet	NotreDame_De_Paris.txt 10
renounced	NotreDame_De_Paris.txt 2
renown	NotreDame_De_Paris.txt 1
rent	NotreDame_De_Paris.txt 13
rents	NotreDame_De_Paris.txt 6
repaired	NotreDame_De_Paris.txt 1
repairing	NotreDame_De_Paris.txt 1
reparation	NotreDame_De_Paris.txt 1
repassing	NotreDame_De_Paris.txt 1
repast	NotreDame_De_Paris.txt 3
repay	NotreDame_De_Paris.txt 2
repeat	NotreDame_De_Paris.txt 3
repeated	NotreDame_De_Paris.txt 51
repeatedly	NotreDame_De_Paris.txt 1
repeating	NotreDame_De_Paris.txt 11
repeats	NotreDame_De_Paris.txt 1
repel	NotreDame_De_Paris.txt 2
repellent	NotreDame_De_Paris.txt 1
repent	NotreDame_De_Paris.txt 2
repeopled	NotreDame_De_Paris.txt 1
replace	NotreDame_De_Paris.txt 1
replaced	NotreDame_De_Paris.txt 9
replacement	NotreDame_De_Paris.txt 5
replaces	NotreDame_De_Paris.txt 1
replenished	NotreDame_De_Paris.txt 1
repleta	NotreDame_De_Paris.txt 1
replied	NotreDame_De_Paris.txt 167
replies	NotreDame_De_Paris.txt 2
reply	NotreDame_De_Paris.txt 28
replying	NotreDame_De_Paris.txt 1
repointed	NotreDame_De_Paris.txt 1
report	NotreDame_De_Paris.txt 2
reported	NotreDame_De_Paris.txt 1
reports	NotreDame_De_Paris.txt 1
repose	NotreDame_De_Paris.txt 3
reposed	NotreDame_De_Paris.txt 2
reposeful	NotreDame_De_Paris.txt 1
represent	NotreDame_De_Paris.txt 2
representation	NotreDame_De_Paris.txt 5
representations	NotreDame_De_Paris.txt 1
representative	NotreDame_De_Paris.txt 1
represented	NotreDame_De_Paris.txt 6
representing	NotreDame_De_Paris.txt 5
represents	NotreDame_De_Paris.txt 4
repress	NotreDame_De_Paris.txt 3
repressed	NotreDame_De_Paris.txt 2
reprieve	NotreDame_De_Paris.txt 1
reprint	NotreDame_De_Paris.txt 1
reproach	NotreDame_De_Paris.txt 6
reproached	NotreDame_De_Paris.txt 1
reproaches	NotreDame_De_Paris.txt 2
reproduce	NotreDame_De_Paris.txt 1
reproduced	NotreDame_De_Paris.txt 1
reproducing	NotreDame_De_Paris.txt 1
reptile	NotreDame_De_Paris.txt 1
republic	NotreDame_De_Paris.txt 1
republican	NotreDame_De_Paris.txt 2
repugnance	NotreDame_De_Paris.txt 2
repugnant	NotreDame_De_Paris.txt 1
repulse	NotreDame_De_Paris.txt 4
repulsed	NotreDame_De_Paris.txt 3
repulsive	NotreDame_De_Paris.txt 1
reputation	NotreDame_De_Paris.txt 7
reputed	NotreDame_De_Paris.txt 3
request	NotreDame_De_Paris.txt 5
requests	NotreDame_De_Paris.txt 2
require	NotreDame_De_Paris.txt 5
required	NotreDame_De_Paris.txt 18
requirements	NotreDame_De_Paris.txt 4
requirere	NotreDame_De_Paris.txt 1
requires	NotreDame_De_Paris.txt 2
requisition	NotreDame_De_Paris.txt 1
reread	NotreDame_De_Paris.txt 1
rerum	NotreDame_De_Paris.txt 1
res	NotreDame_De_Paris.txt 2
rescue	NotreDame_De_Paris.txt 8
rescued	NotreDame_De_Paris.txt 3
research	NotreDame_De_Paris.txt 2
resemblance	NotreDame_De_Paris.txt 4
resemble	NotreDame_De_Paris.txt 10
resembled	NotreDame_De_Paris.txt 16
resembles	NotreDame_De_Paris.txt 7
resemblest	NotreDame_De_Paris.txt 1
resembling	NotreDame_De_Paris.txt 1
resentment	NotreDame_De_Paris.txt 1
reserve	NotreDame_De_Paris.txt 5
reserved	NotreDame_De_Paris.txt 8
reservoir	NotreDame_De_Paris.txt 2
resided	NotreDame_De_Paris.txt 1
residences	NotreDame_De_Paris.txt 1
residue	NotreDame_De_Paris.txt 1
resign	NotreDame_De_Paris.txt 2
resignation	NotreDame_De_Paris.txt 2
resigned	NotreDame_De_Paris.txt 4
resist	NotreDame_De_Paris.txt 5
resistance	NotreDame_De_Paris.txt 13
resisted	NotreDame_De_Paris.txt 5
resisting	NotreDame_De_Paris.txt 2
resolute	NotreDame_De_Paris.txt 2
resolutely	NotreDame_De_Paris.txt 1
resolution	NotreDame_De_Paris.txt 5
resolved	NotreDame_De_Paris.txt 2
resort	NotreDame_De_Paris.txt 2
resound	NotreDame_De_Paris.txt 1
resounded	NotreDame_De_Paris.txt 3
resounds	NotreDame_De_Paris.txt 1
resource	NotreDame_De_Paris.txt 3
respect	NotreDame_De_Paris.txt 12
respectable	NotreDame_De_Paris.txt 2
respected	NotreDame_De_Paris.txt 1
respectful	NotreDame_De_Paris.txt 2
respective	NotreDame_De_Paris.txt 1
respite	NotreDame_De_Paris.txt 3
resplendent	NotreDame_De_Paris.txt 4
respond	NotreDame_De_Paris.txt 2
responded	NotreDame_De_Paris.txt 6
response	NotreDame_De_Paris.txt 3
responses	NotreDame_De_Paris.txt 3
responsibility	NotreDame_De_Paris.txt 1
responsible	NotreDame_De_Paris.txt 2
rest	NotreDame_De_Paris.txt 32
rested	NotreDame_De_Paris.txt 13
resting	NotreDame_De_Paris.txt 6
restless	NotreDame_De_Paris.txt 1
restoration	NotreDame_De_Paris.txt 1
restorations	NotreDame_De_Paris.txt 2
restore	NotreDame_De_Paris.txt 3
restored	NotreDame_De_Paris.txt 7
restores	NotreDame_De_Paris.txt 1
restrain	NotreDame_De_Paris.txt 1
restrained	NotreDame_De_Paris.txt 2
restrains	NotreDame_De_Paris.txt 1
restrictions	NotreDame_De_Paris.txt 2
rests	NotreDame_De_Paris.txt 1
result	NotreDame_De_Paris.txt 4
resulted	NotreDame_De_Paris.txt 1
resulting	NotreDame_De_Paris.txt 1
results	NotreDame_De_Paris.txt 4
resume	NotreDame_De_Paris.txt 2
resumed	NotreDame_De_Paris.txt 91
retain	NotreDame_De_Paris.txt 2
retained	NotreDame_De_Paris.txt 3
retaining	NotreDame_De_Paris.txt 1
reticence	NotreDame_De_Paris.txt 1
retif	NotreDame_De_Paris.txt 1
retire	NotreDame_De_Paris.txt 2
retired	NotreDame_De_Paris.txt 13
retort	NotreDame_De_Paris.txt 2
retorted	NotreDame_De_Paris.txt 16
retorts	NotreDame_De_Paris.txt 1
retrace	NotreDame_De_Paris.txt 3
retraced	NotreDame_De_Paris.txt 2
retracing	NotreDame_De_Paris.txt 2
retreat	NotreDame_De_Paris.txt 17
retreated	NotreDame_De_Paris.txt 12
retreating	NotreDame_De_Paris.txt 2
retrouveras	NotreDame_De_Paris.txt 1
return	NotreDame_De_Paris.txt 23
returned	NotreDame_De_Paris.txt 56
returning	NotreDame_De_Paris.txt 9
returns	NotreDame_De_Paris.txt 3
retying	NotreDame_De_Paris.txt 1
revealed	NotreDame_De_Paris.txt 4
revealing	NotreDame_De_Paris.txt 1
revenue	NotreDame_De_Paris.txt 2
revenues	NotreDame_De_Paris.txt 3
reverberated	NotreDame_De_Paris.txt 2
reverberating	NotreDame_De_Paris.txt 2
reverberation	NotreDame_De_Paris.txt 1
reverence	NotreDame_De_Paris.txt 3
reverences	NotreDame_De_Paris.txt 2
reverend	NotreDame_De_Paris.txt 11
reveries	NotreDame_De_Paris.txt 2
reverse	NotreDame_De_Paris.txt 2
reversed	NotreDame_De_Paris.txt 2
reversion	NotreDame_De_Paris.txt 1
revert	NotreDame_De_Paris.txt 1
revery	NotreDame_De_Paris.txt 14
revile	NotreDame_De_Paris.txt 1
revised	NotreDame_De_Paris.txt 1
revived	NotreDame_De_Paris.txt 3
revocations	NotreDame_De_Paris.txt 1
revolt	NotreDame_De_Paris.txt 13
revolts	NotreDame_De_Paris.txt 1
revolution	NotreDame_De_Paris.txt 10
revolutions	NotreDame_De_Paris.txt 4
reward	NotreDame_De_Paris.txt 2
rewrite	NotreDame_De_Paris.txt 2
rewriting	NotreDame_De_Paris.txt 1
rex	NotreDame_De_Paris.txt 1
rez	NotreDame_De_Paris.txt 1
rhamseion	NotreDame_De_Paris.txt 1
rhapsodies	NotreDame_De_Paris.txt 1
rhapsody	NotreDame_De_Paris.txt 1
rhyme	NotreDame_De_Paris.txt 1
rhymes	NotreDame_De_Paris.txt 1
rhymester	NotreDame_De_Paris.txt 1
rhythmics	NotreDame_De_Paris.txt 1
ribald	NotreDame_De_Paris.txt 1
ribbon	NotreDame_De_Paris.txt 2
ribbons	NotreDame_De_Paris.txt 6
rich	NotreDame_De_Paris.txt 24
richard	NotreDame_De_Paris.txt 1
richarde	NotreDame_De_Paris.txt 1
richelieu	NotreDame_De_Paris.txt 1
richer	NotreDame_De_Paris.txt 1
riches	NotreDame_De_Paris.txt 1
richly	NotreDame_De_Paris.txt 2
richness	NotreDame_De_Paris.txt 3
ricketty	NotreDame_De_Paris.txt 1
rickety	NotreDame_De_Paris.txt 1
rid	NotreDame_De_Paris.txt 6
ridden	NotreDame_De_Paris.txt 1
riddle	NotreDame_De_Paris.txt 1
ride	NotreDame_De_Paris.txt 1
rider	NotreDame_De_Paris.txt 2
rides	NotreDame_De_Paris.txt 2
ridge	NotreDame_De_Paris.txt 1
ridicule	NotreDame_De_Paris.txt 1
ridiculous	NotreDame_De_Paris.txt 5
ridiculously	NotreDame_De_Paris.txt 1
riding	NotreDame_De_Paris.txt 3
rifod	NotreDame_De_Paris.txt 1
riggers	NotreDame_De_Paris.txt 1
right	NotreDame_De_Paris.txt 74
rightly	NotreDame_De_Paris.txt 1
rights	NotreDame_De_Paris.txt 1
rigid	NotreDame_De_Paris.txt 2
rigidity	NotreDame_De_Paris.txt 1
rigor	NotreDame_De_Paris.txt 2
rigorously	NotreDame_De_Paris.txt 1
rim	NotreDame_De_Paris.txt 1
rind	NotreDame_De_Paris.txt 1
rinet	NotreDame_De_Paris.txt 1
ring	NotreDame_De_Paris.txt 9
ringer	NotreDame_De_Paris.txt 2
ringing	NotreDame_De_Paris.txt 9
ringlets	NotreDame_De_Paris.txt 1
rings	NotreDame_De_Paris.txt 6
riot	NotreDame_De_Paris.txt 2
rip	NotreDame_De_Paris.txt 1
ripped	NotreDame_De_Paris.txt 1
ripple	NotreDame_De_Paris.txt 1
rippling	NotreDame_De_Paris.txt 1
riqueza	NotreDame_De_Paris.txt 1
rise	NotreDame_De_Paris.txt 14
risen	NotreDame_De_Paris.txt 8
rises	NotreDame_De_Paris.txt 4
rising	NotreDame_De_Paris.txt 13
risk	NotreDame_De_Paris.txt 7
risked	NotreDame_De_Paris.txt 3
ritual	NotreDame_De_Paris.txt 1
rival	NotreDame_De_Paris.txt 3
rivalled	NotreDame_De_Paris.txt 1
rivalry	NotreDame_De_Paris.txt 2
river	NotreDame_De_Paris.txt 26
rivers	NotreDame_De_Paris.txt 1
riveted	NotreDame_De_Paris.txt 12
rivoli	NotreDame_De_Paris.txt 1
rixa	NotreDame_De_Paris.txt 1
road	NotreDame_De_Paris.txt 8
roads	NotreDame_De_Paris.txt 4
roam	NotreDame_De_Paris.txt 2
roamed	NotreDame_De_Paris.txt 1
roaming	NotreDame_De_Paris.txt 2
roar	NotreDame_De_Paris.txt 4
roared	NotreDame_De_Paris.txt 2
roaring	NotreDame_De_Paris.txt 3
roarings	NotreDame_De_Paris.txt 1
roars	NotreDame_De_Paris.txt 1
roast	NotreDame_De_Paris.txt 1
roasted	NotreDame_De_Paris.txt 1
roasting	NotreDame_De_Paris.txt 1
roastings	NotreDame_De_Paris.txt 1
robber	NotreDame_De_Paris.txt 2
robbers	NotreDame_De_Paris.txt 3
robbing	NotreDame_De_Paris.txt 1
robe	NotreDame_De_Paris.txt 24
robert	NotreDame_De_Paris.txt 19
robes	NotreDame_De_Paris.txt 12
robin	NotreDame_De_Paris.txt 17
robust	NotreDame_De_Paris.txt 2
robustus	NotreDame_De_Paris.txt 1
roch	NotreDame_De_Paris.txt 1
roche	NotreDame_De_Paris.txt 1
rock	NotreDame_De_Paris.txt 3
rockets	NotreDame_De_Paris.txt 1
rocking	NotreDame_De_Paris.txt 1
rode	NotreDame_De_Paris.txt 3
rods	NotreDame_De_Paris.txt 2
roelof	NotreDame_De_Paris.txt 1
roger	NotreDame_De_Paris.txt 1
rogue	NotreDame_De_Paris.txt 3
roi	NotreDame_De_Paris.txt 5
roland	NotreDame_De_Paris.txt 15
rolande	NotreDame_De_Paris.txt 3
role	NotreDame_De_Paris.txt 1
roles	NotreDame_De_Paris.txt 2
roll	NotreDame_De_Paris.txt 4
rolled	NotreDame_De_Paris.txt 4
rolling	NotreDame_De_Paris.txt 3
rolls	NotreDame_De_Paris.txt 3
roman	NotreDame_De_Paris.txt 33
romance	NotreDame_De_Paris.txt 9
romancero	NotreDame_De_Paris.txt 1
romanceros	NotreDame_De_Paris.txt 2
romanesque	NotreDame_De_Paris.txt 19
romans	NotreDame_De_Paris.txt 1
romanticism	NotreDame_De_Paris.txt 1
rome	NotreDame_De_Paris.txt 14
romeo	NotreDame_De_Paris.txt 1
rond	NotreDame_De_Paris.txt 3
rondelle	NotreDame_De_Paris.txt 1
rondo	NotreDame_De_Paris.txt 1
ronge	NotreDame_De_Paris.txt 2
roof	NotreDame_De_Paris.txt 44
roofed	NotreDame_De_Paris.txt 1
roofs	NotreDame_De_Paris.txt 37
roogny	NotreDame_De_Paris.txt 1
room	NotreDame_De_Paris.txt 33
rooms	NotreDame_De_Paris.txt 2
root	NotreDame_De_Paris.txt 2
rooted	NotreDame_De_Paris.txt 2
roots	NotreDame_De_Paris.txt 3
rope	NotreDame_De_Paris.txt 27
roped	NotreDame_De_Paris.txt 1
ropes	NotreDame_De_Paris.txt 5
rosa	NotreDame_De_Paris.txt 1
rosaries	NotreDame_De_Paris.txt 1
rose	NotreDame_De_Paris.txt 74
roses	NotreDame_De_Paris.txt 2
rosettes	NotreDame_De_Paris.txt 2
rosier	NotreDame_De_Paris.txt 1
rosin	NotreDame_De_Paris.txt 1
rostrum	NotreDame_De_Paris.txt 1
rostrums	NotreDame_De_Paris.txt 1
rosy	NotreDame_De_Paris.txt 6
rot	NotreDame_De_Paris.txt 2
rota	NotreDame_De_Paris.txt 1
rotary	NotreDame_De_Paris.txt 1
rotatory	NotreDame_De_Paris.txt 4
rotisserie	NotreDame_De_Paris.txt 1
rotted	NotreDame_De_Paris.txt 2
rotten	NotreDame_De_Paris.txt 1
rotterdam	NotreDame_De_Paris.txt 1
rotting	NotreDame_De_Paris.txt 1
rouault	NotreDame_De_Paris.txt 2
rouen	NotreDame_De_Paris.txt 1
rouge	NotreDame_De_Paris.txt 3
rough	NotreDame_De_Paris.txt 16
roughly	NotreDame_De_Paris.txt 8
round	NotreDame_De_Paris.txt 84
rounded	NotreDame_De_Paris.txt 7
rounds	NotreDame_De_Paris.txt 1
rouse	NotreDame_De_Paris.txt 1
roused	NotreDame_De_Paris.txt 8
rousseau	NotreDame_De_Paris.txt 3
roussillon	NotreDame_De_Paris.txt 1
rout	NotreDame_De_Paris.txt 4
route	NotreDame_De_Paris.txt 1
rouvray	NotreDame_De_Paris.txt 1
row	NotreDame_De_Paris.txt 12
rowed	NotreDame_De_Paris.txt 2
rowels	NotreDame_De_Paris.txt 1
rowing	NotreDame_De_Paris.txt 3
rows	NotreDame_De_Paris.txt 3
royal	NotreDame_De_Paris.txt 20
royale	NotreDame_De_Paris.txt 3
royalties	NotreDame_De_Paris.txt 2
royalty	NotreDame_De_Paris.txt 4
rubbed	NotreDame_De_Paris.txt 4
rubbing	NotreDame_De_Paris.txt 1
rubbish	NotreDame_De_Paris.txt 4
rubble	NotreDame_De_Paris.txt 1
rubebbe	NotreDame_De_Paris.txt 1
ruby	NotreDame_De_Paris.txt 1
ruddy	NotreDame_De_Paris.txt 2
rude	NotreDame_De_Paris.txt 2
rudely	NotreDame_De_Paris.txt 3
rudiment	NotreDame_De_Paris.txt 1
rue	NotreDame_De_Paris.txt 94
rues	NotreDame_De_Paris.txt 3
ruff	NotreDame_De_Paris.txt 1
ruffians	NotreDame_De_Paris.txt 3
ruffled	NotreDame_De_Paris.txt 1
ruffles	NotreDame_De_Paris.txt 1
ruffs	NotreDame_De_Paris.txt 1
rug	NotreDame_De_Paris.txt 1
ruin	NotreDame_De_Paris.txt 6
ruined	NotreDame_De_Paris.txt 11
ruining	NotreDame_De_Paris.txt 2
ruinous	NotreDame_De_Paris.txt 1
ruins	NotreDame_De_Paris.txt 11
rule	NotreDame_De_Paris.txt 3
ruled	NotreDame_De_Paris.txt 1
rules	NotreDame_De_Paris.txt 3
rully	NotreDame_De_Paris.txt 1
rumbling	NotreDame_De_Paris.txt 2
ruminated	NotreDame_De_Paris.txt 1
rummage	NotreDame_De_Paris.txt 1
rummaged	NotreDame_De_Paris.txt 1
rummaging	NotreDame_De_Paris.txt 3
rumor	NotreDame_De_Paris.txt 1
rumors	NotreDame_De_Paris.txt 3
rumpling	NotreDame_De_Paris.txt 1
run	NotreDame_De_Paris.txt 22
runaway	NotreDame_De_Paris.txt 1
runaways	NotreDame_De_Paris.txt 1
rung	NotreDame_De_Paris.txt 2
rungs	NotreDame_De_Paris.txt 2
running	NotreDame_De_Paris.txt 23
runs	NotreDame_De_Paris.txt 5
ruse	NotreDame_De_Paris.txt 1
rush	NotreDame_De_Paris.txt 3
rushed	NotreDame_De_Paris.txt 15
rushes	NotreDame_De_Paris.txt 1
rushing	NotreDame_De_Paris.txt 1
russia	NotreDame_De_Paris.txt 1
rusted	NotreDame_De_Paris.txt 6
rustic	NotreDame_De_Paris.txt 2
rustics	NotreDame_De_Paris.txt 4
rustled	NotreDame_De_Paris.txt 2
rustling	NotreDame_De_Paris.txt 1
rusty	NotreDame_De_Paris.txt 4
ry	NotreDame_De_Paris.txt 5
rye	NotreDame_De_Paris.txt 1
rym	NotreDame_De_Paris.txt 26
