f	NotreDame_De_Paris.txt 16
fa	NotreDame_De_Paris.txt 38
fac	NotreDame_De_Paris.txt 2
facade	NotreDame_De_Paris.txt 1
face	NotreDame_De_Paris.txt 164
faced	NotreDame_De_Paris.txt 4
faces	NotreDame_De_Paris.txt 30
faceted	NotreDame_De_Paris.txt 1
facets	NotreDame_De_Paris.txt 1
facies	NotreDame_De_Paris.txt 1
facile	NotreDame_De_Paris.txt 1
facility	NotreDame_De_Paris.txt 1
facing	NotreDame_De_Paris.txt 1
facit	NotreDame_De_Paris.txt 1
facitote	NotreDame_De_Paris.txt 2
fact	NotreDame_De_Paris.txt 95
faction	NotreDame_De_Paris.txt 1
facts	NotreDame_De_Paris.txt 4
faculties	NotreDame_De_Paris.txt 4
faculty	NotreDame_De_Paris.txt 2
faded	NotreDame_De_Paris.txt 1
fades	NotreDame_De_Paris.txt 1
fading	NotreDame_De_Paris.txt 1
fagot	NotreDame_De_Paris.txt 11
fagots	NotreDame_De_Paris.txt 4
faience	NotreDame_De_Paris.txt 1
failed	NotreDame_De_Paris.txt 3
failing	NotreDame_De_Paris.txt 2
failure	NotreDame_De_Paris.txt 4
faint	NotreDame_De_Paris.txt 1
fainted	NotreDame_De_Paris.txt 2
fainting	NotreDame_De_Paris.txt 2
fair	NotreDame_De_Paris.txt 34
fairbanks	NotreDame_De_Paris.txt 1
faire	NotreDame_De_Paris.txt 1
fairest	NotreDame_De_Paris.txt 1
fairly	NotreDame_De_Paris.txt 3
fairy	NotreDame_De_Paris.txt 3
fairylike	NotreDame_De_Paris.txt 1
faith	NotreDame_De_Paris.txt 17
faithful	NotreDame_De_Paris.txt 7
fall	NotreDame_De_Paris.txt 39
fallen	NotreDame_De_Paris.txt 17
falling	NotreDame_De_Paris.txt 16
falls	NotreDame_De_Paris.txt 2
falourdel	NotreDame_De_Paris.txt 13
false	NotreDame_De_Paris.txt 5
falsely	NotreDame_De_Paris.txt 1
falsetto	NotreDame_De_Paris.txt 1
faltered	NotreDame_De_Paris.txt 1
falzapada	NotreDame_De_Paris.txt 1
fame	NotreDame_De_Paris.txt 2
familiar	NotreDame_De_Paris.txt 8
familiarly	NotreDame_De_Paris.txt 2
families	NotreDame_De_Paris.txt 2
family	NotreDame_De_Paris.txt 15
famine	NotreDame_De_Paris.txt 2
famished	NotreDame_De_Paris.txt 2
famous	NotreDame_De_Paris.txt 13
fancied	NotreDame_De_Paris.txt 9
fancies	NotreDame_De_Paris.txt 4
fanciful	NotreDame_De_Paris.txt 3
fancy	NotreDame_De_Paris.txt 13
fandangoes	NotreDame_De_Paris.txt 1
fanouel	NotreDame_De_Paris.txt 1
fantasies	NotreDame_De_Paris.txt 1
fantastic	NotreDame_De_Paris.txt 12
fantastical	NotreDame_De_Paris.txt 1
fantastically	NotreDame_De_Paris.txt 4
far	NotreDame_De_Paris.txt 72
farce	NotreDame_De_Paris.txt 3
fare	NotreDame_De_Paris.txt 1
farewell	NotreDame_De_Paris.txt 6
fargel	NotreDame_De_Paris.txt 1
farm	NotreDame_De_Paris.txt 2
farmer	NotreDame_De_Paris.txt 2
farrier	NotreDame_De_Paris.txt 1
farriers	NotreDame_De_Paris.txt 1
farther	NotreDame_De_Paris.txt 7
farthing	NotreDame_De_Paris.txt 2
farthings	NotreDame_De_Paris.txt 6
fas	NotreDame_De_Paris.txt 1
fascinated	NotreDame_De_Paris.txt 3
fascination	NotreDame_De_Paris.txt 3
fashion	NotreDame_De_Paris.txt 35
fashionable	NotreDame_De_Paris.txt 1
fashioned	NotreDame_De_Paris.txt 2
fashioning	NotreDame_De_Paris.txt 1
fashions	NotreDame_De_Paris.txt 3
fast	NotreDame_De_Paris.txt 8
fastened	NotreDame_De_Paris.txt 13
faster	NotreDame_De_Paris.txt 1
fasting	NotreDame_De_Paris.txt 2
fat	NotreDame_De_Paris.txt 6
fatal	NotreDame_De_Paris.txt 18
fatality	NotreDame_De_Paris.txt 4
fate	NotreDame_De_Paris.txt 13
father	NotreDame_De_Paris.txt 46
fathers	NotreDame_De_Paris.txt 3
fathomed	NotreDame_De_Paris.txt 1
fathoms	NotreDame_De_Paris.txt 1
fatigue	NotreDame_De_Paris.txt 8
fatigued	NotreDame_De_Paris.txt 2
fatten	NotreDame_De_Paris.txt 1
fatuity	NotreDame_De_Paris.txt 1
fatum	NotreDame_De_Paris.txt 1
faubin	NotreDame_De_Paris.txt 1
faubourg	NotreDame_De_Paris.txt 4
faubourgs	NotreDame_De_Paris.txt 2
fault	NotreDame_De_Paris.txt 11
faults	NotreDame_De_Paris.txt 3
faun	NotreDame_De_Paris.txt 1
faust	NotreDame_De_Paris.txt 2
favor	NotreDame_De_Paris.txt 6
favorable	NotreDame_De_Paris.txt 3
favored	NotreDame_De_Paris.txt 6
favorite	NotreDame_De_Paris.txt 3
favorites	NotreDame_De_Paris.txt 1
favyn	NotreDame_De_Paris.txt 1
fawn	NotreDame_De_Paris.txt 3
fear	NotreDame_De_Paris.txt 30
feared	NotreDame_De_Paris.txt 10
fears	NotreDame_De_Paris.txt 2
feast	NotreDame_De_Paris.txt 7
feasted	NotreDame_De_Paris.txt 1
feasting	NotreDame_De_Paris.txt 2
feasts	NotreDame_De_Paris.txt 2
feather	NotreDame_De_Paris.txt 3
feathered	NotreDame_De_Paris.txt 1
feathers	NotreDame_De_Paris.txt 1
feats	NotreDame_De_Paris.txt 3
feature	NotreDame_De_Paris.txt 1
features	NotreDame_De_Paris.txt 5
february	NotreDame_De_Paris.txt 1
febves	NotreDame_De_Paris.txt 1
fecund	NotreDame_De_Paris.txt 1
fed	NotreDame_De_Paris.txt 1
federal	NotreDame_De_Paris.txt 2
fee	NotreDame_De_Paris.txt 9
feeble	NotreDame_De_Paris.txt 6
feebleness	NotreDame_De_Paris.txt 1
feebly	NotreDame_De_Paris.txt 3
feed	NotreDame_De_Paris.txt 1
feeding	NotreDame_De_Paris.txt 1
feel	NotreDame_De_Paris.txt 20
feeling	NotreDame_De_Paris.txt 16
feels	NotreDame_De_Paris.txt 12
fees	NotreDame_De_Paris.txt 4
feet	NotreDame_De_Paris.txt 110
feigned	NotreDame_De_Paris.txt 1
felicitations	NotreDame_De_Paris.txt 1
felicity	NotreDame_De_Paris.txt 1
fell	NotreDame_De_Paris.txt 79
fellow	NotreDame_De_Paris.txt 28
fellows	NotreDame_De_Paris.txt 7
felt	NotreDame_De_Paris.txt 91
female	NotreDame_De_Paris.txt 16
females	NotreDame_De_Paris.txt 1
feminine	NotreDame_De_Paris.txt 4
fen	NotreDame_De_Paris.txt 1
fence	NotreDame_De_Paris.txt 1
fenced	NotreDame_De_Paris.txt 1
ferment	NotreDame_De_Paris.txt 3
ferments	NotreDame_De_Paris.txt 1
fernicle	NotreDame_De_Paris.txt 1
ferocious	NotreDame_De_Paris.txt 1
ferronnerie	NotreDame_De_Paris.txt 1
ferrution	NotreDame_De_Paris.txt 1
ferryman	NotreDame_De_Paris.txt 5
fertile	NotreDame_De_Paris.txt 1
fervent	NotreDame_De_Paris.txt 1
festival	NotreDame_De_Paris.txt 17
festivals	NotreDame_De_Paris.txt 4
fetter	NotreDame_De_Paris.txt 1
fetters	NotreDame_De_Paris.txt 1
feu	NotreDame_De_Paris.txt 2
feudal	NotreDame_De_Paris.txt 9
feudalism	NotreDame_De_Paris.txt 5
feuillage	NotreDame_De_Paris.txt 1
fever	NotreDame_De_Paris.txt 3
fevers	NotreDame_De_Paris.txt 1
few	NotreDame_De_Paris.txt 77
fiat	NotreDame_De_Paris.txt 2
fibre	NotreDame_De_Paris.txt 1
fibres	NotreDame_De_Paris.txt 2
fibrous	NotreDame_De_Paris.txt 1
fickle	NotreDame_De_Paris.txt 1
fictitious	NotreDame_De_Paris.txt 1
ficulnus	NotreDame_De_Paris.txt 1
fiddler	NotreDame_De_Paris.txt 1
fidelitas	NotreDame_De_Paris.txt 1
fidelity	NotreDame_De_Paris.txt 2
fie	NotreDame_De_Paris.txt 2
fief	NotreDame_De_Paris.txt 10
fiefs	NotreDame_De_Paris.txt 1
field	NotreDame_De_Paris.txt 12
fields	NotreDame_De_Paris.txt 8
fierce	NotreDame_De_Paris.txt 6
fiery	NotreDame_De_Paris.txt 3
fife	NotreDame_De_Paris.txt 2
fifteen	NotreDame_De_Paris.txt 25
fifteenth	NotreDame_De_Paris.txt 29
fifth	NotreDame_De_Paris.txt 5
fifty	NotreDame_De_Paris.txt 13
figaro	NotreDame_De_Paris.txt 1
fight	NotreDame_De_Paris.txt 3
fighters	NotreDame_De_Paris.txt 1
fighting	NotreDame_De_Paris.txt 2
figuras	NotreDame_De_Paris.txt 1
figuratively	NotreDame_De_Paris.txt 1
figure	NotreDame_De_Paris.txt 24
figured	NotreDame_De_Paris.txt 4
figures	NotreDame_De_Paris.txt 25
figuring	NotreDame_De_Paris.txt 1
figuris	NotreDame_De_Paris.txt 1
file	NotreDame_De_Paris.txt 7
files	NotreDame_De_Paris.txt 2
filial	NotreDame_De_Paris.txt 1
fill	NotreDame_De_Paris.txt 4
fille	NotreDame_De_Paris.txt 3
filled	NotreDame_De_Paris.txt 28
filles	NotreDame_De_Paris.txt 1
fillip	NotreDame_De_Paris.txt 1
fills	NotreDame_De_Paris.txt 4
filtered	NotreDame_De_Paris.txt 1
filtering	NotreDame_De_Paris.txt 1
filters	NotreDame_De_Paris.txt 1
filth	NotreDame_De_Paris.txt 1
final	NotreDame_De_Paris.txt 6
finally	NotreDame_De_Paris.txt 23
finances	NotreDame_De_Paris.txt 1
financial	NotreDame_De_Paris.txt 1
find	NotreDame_De_Paris.txt 41
finding	NotreDame_De_Paris.txt 8
finds	NotreDame_De_Paris.txt 10
fine	NotreDame_De_Paris.txt 126
fined	NotreDame_De_Paris.txt 1
finely	NotreDame_De_Paris.txt 1
fineness	NotreDame_De_Paris.txt 1
finer	NotreDame_De_Paris.txt 2
fines	NotreDame_De_Paris.txt 1
finest	NotreDame_De_Paris.txt 8
finger	NotreDame_De_Paris.txt 25
fingering	NotreDame_De_Paris.txt 1
fingers	NotreDame_De_Paris.txt 15
finish	NotreDame_De_Paris.txt 10
finished	NotreDame_De_Paris.txt 19
finishes	NotreDame_De_Paris.txt 1
fioriture	NotreDame_De_Paris.txt 1
fire	NotreDame_De_Paris.txt 85
firebrand	NotreDame_De_Paris.txt 2
fired	NotreDame_De_Paris.txt 1
fires	NotreDame_De_Paris.txt 5
firewood	NotreDame_De_Paris.txt 2
firework	NotreDame_De_Paris.txt 1
fireworks	NotreDame_De_Paris.txt 1
firm	NotreDame_De_Paris.txt 9
firmly	NotreDame_De_Paris.txt 3
firmness	NotreDame_De_Paris.txt 2
first	NotreDame_De_Paris.txt 185
fish	NotreDame_De_Paris.txt 5
fishes	NotreDame_De_Paris.txt 3
fishponds	NotreDame_De_Paris.txt 2
fishwife	NotreDame_De_Paris.txt 1
fissures	NotreDame_De_Paris.txt 2
fist	NotreDame_De_Paris.txt 6
fists	NotreDame_De_Paris.txt 12
fit	NotreDame_De_Paris.txt 8
fitness	NotreDame_De_Paris.txt 1
fits	NotreDame_De_Paris.txt 1
fitted	NotreDame_De_Paris.txt 6
fitting	NotreDame_De_Paris.txt 3
five	NotreDame_De_Paris.txt 35
fix	NotreDame_De_Paris.txt 3
fixed	NotreDame_De_Paris.txt 38
fixedly	NotreDame_De_Paris.txt 4
fixing	NotreDame_De_Paris.txt 4
fl	NotreDame_De_Paris.txt 1
flabbily	NotreDame_De_Paris.txt 1
flagellate	NotreDame_De_Paris.txt 1
flagging	NotreDame_De_Paris.txt 2
flagon	NotreDame_De_Paris.txt 2
flagstone	NotreDame_De_Paris.txt 1
flagstones	NotreDame_De_Paris.txt 2
flakes	NotreDame_De_Paris.txt 1
flambeaux	NotreDame_De_Paris.txt 1
flame	NotreDame_De_Paris.txt 22
flamed	NotreDame_De_Paris.txt 2
flamel	NotreDame_De_Paris.txt 15
flames	NotreDame_De_Paris.txt 6
flaming	NotreDame_De_Paris.txt 9
flamma	NotreDame_De_Paris.txt 1
flanders	NotreDame_De_Paris.txt 16
flank	NotreDame_De_Paris.txt 1
flanked	NotreDame_De_Paris.txt 6
flanks	NotreDame_De_Paris.txt 3
flaring	NotreDame_De_Paris.txt 2
flash	NotreDame_De_Paris.txt 18
flashed	NotreDame_De_Paris.txt 11
flashes	NotreDame_De_Paris.txt 2
flashing	NotreDame_De_Paris.txt 6
flasks	NotreDame_De_Paris.txt 1
flat	NotreDame_De_Paris.txt 10
flattened	NotreDame_De_Paris.txt 5
flattered	NotreDame_De_Paris.txt 2
flattering	NotreDame_De_Paris.txt 1
flax	NotreDame_De_Paris.txt 1
flay	NotreDame_De_Paris.txt 1
flayed	NotreDame_De_Paris.txt 2
flayer	NotreDame_De_Paris.txt 1
fleas	NotreDame_De_Paris.txt 2
fled	NotreDame_De_Paris.txt 19
flee	NotreDame_De_Paris.txt 11
fleece	NotreDame_De_Paris.txt 3
fleecy	NotreDame_De_Paris.txt 1
fleeing	NotreDame_De_Paris.txt 2
fleming	NotreDame_De_Paris.txt 1
flemings	NotreDame_De_Paris.txt 18
flemish	NotreDame_De_Paris.txt 27
flesh	NotreDame_De_Paris.txt 18
fleshless	NotreDame_De_Paris.txt 5
fleur	NotreDame_De_Paris.txt 62
fleuries	NotreDame_De_Paris.txt 1
fleurs	NotreDame_De_Paris.txt 6
flew	NotreDame_De_Paris.txt 7
flickered	NotreDame_De_Paris.txt 3
flickering	NotreDame_De_Paris.txt 3
flies	NotreDame_De_Paris.txt 7
flight	NotreDame_De_Paris.txt 16
fling	NotreDame_De_Paris.txt 13
flinging	NotreDame_De_Paris.txt 5
flit	NotreDame_De_Paris.txt 1
flitted	NotreDame_De_Paris.txt 3
float	NotreDame_De_Paris.txt 2
floated	NotreDame_De_Paris.txt 2
floating	NotreDame_De_Paris.txt 7
floats	NotreDame_De_Paris.txt 2
flock	NotreDame_De_Paris.txt 3
flocks	NotreDame_De_Paris.txt 2
flog	NotreDame_De_Paris.txt 1
flogged	NotreDame_De_Paris.txt 1
flood	NotreDame_De_Paris.txt 8
flooded	NotreDame_De_Paris.txt 1
floods	NotreDame_De_Paris.txt 5
floor	NotreDame_De_Paris.txt 30
florentine	NotreDame_De_Paris.txt 1
florian	NotreDame_De_Paris.txt 14
florin	NotreDame_De_Paris.txt 1
flounce	NotreDame_De_Paris.txt 1
floundered	NotreDame_De_Paris.txt 1
flourish	NotreDame_De_Paris.txt 1
flow	NotreDame_De_Paris.txt 4
flowed	NotreDame_De_Paris.txt 5
flower	NotreDame_De_Paris.txt 3
flowered	NotreDame_De_Paris.txt 1
flowers	NotreDame_De_Paris.txt 13
flowing	NotreDame_De_Paris.txt 3
flows	NotreDame_De_Paris.txt 1
fluctus	NotreDame_De_Paris.txt 1
fluid	NotreDame_De_Paris.txt 1
flumem	NotreDame_De_Paris.txt 1
flung	NotreDame_De_Paris.txt 38
flush	NotreDame_De_Paris.txt 3
flute	NotreDame_De_Paris.txt 2
fluted	NotreDame_De_Paris.txt 1
flutes	NotreDame_De_Paris.txt 2
fluttering	NotreDame_De_Paris.txt 1
fluvio	NotreDame_De_Paris.txt 1
flux	NotreDame_De_Paris.txt 1
fly	NotreDame_De_Paris.txt 26
flying	NotreDame_De_Paris.txt 14
fo	NotreDame_De_Paris.txt 1
foamed	NotreDame_De_Paris.txt 2
foaming	NotreDame_De_Paris.txt 5
fob	NotreDame_De_Paris.txt 2
fog	NotreDame_De_Paris.txt 4
foh	NotreDame_De_Paris.txt 1
foi	NotreDame_De_Paris.txt 1
foin	NotreDame_De_Paris.txt 3
foix	NotreDame_De_Paris.txt 1
fold	NotreDame_De_Paris.txt 3
folded	NotreDame_De_Paris.txt 6
folds	NotreDame_De_Paris.txt 5
foliage	NotreDame_De_Paris.txt 8
folio	NotreDame_De_Paris.txt 2
folk	NotreDame_De_Paris.txt 1
folks	NotreDame_De_Paris.txt 1
folle	NotreDame_De_Paris.txt 3
follies	NotreDame_De_Paris.txt 2
follow	NotreDame_De_Paris.txt 27
followed	NotreDame_De_Paris.txt 49
follower	NotreDame_De_Paris.txt 1
followers	NotreDame_De_Paris.txt 1
following	NotreDame_De_Paris.txt 24
follows	NotreDame_De_Paris.txt 3
folly	NotreDame_De_Paris.txt 9
fond	NotreDame_De_Paris.txt 6
fondled	NotreDame_De_Paris.txt 1
fondling	NotreDame_De_Paris.txt 2
font	NotreDame_De_Paris.txt 3
fontaine	NotreDame_De_Paris.txt 2
food	NotreDame_De_Paris.txt 2
fool	NotreDame_De_Paris.txt 11
foolish	NotreDame_De_Paris.txt 8
fools	NotreDame_De_Paris.txt 30
foot	NotreDame_De_Paris.txt 80
footed	NotreDame_De_Paris.txt 2
foothold	NotreDame_De_Paris.txt 1
footpad	NotreDame_De_Paris.txt 1
footstep	NotreDame_De_Paris.txt 1
for	NotreDame_De_Paris.txt 952
forbade	NotreDame_De_Paris.txt 2
forbidden	NotreDame_De_Paris.txt 3
forbidding	NotreDame_De_Paris.txt 1
force	NotreDame_De_Paris.txt 28
forced	NotreDame_De_Paris.txt 20
forceps	NotreDame_De_Paris.txt 1
forces	NotreDame_De_Paris.txt 5
forcibly	NotreDame_De_Paris.txt 3
forcing	NotreDame_De_Paris.txt 3
fore	NotreDame_De_Paris.txt 3
forefinger	NotreDame_De_Paris.txt 2
forehead	NotreDame_De_Paris.txt 4
foreheads	NotreDame_De_Paris.txt 1
foreign	NotreDame_De_Paris.txt 2
foremost	NotreDame_De_Paris.txt 2
forepaws	NotreDame_De_Paris.txt 1
foreseeing	NotreDame_De_Paris.txt 1
foreseen	NotreDame_De_Paris.txt 2
forest	NotreDame_De_Paris.txt 9
forests	NotreDame_De_Paris.txt 4
foretold	NotreDame_De_Paris.txt 1
forever	NotreDame_De_Paris.txt 10
forge	NotreDame_De_Paris.txt 3
forget	NotreDame_De_Paris.txt 8
forgetfulness	NotreDame_De_Paris.txt 2
forgetting	NotreDame_De_Paris.txt 6
forgive	NotreDame_De_Paris.txt 2
forgot	NotreDame_De_Paris.txt 5
forgotten	NotreDame_De_Paris.txt 21
forismaritagium	NotreDame_De_Paris.txt 1
fork	NotreDame_De_Paris.txt 1
forked	NotreDame_De_Paris.txt 1
forks	NotreDame_De_Paris.txt 1
form	NotreDame_De_Paris.txt 75
formal	NotreDame_De_Paris.txt 2
format	NotreDame_De_Paris.txt 4
formation	NotreDame_De_Paris.txt 3
formations	NotreDame_De_Paris.txt 2
formats	NotreDame_De_Paris.txt 2
formed	NotreDame_De_Paris.txt 45
former	NotreDame_De_Paris.txt 7
formerly	NotreDame_De_Paris.txt 11
formidable	NotreDame_De_Paris.txt 30
forming	NotreDame_De_Paris.txt 4
formless	NotreDame_De_Paris.txt 1
formoe	NotreDame_De_Paris.txt 1
forms	NotreDame_De_Paris.txt 18
formula	NotreDame_De_Paris.txt 3
formulas	NotreDame_De_Paris.txt 1
formulate	NotreDame_De_Paris.txt 1
formulated	NotreDame_De_Paris.txt 2
fornication	NotreDame_De_Paris.txt 1
forte	NotreDame_De_Paris.txt 1
fortescue	NotreDame_De_Paris.txt 1
forth	NotreDame_De_Paris.txt 65
fortieth	NotreDame_De_Paris.txt 1
fortification	NotreDame_De_Paris.txt 1
fortifications	NotreDame_De_Paris.txt 2
fortified	NotreDame_De_Paris.txt 3
fortnight	NotreDame_De_Paris.txt 2
fortress	NotreDame_De_Paris.txt 8
fortresses	NotreDame_De_Paris.txt 3
fortunate	NotreDame_De_Paris.txt 3
fortunately	NotreDame_De_Paris.txt 8
fortune	NotreDame_De_Paris.txt 5
fortunes	NotreDame_De_Paris.txt 3
forty	NotreDame_De_Paris.txt 16
forward	NotreDame_De_Paris.txt 5
foster	NotreDame_De_Paris.txt 1
fouarre	NotreDame_De_Paris.txt 1
fought	NotreDame_De_Paris.txt 2
foul	NotreDame_De_Paris.txt 1
found	NotreDame_De_Paris.txt 86
foundation	NotreDame_De_Paris.txt 32
foundations	NotreDame_De_Paris.txt 2
founded	NotreDame_De_Paris.txt 3
founding	NotreDame_De_Paris.txt 1
foundling	NotreDame_De_Paris.txt 9
foundlings	NotreDame_De_Paris.txt 5
foundries	NotreDame_De_Paris.txt 1
fountain	NotreDame_De_Paris.txt 4
fountains	NotreDame_De_Paris.txt 1
four	NotreDame_De_Paris.txt 107
fourbault	NotreDame_De_Paris.txt 4
fourrata	NotreDame_De_Paris.txt 1
fourratis	NotreDame_De_Paris.txt 1
fours	NotreDame_De_Paris.txt 4
fourteen	NotreDame_De_Paris.txt 8
fourteenth	NotreDame_De_Paris.txt 3
fourth	NotreDame_De_Paris.txt 8
fowl	NotreDame_De_Paris.txt 2
fox	NotreDame_De_Paris.txt 5
fr	NotreDame_De_Paris.txt 2
fracture	NotreDame_De_Paris.txt 1
fractures	NotreDame_De_Paris.txt 2
fragile	NotreDame_De_Paris.txt 6
fragment	NotreDame_De_Paris.txt 4
fragments	NotreDame_De_Paris.txt 8
frail	NotreDame_De_Paris.txt 13
frame	NotreDame_De_Paris.txt 9
framed	NotreDame_De_Paris.txt 3
frames	NotreDame_De_Paris.txt 1
framework	NotreDame_De_Paris.txt 4
fran	NotreDame_De_Paris.txt 5
franc	NotreDame_De_Paris.txt 1
france	NotreDame_De_Paris.txt 47
franche	NotreDame_De_Paris.txt 1
franchises	NotreDame_De_Paris.txt 1
franciae	NotreDame_De_Paris.txt 1
franciscan	NotreDame_De_Paris.txt 1
francois	NotreDame_De_Paris.txt 1
francs	NotreDame_De_Paris.txt 1
frank	NotreDame_De_Paris.txt 1
frankly	NotreDame_De_Paris.txt 2
frankness	NotreDame_De_Paris.txt 2
frantic	NotreDame_De_Paris.txt 3
frantically	NotreDame_De_Paris.txt 1
fraternal	NotreDame_De_Paris.txt 2
fraternally	NotreDame_De_Paris.txt 1
fraternity	NotreDame_De_Paris.txt 2
fraught	NotreDame_De_Paris.txt 1
freak	NotreDame_De_Paris.txt 4
free	NotreDame_De_Paris.txt 21
freedom	NotreDame_De_Paris.txt 1
freely	NotreDame_De_Paris.txt 8
freewill	NotreDame_De_Paris.txt 1
freezing	NotreDame_De_Paris.txt 2
french	NotreDame_De_Paris.txt 9
frenchman	NotreDame_De_Paris.txt 3
frenzy	NotreDame_De_Paris.txt 3
frequent	NotreDame_De_Paris.txt 7
frequented	NotreDame_De_Paris.txt 3
frequently	NotreDame_De_Paris.txt 7
fresh	NotreDame_De_Paris.txt 32
freshness	NotreDame_De_Paris.txt 1
fretted	NotreDame_De_Paris.txt 3
friar	NotreDame_De_Paris.txt 2
friction	NotreDame_De_Paris.txt 2
friday	NotreDame_De_Paris.txt 1
friend	NotreDame_De_Paris.txt 43
friendly	NotreDame_De_Paris.txt 1
friends	NotreDame_De_Paris.txt 25
friendship	NotreDame_De_Paris.txt 3
frieze	NotreDame_De_Paris.txt 1
fright	NotreDame_De_Paris.txt 10
frighten	NotreDame_De_Paris.txt 2
frightened	NotreDame_De_Paris.txt 21
frightens	NotreDame_De_Paris.txt 1
frightful	NotreDame_De_Paris.txt 32
frightfully	NotreDame_De_Paris.txt 1
fringe	NotreDame_De_Paris.txt 1
fringes	NotreDame_De_Paris.txt 3
frisking	NotreDame_De_Paris.txt 1
frisky	NotreDame_De_Paris.txt 1
fro	NotreDame_De_Paris.txt 4
frock	NotreDame_De_Paris.txt 1
frog	NotreDame_De_Paris.txt 2
frogs	NotreDame_De_Paris.txt 1
frolicsome	NotreDame_De_Paris.txt 1
frollo	NotreDame_De_Paris.txt 60
from	NotreDame_De_Paris.txt 900
front	NotreDame_De_Paris.txt 69
frontispiece	NotreDame_De_Paris.txt 1
frontispieces	NotreDame_De_Paris.txt 1
fronts	NotreDame_De_Paris.txt 2
frothed	NotreDame_De_Paris.txt 2
frothing	NotreDame_De_Paris.txt 1
frown	NotreDame_De_Paris.txt 3
frowned	NotreDame_De_Paris.txt 5
froze	NotreDame_De_Paris.txt 3
frozen	NotreDame_De_Paris.txt 6
fruit	NotreDame_De_Paris.txt 6
fruitless	NotreDame_De_Paris.txt 1
frying	NotreDame_De_Paris.txt 4
fugitives	NotreDame_De_Paris.txt 1
fuit	NotreDame_De_Paris.txt 1
fulfil	NotreDame_De_Paris.txt 2
fulfilled	NotreDame_De_Paris.txt 2
fulfilling	NotreDame_De_Paris.txt 1
fulfils	NotreDame_De_Paris.txt 1
full	NotreDame_De_Paris.txt 78
fully	NotreDame_De_Paris.txt 4
fumble	NotreDame_De_Paris.txt 1
fumbling	NotreDame_De_Paris.txt 2
fun	NotreDame_De_Paris.txt 1
fundraising	NotreDame_De_Paris.txt 1
funds	NotreDame_De_Paris.txt 2
funeral	NotreDame_De_Paris.txt 1
funerals	NotreDame_De_Paris.txt 1
funereal	NotreDame_De_Paris.txt 3
fungi	NotreDame_De_Paris.txt 1
funnels	NotreDame_De_Paris.txt 1
fur	NotreDame_De_Paris.txt 2
furious	NotreDame_De_Paris.txt 19
furiously	NotreDame_De_Paris.txt 4
furnace	NotreDame_De_Paris.txt 21
furnish	NotreDame_De_Paris.txt 2
furnished	NotreDame_De_Paris.txt 3
furnishes	NotreDame_De_Paris.txt 2
furniture	NotreDame_De_Paris.txt 2
furred	NotreDame_De_Paris.txt 7
furrier	NotreDame_De_Paris.txt 4
furrow	NotreDame_De_Paris.txt 2
furrowed	NotreDame_De_Paris.txt 4
furs	NotreDame_De_Paris.txt 1
further	NotreDame_De_Paris.txt 15
furthermore	NotreDame_De_Paris.txt 1
furtive	NotreDame_De_Paris.txt 2
furtively	NotreDame_De_Paris.txt 2
fury	NotreDame_De_Paris.txt 21
fuse	NotreDame_De_Paris.txt 1
fustian	NotreDame_De_Paris.txt 2
future	NotreDame_De_Paris.txt 11
fye	NotreDame_De_Paris.txt 1
