v	Miserables.txt 71
va	Miserables.txt 1
vacancy	Miserables.txt 1
vacant	Miserables.txt 4
vacarmini	Miserables.txt 1
vacation	Miserables.txt 2
vaccine	Miserables.txt 1
vache	Miserables.txt 1
vacillate	Miserables.txt 2
vacillated	Miserables.txt 1
vacillating	Miserables.txt 1
vacillation	Miserables.txt 3
vacuum	Miserables.txt 1
vade	Miserables.txt 2
vadeboncoeur	Miserables.txt 1
vae	Miserables.txt 1
vagabond	Miserables.txt 7
vagabondage	Miserables.txt 2
vagabondism	Miserables.txt 1
vagabonds	Miserables.txt 5
vagrancy	Miserables.txt 2
vagrant	Miserables.txt 1
vagrants	Miserables.txt 3
vague	Miserables.txt 82
vaguely	Miserables.txt 49
vagueness	Miserables.txt 4
vaguest	Miserables.txt 1
vah	Miserables.txt 1
vain	Miserables.txt 35
vainglory	Miserables.txt 1
vainly	Miserables.txt 1
vair	Miserables.txt 1
vais	Miserables.txt 1
val	Miserables.txt 6
valde	Miserables.txt 1
valenciennes	Miserables.txt 1
valentinian	Miserables.txt 1
valet	Miserables.txt 2
valetudinarian	Miserables.txt 1
valiant	Miserables.txt 11
valiantly	Miserables.txt 3
valid	Miserables.txt 1
valise	Miserables.txt 11
valises	Miserables.txt 1
valjean	Miserables.txt 1119
vallee	Miserables.txt 1
valley	Miserables.txt 14
valleys	Miserables.txt 2
vallombrosa	Miserables.txt 1
valmy	Miserables.txt 1
valois	Miserables.txt 3
valor	Miserables.txt 2
valsin	Miserables.txt 1
valuable	Miserables.txt 4
valuations	Miserables.txt 1
value	Miserables.txt 9
valves	Miserables.txt 1
vampire	Miserables.txt 1
van	Miserables.txt 7
vancouver	Miserables.txt 1
vandal	Miserables.txt 1
vandeleur	Miserables.txt 2
vandermeulen	Miserables.txt 2
vanguard	Miserables.txt 3
vanguards	Miserables.txt 1
vanilla	Miserables.txt 2
vanish	Miserables.txt 17
vanished	Miserables.txt 54
vanishes	Miserables.txt 8
vanishing	Miserables.txt 10
vanities	Miserables.txt 2
vanity	Miserables.txt 12
vanquished	Miserables.txt 18
vanquishing	Miserables.txt 1
vantana	Miserables.txt 1
vantane	Miserables.txt 1
vantbrace	Miserables.txt 1
vanterne	Miserables.txt 1
vanum	Miserables.txt 1
vanvre	Miserables.txt 1
vanvres	Miserables.txt 1
vapor	Miserables.txt 7
vapors	Miserables.txt 3
var	Miserables.txt 3
varennes	Miserables.txt 1
vargouleme	Miserables.txt 1
variable	Miserables.txt 1
variance	Miserables.txt 2
variant	Miserables.txt 1
variation	Miserables.txt 3
variatur	Miserables.txt 1
varied	Miserables.txt 10
varies	Miserables.txt 2
varieties	Miserables.txt 4
variety	Miserables.txt 12
various	Miserables.txt 25
variously	Miserables.txt 2
varnish	Miserables.txt 2
varnished	Miserables.txt 6
varus	Miserables.txt 1
vary	Miserables.txt 3
varying	Miserables.txt 5
vasaphanta	Miserables.txt 1
vase	Miserables.txt 5
vases	Miserables.txt 1
vast	Miserables.txt 72
vastly	Miserables.txt 1
vastness	Miserables.txt 1
vat	Miserables.txt 1
vatican	Miserables.txt 1
vaubernier	Miserables.txt 1
vaublanc	Miserables.txt 2
vaubois	Miserables.txt 3
vaud	Miserables.txt 1
vaudeville	Miserables.txt 5
vaudevilles	Miserables.txt 2
vaugirard	Miserables.txt 18
vaulabelle	Miserables.txt 1
vault	Miserables.txt 45
vaulted	Miserables.txt 10
vaulting	Miserables.txt 2
vaults	Miserables.txt 11
vauvert	Miserables.txt 1
ve	Miserables.txt 25
veal	Miserables.txt 1
vecu	Miserables.txt 1
veda	Miserables.txt 1
veered	Miserables.txt 1
vegetable	Miserables.txt 2
vegetables	Miserables.txt 6
vegetate	Miserables.txt 1
vegetated	Miserables.txt 1
vegetates	Miserables.txt 1
vegetation	Miserables.txt 11
vegetations	Miserables.txt 1
vehemence	Miserables.txt 1
vehicle	Miserables.txt 33
vehicles	Miserables.txt 22
veil	Miserables.txt 30
veiled	Miserables.txt 10
veils	Miserables.txt 7
vein	Miserables.txt 2
veins	Miserables.txt 12
vejanus	Miserables.txt 1
vel	Miserables.txt 1
velvet	Miserables.txt 26
venant	Miserables.txt 1
vence	Miserables.txt 1
vend	Miserables.txt 1
vendean	Miserables.txt 2
vendee	Miserables.txt 2
vendemiaire	Miserables.txt 2
vendetta	Miserables.txt 1
vendome	Miserables.txt 2
vendu	Miserables.txt 1
venerable	Miserables.txt 27
venerate	Miserables.txt 3
venerated	Miserables.txt 7
venerates	Miserables.txt 1
venerating	Miserables.txt 1
veneration	Miserables.txt 15
venery	Miserables.txt 3
venetian	Miserables.txt 3
venetiis	Miserables.txt 1
venez	Miserables.txt 1
vengeance	Miserables.txt 5
venial	Miserables.txt 3
venice	Miserables.txt 12
venir	Miserables.txt 1
venom	Miserables.txt 1
venomous	Miserables.txt 6
venous	Miserables.txt 1
vent	Miserables.txt 24
ventilated	Miserables.txt 1
ventre	Miserables.txt 1
ventregoulette	Miserables.txt 1
ventriloquist	Miserables.txt 10
vents	Miserables.txt 2
venture	Miserables.txt 7
ventured	Miserables.txt 20
venturing	Miserables.txt 2
venus	Miserables.txt 11
veracity	Miserables.txt 1
veranda	Miserables.txt 1
verbal	Miserables.txt 3
verdant	Miserables.txt 3
verdets	Miserables.txt 1
verdict	Miserables.txt 3
verdigris	Miserables.txt 4
verdure	Miserables.txt 3
verga	Miserables.txt 13
verge	Miserables.txt 16
vergniaud	Miserables.txt 1
verified	Miserables.txt 5
verify	Miserables.txt 3
verifying	Miserables.txt 1
veritable	Miserables.txt 17
vermin	Miserables.txt 8
vermis	Miserables.txt 1
vernon	Miserables.txt 20
verrerie	Miserables.txt 7
verres	Miserables.txt 1
verrue	Miserables.txt 1
versailles	Miserables.txt 2
verse	Miserables.txt 14
versed	Miserables.txt 1
verses	Miserables.txt 22
version	Miserables.txt 1
versions	Miserables.txt 1
verso	Miserables.txt 2
versus	Miserables.txt 1
vert	Miserables.txt 9
vertebral	Miserables.txt 3
vertical	Miserables.txt 4
vertigo	Miserables.txt 6
vertu	Miserables.txt 2
vertus	Miserables.txt 1
very	Miserables.txt 923
vescovo	Miserables.txt 1
vespers	Miserables.txt 3
vespertillos	Miserables.txt 1
vessel	Miserables.txt 17
vessels	Miserables.txt 5
vest	Miserables.txt 3
vestal	Miserables.txt 2
vestals	Miserables.txt 1
vestibule	Miserables.txt 3
vestiges	Miserables.txt 1
vestments	Miserables.txt 1
vests	Miserables.txt 1
vesture	Miserables.txt 1
vetches	Miserables.txt 1
veteran	Miserables.txt 11
veterans	Miserables.txt 4
veto	Miserables.txt 1
veut	Miserables.txt 1
veuvain	Miserables.txt 2
vexation	Miserables.txt 4
vexations	Miserables.txt 1
vexatious	Miserables.txt 1
vexed	Miserables.txt 12
vi	Miserables.txt 63
via	Miserables.txt 1
vib	Miserables.txt 1
vibiscus	Miserables.txt 1
vibrating	Miserables.txt 3
vibration	Miserables.txt 4
vicar	Miserables.txt 4
vicarage	Miserables.txt 1
vicars	Miserables.txt 2
vicarships	Miserables.txt 1
vice	Miserables.txt 11
vices	Miserables.txt 11
vicinity	Miserables.txt 23
vicious	Miserables.txt 9
viciousness	Miserables.txt 2
vicissitude	Miserables.txt 1
vicissitudes	Miserables.txt 5
vicomte	Miserables.txt 7
vicomtes	Miserables.txt 1
vicomtess	Miserables.txt 1
vicomtesse	Miserables.txt 1
victim	Miserables.txt 14
victims	Miserables.txt 4
victis	Miserables.txt 1
victoires	Miserables.txt 3
victor	Miserables.txt 10
victories	Miserables.txt 6
victorious	Miserables.txt 8
victory	Miserables.txt 34
victurnien	Miserables.txt 8
vide	Miserables.txt 1
videant	Miserables.txt 1
vidette	Miserables.txt 2
videttes	Miserables.txt 1
vidocq	Miserables.txt 2
vie	Miserables.txt 1
vied	Miserables.txt 2
vielle	Miserables.txt 3
vielles	Miserables.txt 4
vienna	Miserables.txt 5
vienne	Miserables.txt 1
vieux	Miserables.txt 3
view	Miserables.txt 79
viewed	Miserables.txt 22
viewing	Miserables.txt 3
views	Miserables.txt 3
vigil	Miserables.txt 1
vigilance	Miserables.txt 3
vigilant	Miserables.txt 2
viginti	Miserables.txt 1
vignemale	Miserables.txt 1
vignes	Miserables.txt 2
vignettes	Miserables.txt 1
vigor	Miserables.txt 5
vigorous	Miserables.txt 11
vigorously	Miserables.txt 5
vii	Miserables.txt 50
viii	Miserables.txt 44
vil	Miserables.txt 1
vile	Miserables.txt 8
vileness	Miserables.txt 1
village	Miserables.txt 48
villager	Miserables.txt 3
villagers	Miserables.txt 1
villages	Miserables.txt 8
villain	Miserables.txt 13
villainous	Miserables.txt 4
villainously	Miserables.txt 1
villains	Miserables.txt 2
villainy	Miserables.txt 1
villard	Miserables.txt 1
villas	Miserables.txt 1
ville	Miserables.txt 1
villele	Miserables.txt 3
villemomble	Miserables.txt 2
villers	Miserables.txt 1
villette	Miserables.txt 1
villiers	Miserables.txt 3
villon	Miserables.txt 4
villons	Miserables.txt 1
vin	Miserables.txt 1
vincennes	Miserables.txt 5
vincent	Miserables.txt 4
vindicte	Miserables.txt 2
vindictiveness	Miserables.txt 1
vine	Miserables.txt 7
vinegar	Miserables.txt 1
vines	Miserables.txt 2
vineyard	Miserables.txt 2
vingt	Miserables.txt 1
vinous	Miserables.txt 1
vins	Miserables.txt 1
vintage	Miserables.txt 2
vintner	Miserables.txt 1
viola	Miserables.txt 1
violate	Miserables.txt 1
violated	Miserables.txt 6
violates	Miserables.txt 3
violations	Miserables.txt 2
violator	Miserables.txt 1
violence	Miserables.txt 35
violences	Miserables.txt 5
violent	Miserables.txt 57
violently	Miserables.txt 16
violet	Miserables.txt 10
violets	Miserables.txt 2
violin	Miserables.txt 1
violins	Miserables.txt 4
viper	Miserables.txt 3
vipers	Miserables.txt 1
vir	Miserables.txt 1
virgil	Miserables.txt 6
virgin	Miserables.txt 37
virginal	Miserables.txt 5
virginity	Miserables.txt 6
virgins	Miserables.txt 12
virile	Miserables.txt 2
virtue	Miserables.txt 64
virtues	Miserables.txt 10
virtuoso	Miserables.txt 1
virtuous	Miserables.txt 8
virtuously	Miserables.txt 1
virus	Miserables.txt 1
vis	Miserables.txt 6
visage	Miserables.txt 17
visages	Miserables.txt 5
viscous	Miserables.txt 2
vise	Miserables.txt 1
visible	Miserables.txt 121
visibly	Miserables.txt 4
visigoths	Miserables.txt 1
vision	Miserables.txt 33
visionary	Miserables.txt 7
visions	Miserables.txt 10
visit	Miserables.txt 36
visitandines	Miserables.txt 1
visitation	Miserables.txt 1
visited	Miserables.txt 10
visiting	Miserables.txt 1
visitor	Miserables.txt 3
visitors	Miserables.txt 5
visits	Miserables.txt 14
visor	Miserables.txt 5
visored	Miserables.txt 1
visual	Miserables.txt 1
vitaelampada	Miserables.txt 1
vital	Miserables.txt 1
vitality	Miserables.txt 3
vitam	Miserables.txt 1
vitellius	Miserables.txt 1
vitre	Miserables.txt 2
vitreous	Miserables.txt 1
vitriol	Miserables.txt 1
vittoria	Miserables.txt 1
vivacious	Miserables.txt 7
vivaciously	Miserables.txt 5
vivacity	Miserables.txt 10
vivait	Miserables.txt 1
vivant	Miserables.txt 1
vive	Miserables.txt 5
vivian	Miserables.txt 3
vivid	Miserables.txt 5
vividly	Miserables.txt 3
vivified	Miserables.txt 1
vivifying	Miserables.txt 1
vivions	Miserables.txt 1
vivonne	Miserables.txt 1
vixi	Miserables.txt 1
vlajean	Miserables.txt 1
vobis	Miserables.txt 1
vocabulary	Miserables.txt 3
vocal	Miserables.txt 17
vocales	Miserables.txt 1
vocation	Miserables.txt 4
vocations	Miserables.txt 2
voci	Miserables.txt 1
vociferate	Miserables.txt 2
vociferated	Miserables.txt 2
vogue	Miserables.txt 3
voice	Miserables.txt 343
voiceless	Miserables.txt 1
voices	Miserables.txt 40
voici	Miserables.txt 2
void	Miserables.txt 11
voids	Miserables.txt 1
voila	Miserables.txt 1
voileci	Miserables.txt 2
voir	Miserables.txt 1
voit	Miserables.txt 2
voitures	Miserables.txt 1
vol	Miserables.txt 1
volatile	Miserables.txt 1
volaverunt	Miserables.txt 1
volcano	Miserables.txt 7
volcanoes	Miserables.txt 2
volet	Miserables.txt 1
volley	Miserables.txt 3
volsci	Miserables.txt 1
voltaire	Miserables.txt 40
voltairian	Miserables.txt 3
voltairianism	Miserables.txt 1
voltairians	Miserables.txt 1
volubility	Miserables.txt 1
volume	Miserables.txt 39
volumes	Miserables.txt 7
voluminous	Miserables.txt 2
voluntarily	Miserables.txt 3
voluntary	Miserables.txt 5
volunteer	Miserables.txt 4
volunteers	Miserables.txt 6
voluptuary	Miserables.txt 1
voluptuous	Miserables.txt 6
voluptuously	Miserables.txt 1
voluptuousness	Miserables.txt 15
volvitur	Miserables.txt 1
vomit	Miserables.txt 1
vomited	Miserables.txt 2
von	Miserables.txt 1
vont	Miserables.txt 13
voracious	Miserables.txt 2
voracity	Miserables.txt 1
vos	Miserables.txt 2
vote	Miserables.txt 6
voted	Miserables.txt 7
voter	Miserables.txt 1
voters	Miserables.txt 1
votes	Miserables.txt 2
voting	Miserables.txt 1
votre	Miserables.txt 3
vous	Miserables.txt 9
vousiergue	Miserables.txt 1
vows	Miserables.txt 6
voyage	Miserables.txt 3
voyages	Miserables.txt 1
voyais	Miserables.txt 1
voyant	Miserables.txt 1
vrai	Miserables.txt 2
vulcan	Miserables.txt 1
vulgar	Miserables.txt 16
vulgarly	Miserables.txt 1
vulnerable	Miserables.txt 2
vulture	Miserables.txt 8
vultures	Miserables.txt 3
