e	Miserables.txt 27
each	Miserables.txt 456
eager	Miserables.txt 3
eagerly	Miserables.txt 9
eagle	Miserables.txt 23
eagles	Miserables.txt 7
eam	Miserables.txt 1
ear	Miserables.txt 58
earlier	Miserables.txt 8
early	Miserables.txt 45
earn	Miserables.txt 18
earned	Miserables.txt 18
earning	Miserables.txt 5
earnings	Miserables.txt 3
earns	Miserables.txt 1
ears	Miserables.txt 38
earth	Miserables.txt 178
earthen	Miserables.txt 1
earthenware	Miserables.txt 7
earthquake	Miserables.txt 5
earthquakes	Miserables.txt 3
earthworm	Miserables.txt 2
earthy	Miserables.txt 1
ease	Miserables.txt 27
easier	Miserables.txt 4
easily	Miserables.txt 40
east	Miserables.txt 8
easter	Miserables.txt 1
eastern	Miserables.txt 1
easy	Miserables.txt 56
eat	Miserables.txt 79
eatable	Miserables.txt 2
eaten	Miserables.txt 32
eater	Miserables.txt 2
eating	Miserables.txt 20
eats	Miserables.txt 13
eau	Miserables.txt 5
ebb	Miserables.txt 7
ebbs	Miserables.txt 1
ebony	Miserables.txt 2
ebook	Miserables.txt 11
ebooks	Miserables.txt 7
ebouriffe	Miserables.txt 1
ebranle	Miserables.txt 1
ebullition	Miserables.txt 2
ebullitions	Miserables.txt 4
eburnea	Miserables.txt 1
ecce	Miserables.txt 6
eccellence	Miserables.txt 1
eccentric	Miserables.txt 12
eccentricities	Miserables.txt 1
eccentricity	Miserables.txt 1
ecclesiastes	Miserables.txt 3
ecclesiastic	Miserables.txt 1
ecclesiastical	Miserables.txt 2
ecclesiastics	Miserables.txt 2
echabeau	Miserables.txt 1
echarpe	Miserables.txt 2
echasses	Miserables.txt 1
echaude	Miserables.txt 1
echelonned	Miserables.txt 2
echelonning	Miserables.txt 1
echelons	Miserables.txt 2
echo	Miserables.txt 6
echoed	Miserables.txt 2
echoes	Miserables.txt 1
eckberg	Miserables.txt 1
eclaireurs	Miserables.txt 1
eclipse	Miserables.txt 15
eclipsed	Miserables.txt 5
eclipses	Miserables.txt 3
eclogue	Miserables.txt 1
eclos	Miserables.txt 1
economic	Miserables.txt 2
economical	Miserables.txt 3
economically	Miserables.txt 1
economists	Miserables.txt 3
economize	Miserables.txt 3
economy	Miserables.txt 7
ecossais	Miserables.txt 1
ecouen	Miserables.txt 2
ecrase	Miserables.txt 1
ecrit	Miserables.txt 1
ecroula	Miserables.txt 1
ecstasies	Miserables.txt 14
ecstasy	Miserables.txt 33
ecstatic	Miserables.txt 6
ecstatically	Miserables.txt 1
edapteon	Miserables.txt 1
eddies	Miserables.txt 1
eddy	Miserables.txt 2
eden	Miserables.txt 7
edenizing	Miserables.txt 1
edge	Miserables.txt 24
edged	Miserables.txt 2
edges	Miserables.txt 6
edict	Miserables.txt 1
edifice	Miserables.txt 17
edifices	Miserables.txt 3
edified	Miserables.txt 1
editing	Miserables.txt 1
edition	Miserables.txt 6
editions	Miserables.txt 5
editor	Miserables.txt 3
edmond	Miserables.txt 1
edon	Miserables.txt 3
educate	Miserables.txt 1
educated	Miserables.txt 7
educating	Miserables.txt 1
education	Miserables.txt 37
educational	Miserables.txt 2
educed	Miserables.txt 1
eel	Miserables.txt 1
eels	Miserables.txt 2
efface	Miserables.txt 5
effaced	Miserables.txt 15
effacement	Miserables.txt 1
effaces	Miserables.txt 2
effacing	Miserables.txt 3
effect	Miserables.txt 99
effected	Miserables.txt 26
effecting	Miserables.txt 1
effects	Miserables.txt 14
effectually	Miserables.txt 1
effeminate	Miserables.txt 2
effet	Miserables.txt 1
efficacious	Miserables.txt 4
efficacy	Miserables.txt 1
effigy	Miserables.txt 3
effluvia	Miserables.txt 2
effort	Miserables.txt 62
efforts	Miserables.txt 22
effrontery	Miserables.txt 6
effusion	Miserables.txt 7
effusively	Miserables.txt 1
egad	Miserables.txt 2
egg	Miserables.txt 6
eggs	Miserables.txt 6
eglantiers	Miserables.txt 1
eglantines	Miserables.txt 1
egoism	Miserables.txt 1
egoist	Miserables.txt 2
egoists	Miserables.txt 2
egotism	Miserables.txt 12
egotistical	Miserables.txt 3
egrugeoir	Miserables.txt 1
egypt	Miserables.txt 6
egyptian	Miserables.txt 1
egyptienne	Miserables.txt 1
eh	Miserables.txt 8
ei	Miserables.txt 2
eight	Miserables.txt 105
eighteen	Miserables.txt 15
eighteenth	Miserables.txt 20
eighth	Miserables.txt 15
eighthly	Miserables.txt 1
eighty	Miserables.txt 46
ein	Miserables.txt 1
either	Miserables.txt 82
ejaculated	Miserables.txt 31
ejaculation	Miserables.txt 1
ejects	Miserables.txt 1
eke	Miserables.txt 1
eked	Miserables.txt 1
el	Miserables.txt 1
elaborate	Miserables.txt 1
elapse	Miserables.txt 3
elapsed	Miserables.txt 25
elasped	Miserables.txt 1
elatos	Miserables.txt 1
elba	Miserables.txt 5
elbow	Miserables.txt 29
elbowed	Miserables.txt 5
elbowing	Miserables.txt 1
elbows	Miserables.txt 38
elder	Miserables.txt 54
elderly	Miserables.txt 13
elders	Miserables.txt 1
eldest	Miserables.txt 17
elect	Miserables.txt 4
elected	Miserables.txt 7
elections	Miserables.txt 2
elector	Miserables.txt 5
electric	Miserables.txt 10
electricity	Miserables.txt 2
electrifies	Miserables.txt 2
electronic	Miserables.txt 27
electronically	Miserables.txt 2
elegance	Miserables.txt 8
elegances	Miserables.txt 2
elegant	Miserables.txt 17
elegy	Miserables.txt 2
element	Miserables.txt 20
elementary	Miserables.txt 2
elements	Miserables.txt 13
eleonore	Miserables.txt 1
elephant	Miserables.txt 38
elephanta	Miserables.txt 1
eleusiac	Miserables.txt 1
elevate	Miserables.txt 2
elevated	Miserables.txt 14
elevates	Miserables.txt 1
elevating	Miserables.txt 4
elevation	Miserables.txt 13
elevations	Miserables.txt 1
eleven	Miserables.txt 21
eleventh	Miserables.txt 4
elicited	Miserables.txt 3
eliding	Miserables.txt 1
elijah	Miserables.txt 1
eliminated	Miserables.txt 1
elixir	Miserables.txt 4
elixirs	Miserables.txt 1
elle	Miserables.txt 10
elleviou	Miserables.txt 1
ellipse	Miserables.txt 1
ellipses	Miserables.txt 1
ellipsis	Miserables.txt 1
elm	Miserables.txt 5
elmire	Miserables.txt 1
elms	Miserables.txt 9
elongated	Miserables.txt 1
eloquence	Miserables.txt 9
eloquent	Miserables.txt 8
elot	Miserables.txt 1
eloy	Miserables.txt 2
elrey	Miserables.txt 1
else	Miserables.txt 71
elsewhere	Miserables.txt 33
elucidate	Miserables.txt 3
elucidated	Miserables.txt 2
eluded	Miserables.txt 1
elysee	Miserables.txt 1
elysees	Miserables.txt 19
elzevir	Miserables.txt 2
em	Miserables.txt 3
emaciated	Miserables.txt 2
emaciation	Miserables.txt 1
email	Miserables.txt 3
emanate	Miserables.txt 2
emanated	Miserables.txt 4
emanates	Miserables.txt 2
emanation	Miserables.txt 2
emancipated	Miserables.txt 1
embalm	Miserables.txt 1
embalmed	Miserables.txt 2
embalming	Miserables.txt 2
embankment	Miserables.txt 1
embark	Miserables.txt 1
embarked	Miserables.txt 2
embarrass	Miserables.txt 2
embarrassed	Miserables.txt 20
embarrasses	Miserables.txt 2
embarrassing	Miserables.txt 7
embarrassment	Miserables.txt 14
embattle	Miserables.txt 1
embattled	Miserables.txt 2
embe	Miserables.txt 1
embedded	Miserables.txt 1
embedding	Miserables.txt 1
embellished	Miserables.txt 1
embers	Miserables.txt 2
embittered	Miserables.txt 1
emblazoned	Miserables.txt 2
embodied	Miserables.txt 1
emboldened	Miserables.txt 2
emboldens	Miserables.txt 1
embouchure	Miserables.txt 1
embrace	Miserables.txt 25
embraced	Miserables.txt 13
embraces	Miserables.txt 1
embrasure	Miserables.txt 4
embrasures	Miserables.txt 2
embroider	Miserables.txt 1
embroidered	Miserables.txt 7
embroideries	Miserables.txt 1
embroidering	Miserables.txt 1
embroidery	Miserables.txt 1
embroiled	Miserables.txt 1
embrun	Miserables.txt 7
embryo	Miserables.txt 2
embryonic	Miserables.txt 3
emerge	Miserables.txt 31
emerged	Miserables.txt 60
emergencies	Miserables.txt 1
emergency	Miserables.txt 1
emerges	Miserables.txt 9
emerging	Miserables.txt 24
emigrants	Miserables.txt 2
emigrated	Miserables.txt 2
emigration	Miserables.txt 2
emigre	Miserables.txt 2
emigree	Miserables.txt 1
eminence	Miserables.txt 5
eminent	Miserables.txt 2
eminently	Miserables.txt 1
emit	Miserables.txt 1
emits	Miserables.txt 2
emitted	Miserables.txt 13
emitting	Miserables.txt 1
emotion	Miserables.txt 33
emotions	Miserables.txt 25
emp	Miserables.txt 1
empereur	Miserables.txt 3
emperor	Miserables.txt 73
emperors	Miserables.txt 4
emphasis	Miserables.txt 1
emphasize	Miserables.txt 3
emphasized	Miserables.txt 3
emphasizing	Miserables.txt 5
emphatic	Miserables.txt 1
emphyteuses	Miserables.txt 1
empire	Miserables.txt 42
empires	Miserables.txt 2
employ	Miserables.txt 4
employed	Miserables.txt 25
employee	Miserables.txt 2
employees	Miserables.txt 4
employing	Miserables.txt 5
employment	Miserables.txt 11
employments	Miserables.txt 1
employs	Miserables.txt 2
empress	Miserables.txt 1
empresses	Miserables.txt 1
emptied	Miserables.txt 9
empties	Miserables.txt 5
emptiness	Miserables.txt 1
empty	Miserables.txt 51
emptying	Miserables.txt 4
empurpled	Miserables.txt 7
empyrean	Miserables.txt 1
emulation	Miserables.txt 1
emulsions	Miserables.txt 1
en	Miserables.txt 31
enable	Miserables.txt 5
enabled	Miserables.txt 2
enables	Miserables.txt 1
enact	Miserables.txt 1
enacted	Miserables.txt 2
enamel	Miserables.txt 1
encamped	Miserables.txt 2
encampment	Miserables.txt 1
encased	Miserables.txt 1
enchained	Miserables.txt 2
enchant	Miserables.txt 1
enchanted	Miserables.txt 4
enchanting	Miserables.txt 1
enchantingly	Miserables.txt 1
enchantment	Miserables.txt 2
enchantments	Miserables.txt 3
encircle	Miserables.txt 1
encircled	Miserables.txt 1
encircling	Miserables.txt 1
enclose	Miserables.txt 1
enclosed	Miserables.txt 10
enclosing	Miserables.txt 1
enclosure	Miserables.txt 23
enclosures	Miserables.txt 7
encompass	Miserables.txt 1
encompassed	Miserables.txt 2
encore	Miserables.txt 1
encounter	Miserables.txt 32
encountered	Miserables.txt 53
encountering	Miserables.txt 3
encounters	Miserables.txt 22
encourage	Miserables.txt 2
encouraged	Miserables.txt 9
encouragement	Miserables.txt 5
encourages	Miserables.txt 1
encouraging	Miserables.txt 4
encroached	Miserables.txt 1
encroachments	Miserables.txt 2
encumber	Miserables.txt 3
encumbered	Miserables.txt 16
encyclopaedia	Miserables.txt 2
encyclopedia	Miserables.txt 2
encyclopedists	Miserables.txt 1
end	Miserables.txt 267
endeavor	Miserables.txt 3
endeavored	Miserables.txt 4
endeavoring	Miserables.txt 7
endeavors	Miserables.txt 1
ended	Miserables.txt 57
ending	Miserables.txt 5
endless	Miserables.txt 6
endormeurs	Miserables.txt 1
endowed	Miserables.txt 10
endroit	Miserables.txt 1
ends	Miserables.txt 26
endurance	Miserables.txt 1
endure	Miserables.txt 3
endured	Miserables.txt 7
endures	Miserables.txt 1
enduring	Miserables.txt 1
enemies	Miserables.txt 6
enemy	Miserables.txt 26
energetic	Miserables.txt 15
energetically	Miserables.txt 7
energies	Miserables.txt 1
energy	Miserables.txt 8
enervation	Miserables.txt 1
enfants	Miserables.txt 3
enfeebled	Miserables.txt 2
enfeeblement	Miserables.txt 1
enfer	Miserables.txt 3
enforce	Miserables.txt 1
enforced	Miserables.txt 3
engage	Miserables.txt 5
engaged	Miserables.txt 45
engagement	Miserables.txt 5
engagements	Miserables.txt 3
engages	Miserables.txt 1
engendered	Miserables.txt 4
engendering	Miserables.txt 1
engenders	Miserables.txt 4
enghien	Miserables.txt 2
engine	Miserables.txt 4
engineer	Miserables.txt 3
engines	Miserables.txt 2
england	Miserables.txt 60
english	Miserables.txt 128
englishman	Miserables.txt 4
englishmen	Miserables.txt 1
englishwoman	Miserables.txt 1
engrafted	Miserables.txt 1
engrafting	Miserables.txt 2
engraved	Miserables.txt 5
engraver	Miserables.txt 1
engraving	Miserables.txt 2
engravings	Miserables.txt 2
engross	Miserables.txt 1
engrossed	Miserables.txt 2
engulf	Miserables.txt 1
engulfed	Miserables.txt 17
engulfment	Miserables.txt 5
engulfs	Miserables.txt 1
enhanced	Miserables.txt 2
enigma	Miserables.txt 24
enigmas	Miserables.txt 6
enigmatic	Miserables.txt 2
enigmatical	Miserables.txt 13
enjoin	Miserables.txt 3
enjoined	Miserables.txt 5
enjoining	Miserables.txt 1
enjolras	Miserables.txt 256
enjoy	Miserables.txt 12
enjoyed	Miserables.txt 6
enjoying	Miserables.txt 3
enjoyment	Miserables.txt 11
enjoyments	Miserables.txt 4
enjoys	Miserables.txt 2
enlarge	Miserables.txt 1
enlarged	Miserables.txt 5
enlargement	Miserables.txt 4
enlarges	Miserables.txt 1
enlarging	Miserables.txt 5
enlighten	Miserables.txt 6
enlightened	Miserables.txt 10
enlightening	Miserables.txt 3
enlightenment	Miserables.txt 8
enlightens	Miserables.txt 1
enlisted	Miserables.txt 2
enlists	Miserables.txt 1
enlivened	Miserables.txt 2
enlivens	Miserables.txt 1
ennius	Miserables.txt 1
ennui	Miserables.txt 5
enormities	Miserables.txt 2
enormity	Miserables.txt 5
enormous	Miserables.txt 83
enormously	Miserables.txt 2
enough	Miserables.txt 92
enrage	Miserables.txt 1
enraged	Miserables.txt 10
enraptured	Miserables.txt 1
enrich	Miserables.txt 2
enriched	Miserables.txt 6
enriching	Miserables.txt 1
enrolling	Miserables.txt 1
ens	Miserables.txt 1
ensconce	Miserables.txt 1
ensconced	Miserables.txt 1
ensemble	Miserables.txt 2
ensenas	Miserables.txt 1
ensigns	Miserables.txt 1
ensnared	Miserables.txt 1
ensorcela	Miserables.txt 1
ensued	Miserables.txt 31
ensuing	Miserables.txt 1
ensuring	Miserables.txt 1
entablature	Miserables.txt 1
entail	Miserables.txt 1
entailed	Miserables.txt 3
entails	Miserables.txt 3
entangle	Miserables.txt 1
entangled	Miserables.txt 13
entanglement	Miserables.txt 2
entangles	Miserables.txt 1
entangling	Miserables.txt 2
entendais	Miserables.txt 1
enter	Miserables.txt 128
entered	Miserables.txt 270
entering	Miserables.txt 76
enterprise	Miserables.txt 4
enters	Miserables.txt 21
entertain	Miserables.txt 3
entertained	Miserables.txt 10
entertaining	Miserables.txt 2
enthusiasm	Miserables.txt 24
enthusiasms	Miserables.txt 3
enthusiastic	Miserables.txt 16
enthusiasts	Miserables.txt 1
enticed	Miserables.txt 1
entichamber	Miserables.txt 1
enticing	Miserables.txt 2
entire	Miserables.txt 42
entirely	Miserables.txt 46
entirety	Miserables.txt 3
entitle	Miserables.txt 1
entitled	Miserables.txt 11
entity	Miserables.txt 3
entr	Miserables.txt 1
entrail	Miserables.txt 1
entrails	Miserables.txt 5
entrain	Miserables.txt 1
entrance	Miserables.txt 61
entrances	Miserables.txt 5
entrave	Miserables.txt 1
entre	Miserables.txt 1
entreat	Miserables.txt 7
entreating	Miserables.txt 2
entreats	Miserables.txt 2
entreaty	Miserables.txt 1
entrenched	Miserables.txt 4
entrenchment	Miserables.txt 2
entresol	Miserables.txt 1
entrusted	Miserables.txt 4
entry	Miserables.txt 9
entwining	Miserables.txt 1
enumerated	Miserables.txt 1
enumerating	Miserables.txt 1
enunciated	Miserables.txt 1
enunciating	Miserables.txt 1
enunciation	Miserables.txt 2
envelop	Miserables.txt 2
envelope	Miserables.txt 15
enveloped	Miserables.txt 31
envelopes	Miserables.txt 1
enveloping	Miserables.txt 4
envelops	Miserables.txt 3
enviable	Miserables.txt 1
envie	Miserables.txt 1
envied	Miserables.txt 6
envious	Miserables.txt 5
environ	Miserables.txt 1
environs	Miserables.txt 7
envola	Miserables.txt 1
envoles	Miserables.txt 1
envy	Miserables.txt 7
enwrapped	Miserables.txt 2
enwraps	Miserables.txt 1
eon	Miserables.txt 1
epaulement	Miserables.txt 1
epaulets	Miserables.txt 10
epaulette	Miserables.txt 1
epaulettes	Miserables.txt 1
epee	Miserables.txt 1
ephemeral	Miserables.txt 1
ephesians	Miserables.txt 2
ephestion	Miserables.txt 1
ephyra	Miserables.txt 1
epic	Miserables.txt 11
epics	Miserables.txt 3
epicurus	Miserables.txt 1
epidemic	Miserables.txt 4
epidemics	Miserables.txt 1
epidermis	Miserables.txt 1
epidotas	Miserables.txt 1
epilepsies	Miserables.txt 1
epileptic	Miserables.txt 1
epimenides	Miserables.txt 1
epinard	Miserables.txt 1
epingle	Miserables.txt 2
epiphonema	Miserables.txt 1
epiphonemas	Miserables.txt 1
episcopal	Miserables.txt 14
episcopate	Miserables.txt 2
episode	Miserables.txt 3
episthates	Miserables.txt 2
epistle	Miserables.txt 9
epistles	Miserables.txt 1
epitaph	Miserables.txt 1
epithet	Miserables.txt 2
epithets	Miserables.txt 2
epoch	Miserables.txt 101
epochs	Miserables.txt 3
eponine	Miserables.txt 83
epouvente	Miserables.txt 1
equal	Miserables.txt 33
equality	Miserables.txt 17
equalled	Miserables.txt 3
equally	Miserables.txt 12
equals	Miserables.txt 3
equanimity	Miserables.txt 1
eques	Miserables.txt 1
equestrian	Miserables.txt 1
equilibrium	Miserables.txt 8
equinoctial	Miserables.txt 1
equipage	Miserables.txt 1
equipment	Miserables.txt 4
equipped	Miserables.txt 1
equitable	Miserables.txt 3
equity	Miserables.txt 4
equivalent	Miserables.txt 16
equivocal	Miserables.txt 6
equivoque	Miserables.txt 2
er	Miserables.txt 2
era	Miserables.txt 3
eradicated	Miserables.txt 1
erase	Miserables.txt 1
erased	Miserables.txt 4
erasing	Miserables.txt 2
erasure	Miserables.txt 2
erasures	Miserables.txt 3
erat	Miserables.txt 1
ere	Miserables.txt 1
erect	Miserables.txt 68
erected	Miserables.txt 12
erecting	Miserables.txt 3
erection	Miserables.txt 1
erexit	Miserables.txt 1
ergaphilas	Miserables.txt 1
ergasilus	Miserables.txt 1
erigone	Miserables.txt 1
erlon	Miserables.txt 4
ermine	Miserables.txt 2
ermitage	Miserables.txt 1
ermite	Miserables.txt 1
err	Miserables.txt 3
errais	Miserables.txt 1
errand	Miserables.txt 9
errands	Miserables.txt 1
erratum	Miserables.txt 2
erring	Miserables.txt 2
error	Miserables.txt 32
errors	Miserables.txt 9
errs	Miserables.txt 1
erudimini	Miserables.txt 1
erudite	Miserables.txt 1
erudition	Miserables.txt 1
eruption	Miserables.txt 4
eruptions	Miserables.txt 3
es	Miserables.txt 2
escape	Miserables.txt 106
escaped	Miserables.txt 42
escapes	Miserables.txt 9
escaping	Miserables.txt 10
escarpment	Miserables.txt 8
escarpments	Miserables.txt 2
escaut	Miserables.txt 1
escort	Miserables.txt 4
escorted	Miserables.txt 5
escoubleau	Miserables.txt 3
escoublon	Miserables.txt 1
escousse	Miserables.txt 1
esdras	Miserables.txt 1
esepius	Miserables.txt 1
espace	Miserables.txt 1
espalier	Miserables.txt 2
especially	Miserables.txt 19
espied	Miserables.txt 11
esplanade	Miserables.txt 7
esplandian	Miserables.txt 2
espouse	Miserables.txt 1
espouses	Miserables.txt 1
espousing	Miserables.txt 1
esprit	Miserables.txt 5
espy	Miserables.txt 1
esquiliae	Miserables.txt 1
esquimaux	Miserables.txt 2
essay	Miserables.txt 1
essayed	Miserables.txt 4
essaying	Miserables.txt 1
essays	Miserables.txt 1
essence	Miserables.txt 3
essences	Miserables.txt 1
essential	Miserables.txt 7
essentially	Miserables.txt 1
essling	Miserables.txt 1
est	Miserables.txt 33
establish	Miserables.txt 2
established	Miserables.txt 40
establishes	Miserables.txt 3
establishing	Miserables.txt 3
establishment	Miserables.txt 28
establishments	Miserables.txt 3
estaient	Miserables.txt 1
estate	Miserables.txt 7
esteem	Miserables.txt 7
esteemed	Miserables.txt 4
estelle	Miserables.txt 1
estienne	Miserables.txt 2
estimable	Miserables.txt 1
estimate	Miserables.txt 2
estimated	Miserables.txt 2
estimation	Miserables.txt 1
estrange	Miserables.txt 1
estrangement	Miserables.txt 4
estranging	Miserables.txt 1
estrapade	Miserables.txt 1
et	Miserables.txt 72
etagere	Miserables.txt 1
etaient	Miserables.txt 2
etain	Miserables.txt 1
etais	Miserables.txt 2
etait	Miserables.txt 5
etala	Miserables.txt 1
etat	Miserables.txt 4
etc	Miserables.txt 61
ete	Miserables.txt 1
eternal	Miserables.txt 31
eternally	Miserables.txt 5
eternity	Miserables.txt 19
ether	Miserables.txt 2
ethereal	Miserables.txt 1
etienne	Miserables.txt 3
etiez	Miserables.txt 1
etiolates	Miserables.txt 1
etions	Miserables.txt 1
etiquette	Miserables.txt 2
etoile	Miserables.txt 5
etoiles	Miserables.txt 1
etonne	Miserables.txt 1
etrange	Miserables.txt 1
etre	Miserables.txt 4
etymologically	Miserables.txt 2
etymologists	Miserables.txt 1
etymology	Miserables.txt 2
euchology	Miserables.txt 1
eucnemos	Miserables.txt 1
eudamidas	Miserables.txt 1
eugene	Miserables.txt 2
eulogium	Miserables.txt 5
eumenides	Miserables.txt 1
eunuch	Miserables.txt 2
eunuchs	Miserables.txt 1
euphetes	Miserables.txt 1
euphony	Miserables.txt 1
euphorion	Miserables.txt 1
euphrasie	Miserables.txt 14
euripides	Miserables.txt 2
euripylus	Miserables.txt 1
europe	Miserables.txt 49
european	Miserables.txt 10
euryalus	Miserables.txt 1
euryanthe	Miserables.txt 2
eusebius	Miserables.txt 2
eustache	Miserables.txt 3
eut	Miserables.txt 1
evacuate	Miserables.txt 1
evacuated	Miserables.txt 1
evade	Miserables.txt 1
evaded	Miserables.txt 1
evadne	Miserables.txt 1
evangelical	Miserables.txt 1
evaporating	Miserables.txt 1
evaporation	Miserables.txt 1
evasions	Miserables.txt 1
eve	Miserables.txt 14
even	Miserables.txt 511
evening	Miserables.txt 250
evenings	Miserables.txt 5
event	Miserables.txt 25
eventide	Miserables.txt 2
events	Miserables.txt 54
eventual	Miserables.txt 1
eventually	Miserables.txt 11
eveque	Miserables.txt 1
ever	Miserables.txt 127
every	Miserables.txt 431
everybody	Miserables.txt 20
everyone	Miserables.txt 4
everything	Miserables.txt 317
everywhere	Miserables.txt 68
evidence	Miserables.txt 7
evidences	Miserables.txt 1
evident	Miserables.txt 53
evidently	Miserables.txt 68
evigilabunt	Miserables.txt 1
evil	Miserables.txt 103
evocation	Miserables.txt 1
evohe	Miserables.txt 1
evoke	Miserables.txt 3
evoked	Miserables.txt 7
evokes	Miserables.txt 3
evoking	Miserables.txt 1
evolution	Miserables.txt 4
evolved	Miserables.txt 2
evolving	Miserables.txt 2
evreus	Miserables.txt 1
evverything	Miserables.txt 1
ex	Miserables.txt 34
exact	Miserables.txt 23
exacted	Miserables.txt 7
exactions	Miserables.txt 1
exactly	Miserables.txt 32
exactness	Miserables.txt 3
exaggerate	Miserables.txt 3
exaggerated	Miserables.txt 7
exaggerates	Miserables.txt 1
exaggerating	Miserables.txt 4
exaggeration	Miserables.txt 6
exaggerations	Miserables.txt 4
exaltation	Miserables.txt 2
exalted	Miserables.txt 3
examination	Miserables.txt 14
examinations	Miserables.txt 2
examine	Miserables.txt 12
examined	Miserables.txt 44
examines	Miserables.txt 4
examining	Miserables.txt 18
example	Miserables.txt 30
examples	Miserables.txt 3
exarch	Miserables.txt 1
exasperated	Miserables.txt 12
exasperates	Miserables.txt 1
exasperating	Miserables.txt 3
exasperation	Miserables.txt 2
exasperations	Miserables.txt 1
excavated	Miserables.txt 7
excavating	Miserables.txt 1
excavation	Miserables.txt 4
excavations	Miserables.txt 4
exceed	Miserables.txt 2
exceeded	Miserables.txt 5
exceedingly	Miserables.txt 2
exceeds	Miserables.txt 1
excellence	Miserables.txt 3
excellences	Miserables.txt 1
excellencies	Miserables.txt 1
excellency	Miserables.txt 1
excellent	Miserables.txt 23
except	Miserables.txt 116
excepted	Miserables.txt 1
excepting	Miserables.txt 1
exception	Miserables.txt 39
exceptional	Miserables.txt 3
exceptions	Miserables.txt 4
excess	Miserables.txt 26
excesses	Miserables.txt 4
excessive	Miserables.txt 12
excessively	Miserables.txt 1
exchange	Miserables.txt 16
exchanged	Miserables.txt 19
exchanges	Miserables.txt 2
exchanging	Miserables.txt 1
exchequer	Miserables.txt 1
excite	Miserables.txt 1
excited	Miserables.txt 8
excitement	Miserables.txt 3
exclaim	Miserables.txt 9
exclaimed	Miserables.txt 183
exclaiming	Miserables.txt 5
exclaims	Miserables.txt 6
exclamation	Miserables.txt 15
exclamations	Miserables.txt 2
excluded	Miserables.txt 3
excludes	Miserables.txt 1
exclusion	Miserables.txt 2
exclusive	Miserables.txt 1
exclusively	Miserables.txt 3
excommunicated	Miserables.txt 2
exconvict	Miserables.txt 1
excoriated	Miserables.txt 1
excoriations	Miserables.txt 1
excrement	Miserables.txt 1
excrescence	Miserables.txt 1
excrescences	Miserables.txt 2
excursion	Miserables.txt 1
excursions	Miserables.txt 2
excusable	Miserables.txt 1
excuse	Miserables.txt 19
excused	Miserables.txt 2
excuses	Miserables.txt 3
excusing	Miserables.txt 1
execrable	Miserables.txt 1
execrate	Miserables.txt 4
execrated	Miserables.txt 1
execrates	Miserables.txt 2
execute	Miserables.txt 6
executed	Miserables.txt 25
executes	Miserables.txt 2
executing	Miserables.txt 4
execution	Miserables.txt 13
executioner	Miserables.txt 16
executioners	Miserables.txt 1
executions	Miserables.txt 1
executive	Miserables.txt 1
executoire	Miserables.txt 1
executory	Miserables.txt 1
exelmans	Miserables.txt 1
exempt	Miserables.txt 7
exemption	Miserables.txt 1
exempts	Miserables.txt 3
exercise	Miserables.txt 6
exercised	Miserables.txt 8
exercises	Miserables.txt 1
exercising	Miserables.txt 1
exerted	Miserables.txt 2
exerting	Miserables.txt 1
exertions	Miserables.txt 1
exfoliated	Miserables.txt 1
exhale	Miserables.txt 1
exhaled	Miserables.txt 7
exhales	Miserables.txt 4
exhaling	Miserables.txt 1
exhaust	Miserables.txt 1
exhausted	Miserables.txt 32
exhausting	Miserables.txt 1
exhaustion	Miserables.txt 6
exhaustions	Miserables.txt 1
exhausts	Miserables.txt 2
exhibit	Miserables.txt 1
exhibited	Miserables.txt 15
exhibition	Miserables.txt 1
exhibitions	Miserables.txt 2
exhilarated	Miserables.txt 1
exhortation	Miserables.txt 2
exhorting	Miserables.txt 1
exigence	Miserables.txt 1
exigencies	Miserables.txt 2
exigency	Miserables.txt 1
exile	Miserables.txt 11
exiled	Miserables.txt 4
exiles	Miserables.txt 2
exist	Miserables.txt 51
existed	Miserables.txt 78
existence	Miserables.txt 62
existences	Miserables.txt 3
existest	Miserables.txt 1
existing	Miserables.txt 3
exists	Miserables.txt 58
exit	Miserables.txt 13
exits	Miserables.txt 3
exodus	Miserables.txt 1
exorbitant	Miserables.txt 2
exordium	Miserables.txt 1
expand	Miserables.txt 1
expanded	Miserables.txt 3
expanding	Miserables.txt 4
expands	Miserables.txt 4
expanse	Miserables.txt 1
expansion	Miserables.txt 3
expansively	Miserables.txt 1
expect	Miserables.txt 20
expectat	Miserables.txt 2
expectation	Miserables.txt 4
expectations	Miserables.txt 3
expected	Miserables.txt 20
expecting	Miserables.txt 14
expects	Miserables.txt 3
expedient	Miserables.txt 17
expedients	Miserables.txt 6
expedition	Miserables.txt 1
expeditious	Miserables.txt 2
expel	Miserables.txt 2
expelled	Miserables.txt 3
expelling	Miserables.txt 1
expend	Miserables.txt 3
expended	Miserables.txt 2
expending	Miserables.txt 2
expenditure	Miserables.txt 5
expenditures	Miserables.txt 2
expends	Miserables.txt 4
expense	Miserables.txt 13
expenses	Miserables.txt 21
expensive	Miserables.txt 3
experience	Miserables.txt 10
experienced	Miserables.txt 38
experiences	Miserables.txt 2
experiment	Miserables.txt 1
experiments	Miserables.txt 4
expiated	Miserables.txt 1
expiates	Miserables.txt 3
expiation	Miserables.txt 14
expiration	Miserables.txt 24
expire	Miserables.txt 2
expired	Miserables.txt 8
expiring	Miserables.txt 2
explain	Miserables.txt 35
explained	Miserables.txt 32
explaining	Miserables.txt 6
explains	Miserables.txt 6
explanation	Miserables.txt 23
explanations	Miserables.txt 4
explicit	Miserables.txt 2
explode	Miserables.txt 1
exploded	Miserables.txt 1
exploits	Miserables.txt 1
exploration	Miserables.txt 1
explorations	Miserables.txt 1
explore	Miserables.txt 2
explored	Miserables.txt 4
exploring	Miserables.txt 2
explosion	Miserables.txt 6
explosions	Miserables.txt 3
explosively	Miserables.txt 1
exporting	Miserables.txt 1
expose	Miserables.txt 4
exposed	Miserables.txt 4
exposes	Miserables.txt 1
exposing	Miserables.txt 1
exposition	Miserables.txt 1
exposure	Miserables.txt 2
express	Miserables.txt 19
expressa	Miserables.txt 1
expressed	Miserables.txt 19
expresses	Miserables.txt 6
expressing	Miserables.txt 3
expression	Miserables.txt 54
expressive	Miserables.txt 14
expressly	Miserables.txt 10
exquisite	Miserables.txt 20
exquisitely	Miserables.txt 1
exquisiteness	Miserables.txt 1
extant	Miserables.txt 1
extend	Miserables.txt 7
extended	Miserables.txt 24
extending	Miserables.txt 5
extends	Miserables.txt 2
extension	Miserables.txt 4
extensive	Miserables.txt 2
extent	Miserables.txt 45
extenuated	Miserables.txt 1
extenuating	Miserables.txt 3
extenuation	Miserables.txt 2
exteremely	Miserables.txt 1
exterior	Miserables.txt 12
exterminate	Miserables.txt 5
exterminated	Miserables.txt 6
exterminates	Miserables.txt 2
exterminating	Miserables.txt 2
extermination	Miserables.txt 5
exterminators	Miserables.txt 1
external	Miserables.txt 9
externally	Miserables.txt 1
externis	Miserables.txt 1
extinct	Miserables.txt 11
extinction	Miserables.txt 8
extinguish	Miserables.txt 4
extinguished	Miserables.txt 25
extinguisher	Miserables.txt 1
extinguishes	Miserables.txt 1
extirpated	Miserables.txt 1
extortionate	Miserables.txt 1
extra	Miserables.txt 4
extract	Miserables.txt 3
extracted	Miserables.txt 12
extracting	Miserables.txt 1
extraction	Miserables.txt 1
extractions	Miserables.txt 1
extracts	Miserables.txt 4
extraordinary	Miserables.txt 30
extravagance	Miserables.txt 1
extravagant	Miserables.txt 3
extravaganzas	Miserables.txt 1
extreme	Miserables.txt 34
extremely	Miserables.txt 24
extremes	Miserables.txt 5
extremest	Miserables.txt 1
extremities	Miserables.txt 11
extremity	Miserables.txt 45
extricate	Miserables.txt 1
extricated	Miserables.txt 9
extricating	Miserables.txt 3
extrication	Miserables.txt 1
exuberance	Miserables.txt 1
exuded	Miserables.txt 1
eye	Miserables.txt 134
eyeballs	Miserables.txt 1
eyebrows	Miserables.txt 4
eyed	Miserables.txt 4
eyeing	Miserables.txt 1
eyelashes	Miserables.txt 3
eyelet	Miserables.txt 1
eyelid	Miserables.txt 1
eyelids	Miserables.txt 11
eyes	Miserables.txt 538
eyesight	Miserables.txt 1
eylau	Miserables.txt 1
eyries	Miserables.txt 1
ezekiel	Miserables.txt 1
