y	NotreDame_De_Paris.txt 3
yard	NotreDame_De_Paris.txt 1
yards	NotreDame_De_Paris.txt 2
yawn	NotreDame_De_Paris.txt 1
yawned	NotreDame_De_Paris.txt 1
yawning	NotreDame_De_Paris.txt 1
ye	NotreDame_De_Paris.txt 3
year	NotreDame_De_Paris.txt 47
years	NotreDame_De_Paris.txt 81
yellow	NotreDame_De_Paris.txt 23
yells	NotreDame_De_Paris.txt 1
yelped	NotreDame_De_Paris.txt 3
yelping	NotreDame_De_Paris.txt 4
yes	NotreDame_De_Paris.txt 95
yesterday	NotreDame_De_Paris.txt 10
yet	NotreDame_De_Paris.txt 56
yeux	NotreDame_De_Paris.txt 1
yield	NotreDame_De_Paris.txt 1
yielded	NotreDame_De_Paris.txt 5
yielding	NotreDame_De_Paris.txt 3
yields	NotreDame_De_Paris.txt 1
yoke	NotreDame_De_Paris.txt 1
yolk	NotreDame_De_Paris.txt 1
yon	NotreDame_De_Paris.txt 1
yonder	NotreDame_De_Paris.txt 37
you	NotreDame_De_Paris.txt 1458
young	NotreDame_De_Paris.txt 213
younger	NotreDame_De_Paris.txt 3
youngest	NotreDame_De_Paris.txt 2
your	NotreDame_De_Paris.txt 356
yours	NotreDame_De_Paris.txt 12
yourself	NotreDame_De_Paris.txt 31
yourselves	NotreDame_De_Paris.txt 3
youth	NotreDame_De_Paris.txt 8
youthful	NotreDame_De_Paris.txt 1
youthfulness	NotreDame_De_Paris.txt 1
yvela	NotreDame_De_Paris.txt 1
yves	NotreDame_De_Paris.txt 1
