t	NotreDame_De_Paris.txt 61
ta	NotreDame_De_Paris.txt 1
tabernacle	NotreDame_De_Paris.txt 1
tabernacles	NotreDame_De_Paris.txt 1
table	NotreDame_De_Paris.txt 56
tables	NotreDame_De_Paris.txt 11
taciturn	NotreDame_De_Paris.txt 1
tack	NotreDame_De_Paris.txt 1
tail	NotreDame_De_Paris.txt 12
take	NotreDame_De_Paris.txt 114
taken	NotreDame_De_Paris.txt 54
takes	NotreDame_De_Paris.txt 11
taketh	NotreDame_De_Paris.txt 1
taking	NotreDame_De_Paris.txt 28
tale	NotreDame_De_Paris.txt 6
talent	NotreDame_De_Paris.txt 1
talk	NotreDame_De_Paris.txt 12
talked	NotreDame_De_Paris.txt 7
talking	NotreDame_De_Paris.txt 11
talks	NotreDame_De_Paris.txt 3
tall	NotreDame_De_Paris.txt 8
taller	NotreDame_De_Paris.txt 1
tallow	NotreDame_De_Paris.txt 3
talon	NotreDame_De_Paris.txt 1
talons	NotreDame_De_Paris.txt 2
tambourine	NotreDame_De_Paris.txt 24
tambourines	NotreDame_De_Paris.txt 2
tamed	NotreDame_De_Paris.txt 1
tamen	NotreDame_De_Paris.txt 2
tan	NotreDame_De_Paris.txt 3
tancarville	NotreDame_De_Paris.txt 1
tangled	NotreDame_De_Paris.txt 2
tannerie	NotreDame_De_Paris.txt 1
tanners	NotreDame_De_Paris.txt 1
tantalus	NotreDame_De_Paris.txt 1
tantrums	NotreDame_De_Paris.txt 1
tap	NotreDame_De_Paris.txt 1
tapering	NotreDame_De_Paris.txt 1
tapestried	NotreDame_De_Paris.txt 1
tapestries	NotreDame_De_Paris.txt 5
tapestry	NotreDame_De_Paris.txt 11
tapping	NotreDame_De_Paris.txt 1
taps	NotreDame_De_Paris.txt 1
tarascon	NotreDame_De_Paris.txt 1
tarasques	NotreDame_De_Paris.txt 1
tardy	NotreDame_De_Paris.txt 1
tares	NotreDame_De_Paris.txt 1
targe	NotreDame_De_Paris.txt 1
targes	NotreDame_De_Paris.txt 3
target	NotreDame_De_Paris.txt 2
tarme	NotreDame_De_Paris.txt 3
tarnish	NotreDame_De_Paris.txt 1
tarnished	NotreDame_De_Paris.txt 1
tartarus	NotreDame_De_Paris.txt 3
tartary	NotreDame_De_Paris.txt 1
task	NotreDame_De_Paris.txt 5
tassin	NotreDame_De_Paris.txt 1
taste	NotreDame_De_Paris.txt 18
tasted	NotreDame_De_Paris.txt 2
tastefully	NotreDame_De_Paris.txt 1
tastes	NotreDame_De_Paris.txt 2
tasting	NotreDame_De_Paris.txt 2
tattered	NotreDame_De_Paris.txt 1
tatters	NotreDame_De_Paris.txt 5
tattle	NotreDame_De_Paris.txt 1
tattooed	NotreDame_De_Paris.txt 1
taught	NotreDame_De_Paris.txt 5
taurinum	NotreDame_De_Paris.txt 1
tavern	NotreDame_De_Paris.txt 14
taverns	NotreDame_De_Paris.txt 2
tawers	NotreDame_De_Paris.txt 1
tawny	NotreDame_De_Paris.txt 2
taws	NotreDame_De_Paris.txt 1
tax	NotreDame_De_Paris.txt 8
taxes	NotreDame_De_Paris.txt 5
te	NotreDame_De_Paris.txt 18
teach	NotreDame_De_Paris.txt 6
teacher	NotreDame_De_Paris.txt 1
teaching	NotreDame_De_Paris.txt 1
team	NotreDame_De_Paris.txt 1
tear	NotreDame_De_Paris.txt 24
tearing	NotreDame_De_Paris.txt 2
tearless	NotreDame_De_Paris.txt 3
tears	NotreDame_De_Paris.txt 32
teasing	NotreDame_De_Paris.txt 2
teau	NotreDame_De_Paris.txt 4
teaufort	NotreDame_De_Paris.txt 1
teaumorant	NotreDame_De_Paris.txt 1
teaupers	NotreDame_De_Paris.txt 21
tedium	NotreDame_De_Paris.txt 1
teeth	NotreDame_De_Paris.txt 58
tel	NotreDame_De_Paris.txt 45
telegraph	NotreDame_De_Paris.txt 1
telet	NotreDame_De_Paris.txt 30
tell	NotreDame_De_Paris.txt 70
telling	NotreDame_De_Paris.txt 3
tells	NotreDame_De_Paris.txt 1
tels	NotreDame_De_Paris.txt 6
temper	NotreDame_De_Paris.txt 5
temperament	NotreDame_De_Paris.txt 1
temperature	NotreDame_De_Paris.txt 2
tempest	NotreDame_De_Paris.txt 8
tempestuous	NotreDame_De_Paris.txt 1
templars	NotreDame_De_Paris.txt 1
temple	NotreDame_De_Paris.txt 22
temples	NotreDame_De_Paris.txt 3
temporal	NotreDame_De_Paris.txt 4
temporarily	NotreDame_De_Paris.txt 2
temporizing	NotreDame_De_Paris.txt 1
temps	NotreDame_De_Paris.txt 1
temptation	NotreDame_De_Paris.txt 3
temptations	NotreDame_De_Paris.txt 1
tempus	NotreDame_De_Paris.txt 1
ten	NotreDame_De_Paris.txt 19
tenable	NotreDame_De_Paris.txt 1
tenacious	NotreDame_De_Paris.txt 2
tenant	NotreDame_De_Paris.txt 1
tended	NotreDame_De_Paris.txt 1
tender	NotreDame_De_Paris.txt 15
tenderest	NotreDame_De_Paris.txt 1
tenderly	NotreDame_De_Paris.txt 6
tenderness	NotreDame_De_Paris.txt 12
tendras	NotreDame_De_Paris.txt 1
tenebrae	NotreDame_De_Paris.txt 1
tenfold	NotreDame_De_Paris.txt 1
teniers	NotreDame_De_Paris.txt 1
tennis	NotreDame_De_Paris.txt 2
tenon	NotreDame_De_Paris.txt 1
tenor	NotreDame_De_Paris.txt 3
tenore	NotreDame_De_Paris.txt 1
tenth	NotreDame_De_Paris.txt 3
term	NotreDame_De_Paris.txt 1
terminate	NotreDame_De_Paris.txt 1
terminated	NotreDame_De_Paris.txt 7
terms	NotreDame_De_Paris.txt 24
terrain	NotreDame_De_Paris.txt 9
terrestrem	NotreDame_De_Paris.txt 1
terrestrial	NotreDame_De_Paris.txt 2
terrible	NotreDame_De_Paris.txt 42
terrific	NotreDame_De_Paris.txt 1
terrified	NotreDame_De_Paris.txt 15
terrifying	NotreDame_De_Paris.txt 1
terror	NotreDame_De_Paris.txt 40
terrorem	NotreDame_De_Paris.txt 1
tertio	NotreDame_De_Paris.txt 2
testament	NotreDame_De_Paris.txt 1
testaments	NotreDame_De_Paris.txt 1
tested	NotreDame_De_Paris.txt 2
testers	NotreDame_De_Paris.txt 1
testimony	NotreDame_De_Paris.txt 3
testudo	NotreDame_De_Paris.txt 1
tetrahedral	NotreDame_De_Paris.txt 1
text	NotreDame_De_Paris.txt 7
th	NotreDame_De_Paris.txt 7
than	NotreDame_De_Paris.txt 322
thank	NotreDame_De_Paris.txt 4
thanked	NotreDame_De_Paris.txt 2
thanks	NotreDame_De_Paris.txt 18
that	NotreDame_De_Paris.txt 2464
thatched	NotreDame_De_Paris.txt 1
the	NotreDame_De_Paris.txt 14760
theatre	NotreDame_De_Paris.txt 10
theatres	NotreDame_De_Paris.txt 1
theatrical	NotreDame_De_Paris.txt 5
thee	NotreDame_De_Paris.txt 26
theft	NotreDame_De_Paris.txt 2
their	NotreDame_De_Paris.txt 423
them	NotreDame_De_Paris.txt 326
themis	NotreDame_De_Paris.txt 1
themselves	NotreDame_De_Paris.txt 67
then	NotreDame_De_Paris.txt 463
thence	NotreDame_De_Paris.txt 4
thenceforth	NotreDame_De_Paris.txt 2
theocracy	NotreDame_De_Paris.txt 5
theocratic	NotreDame_De_Paris.txt 5
theodore	NotreDame_De_Paris.txt 2
theologians	NotreDame_De_Paris.txt 4
theology	NotreDame_De_Paris.txt 4
theories	NotreDame_De_Paris.txt 1
there	NotreDame_De_Paris.txt 631
thereafter	NotreDame_De_Paris.txt 1
thereby	NotreDame_De_Paris.txt 4
therefor	NotreDame_De_Paris.txt 1
therefore	NotreDame_De_Paris.txt 7
therein	NotreDame_De_Paris.txt 3
thereon	NotreDame_De_Paris.txt 1
thereto	NotreDame_De_Paris.txt 3
thereupon	NotreDame_De_Paris.txt 3
thermaturgist	NotreDame_De_Paris.txt 1
thesaurarii	NotreDame_De_Paris.txt 1
these	NotreDame_De_Paris.txt 246
they	NotreDame_De_Paris.txt 516
thibaud	NotreDame_De_Paris.txt 1
thibaude	NotreDame_De_Paris.txt 2
thibauld	NotreDame_De_Paris.txt 3
thibaut	NotreDame_De_Paris.txt 9
thibautod	NotreDame_De_Paris.txt 2
thiboust	NotreDame_De_Paris.txt 1
thick	NotreDame_De_Paris.txt 17
thickest	NotreDame_De_Paris.txt 2
thicket	NotreDame_De_Paris.txt 7
thickets	NotreDame_De_Paris.txt 4
thickly	NotreDame_De_Paris.txt 3
thickness	NotreDame_De_Paris.txt 4
thickset	NotreDame_De_Paris.txt 4
thief	NotreDame_De_Paris.txt 13
thierry	NotreDame_De_Paris.txt 1
thierrye	NotreDame_De_Paris.txt 3
thieves	NotreDame_De_Paris.txt 31
thieving	NotreDame_De_Paris.txt 2
thighs	NotreDame_De_Paris.txt 2
thimble	NotreDame_De_Paris.txt 1
thin	NotreDame_De_Paris.txt 13
thine	NotreDame_De_Paris.txt 6
thing	NotreDame_De_Paris.txt 77
things	NotreDame_De_Paris.txt 71
think	NotreDame_De_Paris.txt 49
thinker	NotreDame_De_Paris.txt 2
thinkest	NotreDame_De_Paris.txt 1
thinking	NotreDame_De_Paris.txt 23
thinks	NotreDame_De_Paris.txt 7
thinner	NotreDame_De_Paris.txt 3
thinness	NotreDame_De_Paris.txt 1
third	NotreDame_De_Paris.txt 26
thirst	NotreDame_De_Paris.txt 3
thirteen	NotreDame_De_Paris.txt 3
thirteenth	NotreDame_De_Paris.txt 5
thirty	NotreDame_De_Paris.txt 17
this	NotreDame_De_Paris.txt 1010
thistle	NotreDame_De_Paris.txt 1
thither	NotreDame_De_Paris.txt 9
thomas	NotreDame_De_Paris.txt 2
thomasse	NotreDame_De_Paris.txt 1
thongs	NotreDame_De_Paris.txt 8
thonne	NotreDame_De_Paris.txt 1
thorns	NotreDame_De_Paris.txt 1
thorough	NotreDame_De_Paris.txt 1
thoroughfares	NotreDame_De_Paris.txt 3
thoroughly	NotreDame_De_Paris.txt 11
thorrettes	NotreDame_De_Paris.txt 1
those	NotreDame_De_Paris.txt 181
thou	NotreDame_De_Paris.txt 48
though	NotreDame_De_Paris.txt 91
thought	NotreDame_De_Paris.txt 147
thoughtful	NotreDame_De_Paris.txt 8
thoughtfully	NotreDame_De_Paris.txt 1
thoughts	NotreDame_De_Paris.txt 20
thousand	NotreDame_De_Paris.txt 95
thousands	NotreDame_De_Paris.txt 12
thrash	NotreDame_De_Paris.txt 1
thrashed	NotreDame_De_Paris.txt 1
thread	NotreDame_De_Paris.txt 12
threadbare	NotreDame_De_Paris.txt 3
threads	NotreDame_De_Paris.txt 2
threatening	NotreDame_De_Paris.txt 3
threats	NotreDame_De_Paris.txt 2
three	NotreDame_De_Paris.txt 147
threshold	NotreDame_De_Paris.txt 15
thresholds	NotreDame_De_Paris.txt 1
threw	NotreDame_De_Paris.txt 24
thrice	NotreDame_De_Paris.txt 1
thrilling	NotreDame_De_Paris.txt 1
thrive	NotreDame_De_Paris.txt 1
throat	NotreDame_De_Paris.txt 15
throats	NotreDame_De_Paris.txt 3
throne	NotreDame_De_Paris.txt 6
throng	NotreDame_De_Paris.txt 35
thronged	NotreDame_De_Paris.txt 5
through	NotreDame_De_Paris.txt 176
throughout	NotreDame_De_Paris.txt 3
throw	NotreDame_De_Paris.txt 2
throwing	NotreDame_De_Paris.txt 5
thrown	NotreDame_De_Paris.txt 9
throws	NotreDame_De_Paris.txt 1
thrummed	NotreDame_De_Paris.txt 1
thrust	NotreDame_De_Paris.txt 22
thrusting	NotreDame_De_Paris.txt 5
thrusts	NotreDame_De_Paris.txt 1
thumb	NotreDame_De_Paris.txt 3
thunder	NotreDame_De_Paris.txt 15
thunderbolt	NotreDame_De_Paris.txt 1
thunderbolts	NotreDame_De_Paris.txt 1
thunderous	NotreDame_De_Paris.txt 1
thunderstruck	NotreDame_De_Paris.txt 1
thunes	NotreDame_De_Paris.txt 22
thus	NotreDame_De_Paris.txt 131
thwacks	NotreDame_De_Paris.txt 1
thy	NotreDame_De_Paris.txt 18
thyself	NotreDame_De_Paris.txt 3
tiara	NotreDame_De_Paris.txt 3
tibi	NotreDame_De_Paris.txt 1
tickled	NotreDame_De_Paris.txt 3
tide	NotreDame_De_Paris.txt 4
tied	NotreDame_De_Paris.txt 5
tierra	NotreDame_De_Paris.txt 1
tiger	NotreDame_De_Paris.txt 6
tigers	NotreDame_De_Paris.txt 2
tighter	NotreDame_De_Paris.txt 1
tigress	NotreDame_De_Paris.txt 3
tile	NotreDame_De_Paris.txt 2
tiled	NotreDame_De_Paris.txt 1
tiles	NotreDame_De_Paris.txt 2
till	NotreDame_De_Paris.txt 5
tilloy	NotreDame_De_Paris.txt 1
timantis	NotreDame_De_Paris.txt 1
timber	NotreDame_De_Paris.txt 6
timbers	NotreDame_De_Paris.txt 1
time	NotreDame_De_Paris.txt 276
timebo	NotreDame_De_Paris.txt 1
times	NotreDame_De_Paris.txt 29
timid	NotreDame_De_Paris.txt 7
timidity	NotreDame_De_Paris.txt 2
timidly	NotreDame_De_Paris.txt 3
timing	NotreDame_De_Paris.txt 1
tin	NotreDame_De_Paris.txt 3
tinge	NotreDame_De_Paris.txt 1
tinged	NotreDame_De_Paris.txt 1
tingueux	NotreDame_De_Paris.txt 1
tinsel	NotreDame_De_Paris.txt 7
tint	NotreDame_De_Paris.txt 1
tiny	NotreDame_De_Paris.txt 29
tip	NotreDame_De_Paris.txt 9
tips	NotreDame_De_Paris.txt 2
tipsy	NotreDame_De_Paris.txt 1
tiptoe	NotreDame_De_Paris.txt 6
tirades	NotreDame_De_Paris.txt 1
tirechappe	NotreDame_De_Paris.txt 6
tired	NotreDame_De_Paris.txt 1
tiresome	NotreDame_De_Paris.txt 3
tis	NotreDame_De_Paris.txt 230
titan	NotreDame_De_Paris.txt 1
title	NotreDame_De_Paris.txt 7
titles	NotreDame_De_Paris.txt 5
tixeranderie	NotreDame_De_Paris.txt 2
tm	NotreDame_De_Paris.txt 57
to	NotreDame_De_Paris.txt 4237
toad	NotreDame_De_Paris.txt 1
tocsin	NotreDame_De_Paris.txt 1
toe	NotreDame_De_Paris.txt 2
toed	NotreDame_De_Paris.txt 1
together	NotreDame_De_Paris.txt 42
toilet	NotreDame_De_Paris.txt 5
toils	NotreDame_De_Paris.txt 1
toises	NotreDame_De_Paris.txt 3
token	NotreDame_De_Paris.txt 2
told	NotreDame_De_Paris.txt 24
tolerable	NotreDame_De_Paris.txt 1
tolerably	NotreDame_De_Paris.txt 13
toll	NotreDame_De_Paris.txt 3
tollgates	NotreDame_De_Paris.txt 1
tolls	NotreDame_De_Paris.txt 1
tom	NotreDame_De_Paris.txt 1
tomb	NotreDame_De_Paris.txt 15
tombs	NotreDame_De_Paris.txt 2
ton	NotreDame_De_Paris.txt 1
tone	NotreDame_De_Paris.txt 51
toned	NotreDame_De_Paris.txt 2
tones	NotreDame_De_Paris.txt 8
tongs	NotreDame_De_Paris.txt 2
tongue	NotreDame_De_Paris.txt 30
tongues	NotreDame_De_Paris.txt 8
tonnerre	NotreDame_De_Paris.txt 4
tonnier	NotreDame_De_Paris.txt 1
tons	NotreDame_De_Paris.txt 1
tonsure	NotreDame_De_Paris.txt 2
tonum	NotreDame_De_Paris.txt 1
too	NotreDame_De_Paris.txt 89
took	NotreDame_De_Paris.txt 90
tools	NotreDame_De_Paris.txt 4
tooth	NotreDame_De_Paris.txt 3
toothed	NotreDame_De_Paris.txt 2
toothless	NotreDame_De_Paris.txt 2
top	NotreDame_De_Paris.txt 25
topmast	NotreDame_De_Paris.txt 1
topmost	NotreDame_De_Paris.txt 2
tops	NotreDame_De_Paris.txt 1
torch	NotreDame_De_Paris.txt 10
torches	NotreDame_De_Paris.txt 23
torchi	NotreDame_De_Paris.txt 4
torcy	NotreDame_De_Paris.txt 1
tore	NotreDame_De_Paris.txt 14
torment	NotreDame_De_Paris.txt 3
tormented	NotreDame_De_Paris.txt 2
tormenting	NotreDame_De_Paris.txt 2
tormentor	NotreDame_De_Paris.txt 5
tormentors	NotreDame_De_Paris.txt 1
torn	NotreDame_De_Paris.txt 14
torpid	NotreDame_De_Paris.txt 1
torrent	NotreDame_De_Paris.txt 2
torrents	NotreDame_De_Paris.txt 1
tort	NotreDame_De_Paris.txt 1
torterue	NotreDame_De_Paris.txt 9
tortoise	NotreDame_De_Paris.txt 2
tortuous	NotreDame_De_Paris.txt 6
tortuously	NotreDame_De_Paris.txt 1
torture	NotreDame_De_Paris.txt 25
tortured	NotreDame_De_Paris.txt 4
torturer	NotreDame_De_Paris.txt 7
torturers	NotreDame_De_Paris.txt 2
tortures	NotreDame_De_Paris.txt 1
toss	NotreDame_De_Paris.txt 1
tossed	NotreDame_De_Paris.txt 10
tossing	NotreDame_De_Paris.txt 2
tota	NotreDame_De_Paris.txt 1
total	NotreDame_De_Paris.txt 4
totalized	NotreDame_De_Paris.txt 1
totally	NotreDame_De_Paris.txt 1
tottering	NotreDame_De_Paris.txt 1
touch	NotreDame_De_Paris.txt 18
touched	NotreDame_De_Paris.txt 19
touches	NotreDame_De_Paris.txt 1
touching	NotreDame_De_Paris.txt 8
tour	NotreDame_De_Paris.txt 27
tourangeau	NotreDame_De_Paris.txt 20
touraugeau	NotreDame_De_Paris.txt 1
tournay	NotreDame_De_Paris.txt 4
tourne	NotreDame_De_Paris.txt 1
tournelle	NotreDame_De_Paris.txt 11
tournelles	NotreDame_De_Paris.txt 11
tournois	NotreDame_De_Paris.txt 2
tournus	NotreDame_De_Paris.txt 1
tours	NotreDame_De_Paris.txt 6
tourville	NotreDame_De_Paris.txt 1
tous	NotreDame_De_Paris.txt 1
toussaint	NotreDame_De_Paris.txt 1
tout	NotreDame_De_Paris.txt 1
tow	NotreDame_De_Paris.txt 1
toward	NotreDame_De_Paris.txt 9
towards	NotreDame_De_Paris.txt 125
towed	NotreDame_De_Paris.txt 1
towels	NotreDame_De_Paris.txt 1
tower	NotreDame_De_Paris.txt 96
towers	NotreDame_De_Paris.txt 89
town	NotreDame_De_Paris.txt 46
towns	NotreDame_De_Paris.txt 3
toy	NotreDame_De_Paris.txt 1
toyed	NotreDame_De_Paris.txt 1
toys	NotreDame_De_Paris.txt 1
tr	NotreDame_De_Paris.txt 1
trace	NotreDame_De_Paris.txt 1
traced	NotreDame_De_Paris.txt 5
traces	NotreDame_De_Paris.txt 4
track	NotreDame_De_Paris.txt 1
trade	NotreDame_De_Paris.txt 11
trademark	NotreDame_De_Paris.txt 11
trades	NotreDame_De_Paris.txt 3
tradition	NotreDame_De_Paris.txt 8
traditional	NotreDame_De_Paris.txt 1
traditions	NotreDame_De_Paris.txt 2
tragedies	NotreDame_De_Paris.txt 3
tragedy	NotreDame_De_Paris.txt 4
tragic	NotreDame_De_Paris.txt 5
trahoir	NotreDame_De_Paris.txt 2
trailed	NotreDame_De_Paris.txt 3
trails	NotreDame_De_Paris.txt 1
train	NotreDame_De_Paris.txt 4
trained	NotreDame_De_Paris.txt 4
trait	NotreDame_De_Paris.txt 2
trample	NotreDame_De_Paris.txt 1
trampled	NotreDame_De_Paris.txt 2
trampling	NotreDame_De_Paris.txt 3
tranquil	NotreDame_De_Paris.txt 20
tranquillity	NotreDame_De_Paris.txt 5
tranquillizer	NotreDame_De_Paris.txt 1
tranquilly	NotreDame_De_Paris.txt 6
transcribe	NotreDame_De_Paris.txt 1
transcribed	NotreDame_De_Paris.txt 1
transcription	NotreDame_De_Paris.txt 1
transfer	NotreDame_De_Paris.txt 1
transferred	NotreDame_De_Paris.txt 1
transform	NotreDame_De_Paris.txt 1
transformation	NotreDame_De_Paris.txt 4
transformations	NotreDame_De_Paris.txt 2
transformed	NotreDame_De_Paris.txt 6
transfused	NotreDame_De_Paris.txt 1
transgressed	NotreDame_De_Paris.txt 1
transierunt	NotreDame_De_Paris.txt 1
transit	NotreDame_De_Paris.txt 2
transita	NotreDame_De_Paris.txt 1
transition	NotreDame_De_Paris.txt 4
translate	NotreDame_De_Paris.txt 3
translated	NotreDame_De_Paris.txt 2
translates	NotreDame_De_Paris.txt 1
translator	NotreDame_De_Paris.txt 1
transmitted	NotreDame_De_Paris.txt 3
transparency	NotreDame_De_Paris.txt 2
transparent	NotreDame_De_Paris.txt 4
transport	NotreDame_De_Paris.txt 2
transported	NotreDame_De_Paris.txt 1
transports	NotreDame_De_Paris.txt 1
transverse	NotreDame_De_Paris.txt 1
trap	NotreDame_De_Paris.txt 6
trapdoor	NotreDame_De_Paris.txt 2
trapezium	NotreDame_De_Paris.txt 4
trapezoid	NotreDame_De_Paris.txt 1
trappings	NotreDame_De_Paris.txt 1
travelled	NotreDame_De_Paris.txt 1
traveller	NotreDame_De_Paris.txt 1
traverse	NotreDame_De_Paris.txt 2
traversed	NotreDame_De_Paris.txt 11
traversing	NotreDame_De_Paris.txt 5
tre	NotreDame_De_Paris.txt 6
treacherous	NotreDame_De_Paris.txt 2
tread	NotreDame_De_Paris.txt 2
treason	NotreDame_De_Paris.txt 3
treasure	NotreDame_De_Paris.txt 2
treasurer	NotreDame_De_Paris.txt 2
treasures	NotreDame_De_Paris.txt 2
treasury	NotreDame_De_Paris.txt 4
treat	NotreDame_De_Paris.txt 4
treated	NotreDame_De_Paris.txt 1
treatment	NotreDame_De_Paris.txt 2
trebizond	NotreDame_De_Paris.txt 1
trebizonde	NotreDame_De_Paris.txt 1
treble	NotreDame_De_Paris.txt 1
tree	NotreDame_De_Paris.txt 11
trees	NotreDame_De_Paris.txt 7
trefoil	NotreDame_De_Paris.txt 2
trefoils	NotreDame_De_Paris.txt 4
trellis	NotreDame_De_Paris.txt 2
trellised	NotreDame_De_Paris.txt 1
trellises	NotreDame_De_Paris.txt 1
tremble	NotreDame_De_Paris.txt 9
trembled	NotreDame_De_Paris.txt 26
trembles	NotreDame_De_Paris.txt 1
trembling	NotreDame_De_Paris.txt 16
tremblingly	NotreDame_De_Paris.txt 1
tremendous	NotreDame_De_Paris.txt 1
tremors	NotreDame_De_Paris.txt 1
trerie	NotreDame_De_Paris.txt 1
tres	NotreDame_De_Paris.txt 1
trespassing	NotreDame_De_Paris.txt 1
tresses	NotreDame_De_Paris.txt 3
trestle	NotreDame_De_Paris.txt 2
trestles	NotreDame_De_Paris.txt 1
tri	NotreDame_De_Paris.txt 1
trial	NotreDame_De_Paris.txt 11
trials	NotreDame_De_Paris.txt 1
triancourt	NotreDame_De_Paris.txt 1
triangle	NotreDame_De_Paris.txt 7
triangles	NotreDame_De_Paris.txt 2
tribe	NotreDame_De_Paris.txt 6
tribunal	NotreDame_De_Paris.txt 2
tribunals	NotreDame_De_Paris.txt 1
tribunaux	NotreDame_De_Paris.txt 1
tribute	NotreDame_De_Paris.txt 1
trick	NotreDame_De_Paris.txt 2
tricked	NotreDame_De_Paris.txt 1
trickled	NotreDame_De_Paris.txt 2
trickles	NotreDame_De_Paris.txt 1
trickling	NotreDame_De_Paris.txt 1
tricks	NotreDame_De_Paris.txt 5
tricot	NotreDame_De_Paris.txt 1
tried	NotreDame_De_Paris.txt 35
triel	NotreDame_De_Paris.txt 1
tries	NotreDame_De_Paris.txt 1
trifle	NotreDame_De_Paris.txt 3
trifles	NotreDame_De_Paris.txt 1
trills	NotreDame_De_Paris.txt 2
trimming	NotreDame_De_Paris.txt 1
tringlet	NotreDame_De_Paris.txt 1
trinit	NotreDame_De_Paris.txt 1
trinity	NotreDame_De_Paris.txt 1
trinket	NotreDame_De_Paris.txt 1
trip	NotreDame_De_Paris.txt 1
tripe	NotreDame_De_Paris.txt 2
triple	NotreDame_De_Paris.txt 5
tripod	NotreDame_De_Paris.txt 4
tristan	NotreDame_De_Paris.txt 56
triton	NotreDame_De_Paris.txt 1
triumph	NotreDame_De_Paris.txt 9
triumphant	NotreDame_De_Paris.txt 7
triumphantly	NotreDame_De_Paris.txt 1
triumphed	NotreDame_De_Paris.txt 1
triumphs	NotreDame_De_Paris.txt 3
trivial	NotreDame_De_Paris.txt 1
trivio	NotreDame_De_Paris.txt 1
trochylus	NotreDame_De_Paris.txt 1
troop	NotreDame_De_Paris.txt 7
trooper	NotreDame_De_Paris.txt 1
troops	NotreDame_De_Paris.txt 9
trot	NotreDame_De_Paris.txt 1
trots	NotreDame_De_Paris.txt 1
trotted	NotreDame_De_Paris.txt 1
trotting	NotreDame_De_Paris.txt 1
trouble	NotreDame_De_Paris.txt 18
troubled	NotreDame_De_Paris.txt 12
troubles	NotreDame_De_Paris.txt 1
troublesome	NotreDame_De_Paris.txt 1
troubling	NotreDame_De_Paris.txt 2
trouillefou	NotreDame_De_Paris.txt 27
trouillerfou	NotreDame_De_Paris.txt 1
trousers	NotreDame_De_Paris.txt 1
trouvain	NotreDame_De_Paris.txt 1
troyes	NotreDame_De_Paris.txt 2
truanderie	NotreDame_De_Paris.txt 1
truce	NotreDame_De_Paris.txt 2
true	NotreDame_De_Paris.txt 53
truly	NotreDame_De_Paris.txt 11
trumpet	NotreDame_De_Paris.txt 4
trumpeter	NotreDame_De_Paris.txt 1
trumpeters	NotreDame_De_Paris.txt 1
trumpets	NotreDame_De_Paris.txt 1
truncus	NotreDame_De_Paris.txt 1
trunk	NotreDame_De_Paris.txt 4
trunks	NotreDame_De_Paris.txt 1
truss	NotreDame_De_Paris.txt 4
trusses	NotreDame_De_Paris.txt 1
trust	NotreDame_De_Paris.txt 2
trusting	NotreDame_De_Paris.txt 1
truth	NotreDame_De_Paris.txt 36
try	NotreDame_De_Paris.txt 10
trying	NotreDame_De_Paris.txt 5
tu	NotreDame_De_Paris.txt 3
tucker	NotreDame_De_Paris.txt 2
tuesday	NotreDame_De_Paris.txt 2
tuft	NotreDame_De_Paris.txt 1
tufted	NotreDame_De_Paris.txt 1
tufts	NotreDame_De_Paris.txt 7
tui	NotreDame_De_Paris.txt 2
tuileries	NotreDame_De_Paris.txt 5
tumbled	NotreDame_De_Paris.txt 1
tumbrel	NotreDame_De_Paris.txt 6
tumult	NotreDame_De_Paris.txt 17
tumultuosa	NotreDame_De_Paris.txt 1
tumultuous	NotreDame_De_Paris.txt 6
tumultuously	NotreDame_De_Paris.txt 3
tumulus	NotreDame_De_Paris.txt 2
tunicam	NotreDame_De_Paris.txt 2
tunices	NotreDame_De_Paris.txt 1
tunics	NotreDame_De_Paris.txt 1
tunnels	NotreDame_De_Paris.txt 1
turin	NotreDame_De_Paris.txt 1
turk	NotreDame_De_Paris.txt 1
turkish	NotreDame_De_Paris.txt 3
turn	NotreDame_De_Paris.txt 60
turned	NotreDame_De_Paris.txt 115
turning	NotreDame_De_Paris.txt 35
turnings	NotreDame_De_Paris.txt 1
turnkey	NotreDame_De_Paris.txt 2
turns	NotreDame_De_Paris.txt 11
turnspit	NotreDame_De_Paris.txt 2
turpitude	NotreDame_De_Paris.txt 1
turquant	NotreDame_De_Paris.txt 1
turret	NotreDame_De_Paris.txt 4
turreted	NotreDame_De_Paris.txt 1
turrets	NotreDame_De_Paris.txt 5
tusk	NotreDame_De_Paris.txt 1
tusked	NotreDame_De_Paris.txt 1
tusks	NotreDame_De_Paris.txt 1
tuum	NotreDame_De_Paris.txt 1
twain	NotreDame_De_Paris.txt 2
twas	NotreDame_De_Paris.txt 15
twelfth	NotreDame_De_Paris.txt 4
twelve	NotreDame_De_Paris.txt 15
twentieth	NotreDame_De_Paris.txt 1
twenty	NotreDame_De_Paris.txt 54
twice	NotreDame_De_Paris.txt 5
twilight	NotreDame_De_Paris.txt 4
twill	NotreDame_De_Paris.txt 2
twined	NotreDame_De_Paris.txt 2
twining	NotreDame_De_Paris.txt 2
twinkling	NotreDame_De_Paris.txt 7
twins	NotreDame_De_Paris.txt 1
twirling	NotreDame_De_Paris.txt 4
twist	NotreDame_De_Paris.txt 2
twisted	NotreDame_De_Paris.txt 4
twisting	NotreDame_De_Paris.txt 1
two	NotreDame_De_Paris.txt 349
txt	NotreDame_De_Paris.txt 1
tybalde	NotreDame_De_Paris.txt 2
type	NotreDame_De_Paris.txt 2
types	NotreDame_De_Paris.txt 3
tyrant	NotreDame_De_Paris.txt 1
