b	Miserables.txt 49
babble	Miserables.txt 3
babbled	Miserables.txt 2
babbler	Miserables.txt 2
babbles	Miserables.txt 1
babe	Miserables.txt 2
babel	Miserables.txt 2
babes	Miserables.txt 4
babet	Miserables.txt 49
babeuf	Miserables.txt 4
babilles	Miserables.txt 1
babouvist	Miserables.txt 1
baby	Miserables.txt 6
babylon	Miserables.txt 7
babylone	Miserables.txt 13
baccalaureat	Miserables.txt 1
bacchanal	Miserables.txt 1
bacchanalia	Miserables.txt 1
bacche	Miserables.txt 1
bachelor	Miserables.txt 2
bachelors	Miserables.txt 1
bachelu	Miserables.txt 1
bacheux	Miserables.txt 1
back	Miserables.txt 423
backbone	Miserables.txt 2
backed	Miserables.txt 10
background	Miserables.txt 17
backing	Miserables.txt 1
backs	Miserables.txt 16
backsliders	Miserables.txt 1
backward	Miserables.txt 6
backwards	Miserables.txt 11
bacon	Miserables.txt 6
bacot	Miserables.txt 1
bad	Miserables.txt 107
badajoz	Miserables.txt 3
bade	Miserables.txt 6
badly	Miserables.txt 55
baffled	Miserables.txt 1
bag	Miserables.txt 10
baggage	Miserables.txt 4
bagpipe	Miserables.txt 1
bagpipes	Miserables.txt 2
bagration	Miserables.txt 2
bags	Miserables.txt 2
bah	Miserables.txt 34
bahorel	Miserables.txt 36
baignoire	Miserables.txt 1
bailiff	Miserables.txt 5
baisais	Miserables.txt 1
baiser	Miserables.txt 1
bake	Miserables.txt 1
baker	Miserables.txt 22
bakeshop	Miserables.txt 1
bal	Miserables.txt 1
balaguier	Miserables.txt 1
balance	Miserables.txt 15
balanced	Miserables.txt 4
balances	Miserables.txt 1
balancing	Miserables.txt 1
balatro	Miserables.txt 1
balconies	Miserables.txt 3
balcony	Miserables.txt 5
bald	Miserables.txt 13
baldness	Miserables.txt 1
baldy	Miserables.txt 1
bale	Miserables.txt 1
balearic	Miserables.txt 2
baleful	Miserables.txt 3
bales	Miserables.txt 1
balizard	Miserables.txt 4
ball	Miserables.txt 45
ballad	Miserables.txt 1
ballads	Miserables.txt 1
ballesteros	Miserables.txt 1
ballet	Miserables.txt 2
ballets	Miserables.txt 4
ballistic	Miserables.txt 1
balloon	Miserables.txt 1
balloons	Miserables.txt 1
ballot	Miserables.txt 1
balloting	Miserables.txt 1
balls	Miserables.txt 33
balm	Miserables.txt 1
baloup	Miserables.txt 7
baluster	Miserables.txt 1
balusters	Miserables.txt 2
balustrade	Miserables.txt 2
balzac	Miserables.txt 2
bamatabnois	Miserables.txt 1
bamatabois	Miserables.txt 5
bambino	Miserables.txt 1
bamboche	Miserables.txt 1
bambochel	Miserables.txt 1
bamboo	Miserables.txt 1
ban	Miserables.txt 10
bancroche	Miserables.txt 1
band	Miserables.txt 25
bandage	Miserables.txt 3
bandaged	Miserables.txt 6
bandages	Miserables.txt 4
bandbox	Miserables.txt 1
bandit	Miserables.txt 7
banditism	Miserables.txt 1
bandits	Miserables.txt 4
bands	Miserables.txt 7
bandy	Miserables.txt 1
banes	Miserables.txt 1
bang	Miserables.txt 3
banged	Miserables.txt 1
banished	Miserables.txt 2
banishes	Miserables.txt 1
banishment	Miserables.txt 1
bank	Miserables.txt 53
banker	Miserables.txt 5
bankeress	Miserables.txt 1
bankers	Miserables.txt 2
banknote	Miserables.txt 1
bankrupt	Miserables.txt 7
bankruptcies	Miserables.txt 1
bankruptcy	Miserables.txt 6
bankrupted	Miserables.txt 2
banks	Miserables.txt 12
banlieue	Miserables.txt 9
banner	Miserables.txt 4
bannerel	Miserables.txt 1
banners	Miserables.txt 1
banns	Miserables.txt 1
banquet	Miserables.txt 3
banquets	Miserables.txt 2
banquette	Miserables.txt 4
banquier	Miserables.txt 11
bans	Miserables.txt 1
bantering	Miserables.txt 2
baour	Miserables.txt 1
baptismal	Miserables.txt 5
baptisms	Miserables.txt 1
baptistine	Miserables.txt 28
baptized	Miserables.txt 3
bar	Miserables.txt 49
barabbas	Miserables.txt 1
barague	Miserables.txt 1
barant	Miserables.txt 1
baranton	Miserables.txt 1
barbari	Miserables.txt 1
barbarian	Miserables.txt 1
barbarians	Miserables.txt 4
barbaric	Miserables.txt 1
barbarism	Miserables.txt 4
barbarisms	Miserables.txt 1
barbarous	Miserables.txt 6
barber	Miserables.txt 9
barberess	Miserables.txt 1
barberini	Miserables.txt 1
barberousse	Miserables.txt 1
barbers	Miserables.txt 1
barbier	Miserables.txt 1
barcelona	Miserables.txt 1
barcelonette	Miserables.txt 1
bare	Miserables.txt 64
bared	Miserables.txt 3
barefaced	Miserables.txt 1
barefoot	Miserables.txt 14
barefooted	Miserables.txt 9
barege	Miserables.txt 1
bareheaded	Miserables.txt 3
barely	Miserables.txt 28
bareme	Miserables.txt 1
bargain	Miserables.txt 4
barge	Miserables.txt 2
barillerie	Miserables.txt 1
baring	Miserables.txt 1
barius	Miserables.txt 1
bark	Miserables.txt 10
barked	Miserables.txt 1
barkers	Miserables.txt 1
barking	Miserables.txt 6
barks	Miserables.txt 5
barley	Miserables.txt 1
barleycourt	Miserables.txt 1
barn	Miserables.txt 1
barnacles	Miserables.txt 2
barne	Miserables.txt 1
barneville	Miserables.txt 1
barns	Miserables.txt 2
baron	Miserables.txt 69
baroness	Miserables.txt 2
baronet	Miserables.txt 1
baronne	Miserables.txt 11
barons	Miserables.txt 1
baronship	Miserables.txt 1
barony	Miserables.txt 1
barra	Miserables.txt 3
barrack	Miserables.txt 1
barracks	Miserables.txt 21
barras	Miserables.txt 1
barre	Miserables.txt 2
barrecarrosse	Miserables.txt 1
barred	Miserables.txt 19
barrel	Miserables.txt 13
barrelled	Miserables.txt 5
barrels	Miserables.txt 7
barricade	Miserables.txt 293
barricaded	Miserables.txt 10
barricades	Miserables.txt 41
barricading	Miserables.txt 1
barrier	Miserables.txt 37
barriere	Miserables.txt 31
barrieredes	Miserables.txt 1
barriers	Miserables.txt 13
barring	Miserables.txt 2
barrows	Miserables.txt 2
barry	Miserables.txt 2
bars	Miserables.txt 36
bart	Miserables.txt 1
barthelemy	Miserables.txt 10
barthelemys	Miserables.txt 1
bartholo	Miserables.txt 1
baruch	Miserables.txt 1
bas	Miserables.txt 4
base	Miserables.txt 23
based	Miserables.txt 2
basement	Miserables.txt 1
baseness	Miserables.txt 6
baser	Miserables.txt 1
bases	Miserables.txt 1
basest	Miserables.txt 2
basil	Miserables.txt 2
basile	Miserables.txt 1
basilica	Miserables.txt 1
basils	Miserables.txt 1
basin	Miserables.txt 17
basins	Miserables.txt 3
basket	Miserables.txt 43
baskets	Miserables.txt 1
basque	Miserables.txt 57
bass	Miserables.txt 1
basse	Miserables.txt 1
basses	Miserables.txt 3
basset	Miserables.txt 1
bassompierre	Miserables.txt 2
bastard	Miserables.txt 7
bastide	Miserables.txt 1
bastille	Miserables.txt 28
bastilles	Miserables.txt 3
bastions	Miserables.txt 1
bastringue	Miserables.txt 1
bastringues	Miserables.txt 1
bat	Miserables.txt 8
batarde	Miserables.txt 1
batave	Miserables.txt 1
batch	Miserables.txt 1
batches	Miserables.txt 1
bated	Miserables.txt 1
bateliere	Miserables.txt 1
bath	Miserables.txt 8
bathe	Miserables.txt 1
bathed	Miserables.txt 14
bathing	Miserables.txt 1
baths	Miserables.txt 2
bathtub	Miserables.txt 1
bathurst	Miserables.txt 2
batiment	Miserables.txt 2
batiste	Miserables.txt 2
bative	Miserables.txt 1
battalion	Miserables.txt 17
battalions	Miserables.txt 17
battemolle	Miserables.txt 1
batter	Miserables.txt 2
battered	Miserables.txt 5
batteries	Miserables.txt 11
battering	Miserables.txt 6
battery	Miserables.txt 10
battle	Miserables.txt 139
battledore	Miserables.txt 1
battledores	Miserables.txt 1
battlefield	Miserables.txt 4
battlements	Miserables.txt 1
battles	Miserables.txt 15
battoir	Miserables.txt 1
battue	Miserables.txt 1
bauce	Miserables.txt 1
baucis	Miserables.txt 1
baudoyer	Miserables.txt 1
bauduin	Miserables.txt 5
bautzen	Miserables.txt 2
baville	Miserables.txt 1
bavoux	Miserables.txt 1
bawl	Miserables.txt 3
bawling	Miserables.txt 2
bawls	Miserables.txt 1
bay	Miserables.txt 2
bayard	Miserables.txt 1
bayonet	Miserables.txt 15
bayonets	Miserables.txt 22
bayonne	Miserables.txt 2
bays	Miserables.txt 1
bazile	Miserables.txt 1
be	Miserables.txt 2392
beach	Miserables.txt 7
beaches	Miserables.txt 1
beadle	Miserables.txt 8
beads	Miserables.txt 8
beak	Miserables.txt 7
beaks	Miserables.txt 2
beam	Miserables.txt 15
beamed	Miserables.txt 7
beaming	Miserables.txt 11
beams	Miserables.txt 19
beans	Miserables.txt 2
bear	Miserables.txt 48
bearable	Miserables.txt 1
beard	Miserables.txt 23
bearded	Miserables.txt 12
beardless	Miserables.txt 1
beards	Miserables.txt 3
bearer	Miserables.txt 2
bearers	Miserables.txt 2
bearing	Miserables.txt 41
bearings	Miserables.txt 9
bearnese	Miserables.txt 1
bears	Miserables.txt 31
beast	Miserables.txt 46
beastly	Miserables.txt 4
beasts	Miserables.txt 15
beat	Miserables.txt 23
beaten	Miserables.txt 17
beating	Miserables.txt 19
beats	Miserables.txt 7
beau	Miserables.txt 4
beaubourg	Miserables.txt 2
beauceron	Miserables.txt 2
beauff	Miserables.txt 1
beaufort	Miserables.txt 1
beaujon	Miserables.txt 2
beaulieu	Miserables.txt 3
beaumarchais	Miserables.txt 4
beaumelle	Miserables.txt 1
beausset	Miserables.txt 1
beaute	Miserables.txt 1
beauteous	Miserables.txt 1
beauties	Miserables.txt 11
beautiful	Miserables.txt 110
beautreillis	Miserables.txt 2
beauty	Miserables.txt 50
beauvais	Miserables.txt 3
beaux	Miserables.txt 1
beaver	Miserables.txt 1
bec	Miserables.txt 1
became	Miserables.txt 159
because	Miserables.txt 298
beccaria	Miserables.txt 4
become	Miserables.txt 221
becomes	Miserables.txt 92
becoming	Miserables.txt 53
becoter	Miserables.txt 1
becquillard	Miserables.txt 1
becs	Miserables.txt 1
bed	Miserables.txt 258
bedazzlement	Miserables.txt 1
bedchamber	Miserables.txt 1
bedding	Miserables.txt 1
bedroom	Miserables.txt 10
bedrooms	Miserables.txt 1
beds	Miserables.txt 33
bedside	Miserables.txt 6
bedsides	Miserables.txt 1
bedstead	Miserables.txt 2
bee	Miserables.txt 3
beech	Miserables.txt 2
beef	Miserables.txt 2
beelzebub	Miserables.txt 1
been	Miserables.txt 1517
beer	Miserables.txt 6
beerglass	Miserables.txt 1
bees	Miserables.txt 11
beetle	Miserables.txt 1
beetles	Miserables.txt 1
beetling	Miserables.txt 1
befallen	Miserables.txt 2
befit	Miserables.txt 1
befits	Miserables.txt 4
befitting	Miserables.txt 1
beford	Miserables.txt 1
before	Miserables.txt 501
beforehand	Miserables.txt 4
beg	Miserables.txt 17
began	Miserables.txt 232
begaye	Miserables.txt 1
beget	Miserables.txt 1
beggar	Miserables.txt 28
beggarly	Miserables.txt 1
beggars	Miserables.txt 8
begged	Miserables.txt 6
begging	Miserables.txt 3
begin	Miserables.txt 36
beginning	Miserables.txt 134
beginnings	Miserables.txt 4
begins	Miserables.txt 28
begone	Miserables.txt 1
begs	Miserables.txt 1
beguile	Miserables.txt 1
begun	Miserables.txt 75
behalf	Miserables.txt 4
behave	Miserables.txt 6
behaved	Miserables.txt 2
behaves	Miserables.txt 2
behaving	Miserables.txt 1
behavior	Miserables.txt 1
beheaded	Miserables.txt 1
beheld	Miserables.txt 148
behemoth	Miserables.txt 1
behind	Miserables.txt 291
behold	Miserables.txt 67
beholding	Miserables.txt 5
beholds	Miserables.txt 24
behooved	Miserables.txt 2
behooves	Miserables.txt 1
being	Miserables.txt 469
beings	Miserables.txt 67
bejean	Miserables.txt 1
bel	Miserables.txt 3
belated	Miserables.txt 2
belched	Miserables.txt 1
belfry	Miserables.txt 2
belgian	Miserables.txt 5
belgians	Miserables.txt 3
belgium	Miserables.txt 3
belied	Miserables.txt 1
belief	Miserables.txt 9
beliefs	Miserables.txt 1
belies	Miserables.txt 1
believe	Miserables.txt 62
believed	Miserables.txt 33
believer	Miserables.txt 3
believers	Miserables.txt 1
believes	Miserables.txt 5
believing	Miserables.txt 7
belisaire	Miserables.txt 1
belissen	Miserables.txt 1
belittle	Miserables.txt 2
bell	Miserables.txt 46
bellart	Miserables.txt 1
bellavesne	Miserables.txt 1
belle	Miserables.txt 7
belled	Miserables.txt 2
belles	Miserables.txt 12
belleville	Miserables.txt 4
bellevue	Miserables.txt 1
belli	Miserables.txt 1
bellied	Miserables.txt 1
bellies	Miserables.txt 2
bellona	Miserables.txt 1
bellowing	Miserables.txt 1
bellows	Miserables.txt 3
bells	Miserables.txt 8
bellum	Miserables.txt 1
belly	Miserables.txt 25
belong	Miserables.txt 42
belonged	Miserables.txt 55
belonging	Miserables.txt 9
belongs	Miserables.txt 22
beloved	Miserables.txt 26
below	Miserables.txt 93
belt	Miserables.txt 13
belts	Miserables.txt 4
belvedere	Miserables.txt 1
bem	Miserables.txt 1
bemired	Miserables.txt 2
ben	Miserables.txt 1
benares	Miserables.txt 1
bench	Miserables.txt 67
benches	Miserables.txt 7
bend	Miserables.txt 15
bending	Miserables.txt 19
bendings	Miserables.txt 1
bends	Miserables.txt 2
beneath	Miserables.txt 216
benedictine	Miserables.txt 7
benedictines	Miserables.txt 16
benediction	Miserables.txt 3
benedictions	Miserables.txt 3
benefactor	Miserables.txt 14
benefactors	Miserables.txt 1
benefice	Miserables.txt 1
beneficent	Miserables.txt 1
beneficially	Miserables.txt 1
benefit	Miserables.txt 12
benefiting	Miserables.txt 1
benefits	Miserables.txt 1
benevolence	Miserables.txt 5
benevolent	Miserables.txt 14
bengy	Miserables.txt 1
benigne	Miserables.txt 1
benjamin	Miserables.txt 5
benoit	Miserables.txt 19
bent	Miserables.txt 91
benumbed	Miserables.txt 5
benumbing	Miserables.txt 1
benumbs	Miserables.txt 1
benvenuto	Miserables.txt 1
bequeath	Miserables.txt 2
bequeathed	Miserables.txt 5
bequiabouit	Miserables.txt 1
bequilles	Miserables.txt 1
ber	Miserables.txt 1
bercy	Miserables.txt 3
bereft	Miserables.txt 1
beresina	Miserables.txt 2
bergere	Miserables.txt 2
beribboned	Miserables.txt 1
berlin	Miserables.txt 5
berlins	Miserables.txt 1
bernard	Miserables.txt 15
bernardine	Miserables.txt 2
bernardines	Miserables.txt 18
bernardins	Miserables.txt 1
bernier	Miserables.txt 1
bernis	Miserables.txt 1
berquin	Miserables.txt 1
berri	Miserables.txt 2
berry	Miserables.txt 6
berthier	Miserables.txt 2
bertin	Miserables.txt 1
berton	Miserables.txt 1
bertrand	Miserables.txt 4
berulle	Miserables.txt 4
bes	Miserables.txt 2
besancon	Miserables.txt 1
beseech	Miserables.txt 5
beseeches	Miserables.txt 1
beseeching	Miserables.txt 2
besetting	Miserables.txt 1
beside	Miserables.txt 122
besides	Miserables.txt 74
besieged	Miserables.txt 4
besiegers	Miserables.txt 5
besieging	Miserables.txt 1
besmeared	Miserables.txt 2
besought	Miserables.txt 3
bespattered	Miserables.txt 3
besse	Miserables.txt 1
best	Miserables.txt 57
bestial	Miserables.txt 3
bestiality	Miserables.txt 3
bestow	Miserables.txt 12
bestowed	Miserables.txt 37
bestowing	Miserables.txt 6
bestows	Miserables.txt 5
bestridden	Miserables.txt 1
bestride	Miserables.txt 2
bestrode	Miserables.txt 2
bestucheff	Miserables.txt 2
bet	Miserables.txt 4
betake	Miserables.txt 3
betaken	Miserables.txt 5
betaking	Miserables.txt 3
bete	Miserables.txt 1
bethisy	Miserables.txt 1
bethune	Miserables.txt 1
betimes	Miserables.txt 2
betokened	Miserables.txt 2
betook	Miserables.txt 8
betray	Miserables.txt 3
betrayed	Miserables.txt 20
betraying	Miserables.txt 2
betrothed	Miserables.txt 3
better	Miserables.txt 132
between	Miserables.txt 318
beug	Miserables.txt 1
beure	Miserables.txt 1
beverages	Miserables.txt 1
beware	Miserables.txt 6
bewept	Miserables.txt 2
bewigged	Miserables.txt 1
bewildered	Miserables.txt 22
bewildering	Miserables.txt 1
bewilderment	Miserables.txt 12
bewitched	Miserables.txt 2
bewitching	Miserables.txt 1
beyond	Miserables.txt 68
bibere	Miserables.txt 1
bibines	Miserables.txt 2
bible	Miserables.txt 6
bibles	Miserables.txt 1
biblical	Miserables.txt 3
biceps	Miserables.txt 1
bicetre	Miserables.txt 7
biches	Miserables.txt 1
bichot	Miserables.txt 1
bickering	Miserables.txt 1
bickerings	Miserables.txt 1
bid	Miserables.txt 5
bidden	Miserables.txt 2
bidding	Miserables.txt 4
bids	Miserables.txt 1
bien	Miserables.txt 5
bienvenu	Miserables.txt 25
bier	Miserables.txt 1
bievre	Miserables.txt 2
bifurcated	Miserables.txt 1
big	Miserables.txt 79
bigger	Miserables.txt 5
bigot	Miserables.txt 2
bigoted	Miserables.txt 4
bigotries	Miserables.txt 1
bigotry	Miserables.txt 3
bigottini	Miserables.txt 1
bigre	Miserables.txt 1
bigrenaille	Miserables.txt 17
bigwigs	Miserables.txt 1
bile	Miserables.txt 2
bill	Miserables.txt 26
billancourt	Miserables.txt 1
billards	Miserables.txt 1
billet	Miserables.txt 1
billettes	Miserables.txt 7
billiard	Miserables.txt 8
billiards	Miserables.txt 5
billowing	Miserables.txt 2
billows	Miserables.txt 9
bills	Miserables.txt 13
binary	Miserables.txt 1
binche	Miserables.txt 2
bind	Miserables.txt 6
binding	Miserables.txt 1
binds	Miserables.txt 6
bini	Miserables.txt 1
biographies	Miserables.txt 2
biography	Miserables.txt 1
biped	Miserables.txt 2
bipede	Miserables.txt 1
birague	Miserables.txt 1
bird	Miserables.txt 43
birdlike	Miserables.txt 1
birds	Miserables.txt 51
birth	Miserables.txt 25
birthday	Miserables.txt 4
births	Miserables.txt 2
bis	Miserables.txt 1
bisbilles	Miserables.txt 1
biscaien	Miserables.txt 4
biscaiens	Miserables.txt 1
biscayan	Miserables.txt 2
biscuit	Miserables.txt 5
bishop	Miserables.txt 318
bishopric	Miserables.txt 5
bishops	Miserables.txt 10
bit	Miserables.txt 85
bitch	Miserables.txt 1
bite	Miserables.txt 6
bites	Miserables.txt 4
biting	Miserables.txt 2
bits	Miserables.txt 18
bitten	Miserables.txt 1
bitter	Miserables.txt 18
bitterly	Miserables.txt 7
bitterness	Miserables.txt 12
bitumen	Miserables.txt 1
bivouac	Miserables.txt 8
bivouacked	Miserables.txt 1
bivouacking	Miserables.txt 2
bivouacs	Miserables.txt 2
bizarre	Miserables.txt 3
bizarro	Miserables.txt 1
blachevelle	Miserables.txt 28
black	Miserables.txt 273
blacked	Miserables.txt 1
blacken	Miserables.txt 1
blackened	Miserables.txt 10
blackening	Miserables.txt 1
blackens	Miserables.txt 3
blacker	Miserables.txt 2
blackest	Miserables.txt 3
blackguard	Miserables.txt 11
blackguards	Miserables.txt 3
blacking	Miserables.txt 1
blackish	Miserables.txt 2
blackmann	Miserables.txt 2
blackness	Miserables.txt 11
blacknesses	Miserables.txt 1
blacksmith	Miserables.txt 2
blade	Miserables.txt 15
blades	Miserables.txt 14
blaise	Miserables.txt 2
blame	Miserables.txt 14
blamed	Miserables.txt 8
blameless	Miserables.txt 1
blameworthy	Miserables.txt 1
blanc	Miserables.txt 9
blancard	Miserables.txt 1
blanch	Miserables.txt 1
blanchard	Miserables.txt 1
blanche	Miserables.txt 1
blanched	Miserables.txt 4
blancs	Miserables.txt 6
bland	Miserables.txt 1
blandishments	Miserables.txt 1
blank	Miserables.txt 9
blankenheim	Miserables.txt 1
blanket	Miserables.txt 6
blankets	Miserables.txt 6
blaru	Miserables.txt 4
blas	Miserables.txt 1
blasphemed	Miserables.txt 1
blasphemies	Miserables.txt 1
blasphemous	Miserables.txt 1
blasphemy	Miserables.txt 2
blast	Miserables.txt 5
blasts	Miserables.txt 1
blavet	Miserables.txt 1
blavin	Miserables.txt 1
blaye	Miserables.txt 1
blaze	Miserables.txt 5
blazed	Miserables.txt 1
blazes	Miserables.txt 1
blazing	Miserables.txt 3
bled	Miserables.txt 1
bleed	Miserables.txt 4
bleeding	Miserables.txt 20
bleeds	Miserables.txt 3
blemeur	Miserables.txt 3
blemish	Miserables.txt 1
blemished	Miserables.txt 1
blend	Miserables.txt 1
blended	Miserables.txt 1
bless	Miserables.txt 6
blessed	Miserables.txt 19
blessing	Miserables.txt 9
blessings	Miserables.txt 4
blest	Miserables.txt 1
bleu	Miserables.txt 2
bleue	Miserables.txt 1
blew	Miserables.txt 15
blight	Miserables.txt 1
blighted	Miserables.txt 1
blind	Miserables.txt 72
blinded	Miserables.txt 6
blindfolded	Miserables.txt 1
blinding	Miserables.txt 1
blindly	Miserables.txt 4
blindness	Miserables.txt 14
blinds	Miserables.txt 3
blink	Miserables.txt 1
bliss	Miserables.txt 7
blissful	Miserables.txt 1
blissfulness	Miserables.txt 1
block	Miserables.txt 6
blockaded	Miserables.txt 1
blocked	Miserables.txt 8
blockhead	Miserables.txt 8
blocks	Miserables.txt 11
blomet	Miserables.txt 4
blond	Miserables.txt 13
blonde	Miserables.txt 7
blondeau	Miserables.txt 18
blood	Miserables.txt 108
bloodhound	Miserables.txt 1
bloodhounds	Miserables.txt 1
bloodshed	Miserables.txt 4
bloodshot	Miserables.txt 2
bloody	Miserables.txt 14
bloom	Miserables.txt 3
blooming	Miserables.txt 1
blossom	Miserables.txt 5
blossomed	Miserables.txt 4
blossoming	Miserables.txt 10
blossoms	Miserables.txt 2
blot	Miserables.txt 1
blotches	Miserables.txt 2
blotted	Miserables.txt 1
blotter	Miserables.txt 7
blotting	Miserables.txt 6
blouse	Miserables.txt 45
blouses	Miserables.txt 5
blow	Miserables.txt 59
blowing	Miserables.txt 14
blown	Miserables.txt 1
blows	Miserables.txt 35
blowsy	Miserables.txt 1
blucher	Miserables.txt 25
bludgeon	Miserables.txt 11
bludgeons	Miserables.txt 2
blue	Miserables.txt 81
blueing	Miserables.txt 1
blunder	Miserables.txt 4
blunderbuss	Miserables.txt 1
blunderbusses	Miserables.txt 2
blundered	Miserables.txt 1
blunders	Miserables.txt 3
blunted	Miserables.txt 1
bluntly	Miserables.txt 1
blurred	Miserables.txt 1
blush	Miserables.txt 4
blushed	Miserables.txt 3
blushes	Miserables.txt 2
blushing	Miserables.txt 4
blusterer	Miserables.txt 3
boa	Miserables.txt 4
boar	Miserables.txt 5
board	Miserables.txt 13
boarder	Miserables.txt 1
boarding	Miserables.txt 9
boards	Miserables.txt 6
boast	Miserables.txt 2
boasted	Miserables.txt 2
boasting	Miserables.txt 3
boasts	Miserables.txt 1
boat	Miserables.txt 9
boatman	Miserables.txt 1
boats	Miserables.txt 1
bobbies	Miserables.txt 8
bobby	Miserables.txt 3
bobeche	Miserables.txt 1
bocherville	Miserables.txt 1
bodice	Miserables.txt 10
bodices	Miserables.txt 1
bodies	Miserables.txt 19
bodily	Miserables.txt 5
bodin	Miserables.txt 1
body	Miserables.txt 92
boeotian	Miserables.txt 1
boeuf	Miserables.txt 3
bofeton	Miserables.txt 1
boffete	Miserables.txt 1
bohemia	Miserables.txt 3
bohemian	Miserables.txt 2
bohemians	Miserables.txt 2
boil	Miserables.txt 2
boileau	Miserables.txt 1
boiled	Miserables.txt 3
boiler	Miserables.txt 1
boilers	Miserables.txt 1
boiling	Miserables.txt 6
bois	Miserables.txt 3
boischevron	Miserables.txt 2
boisseau	Miserables.txt 1
boissy	Miserables.txt 1
boisterous	Miserables.txt 1
boitsfort	Miserables.txt 1
bojean	Miserables.txt 1
bol	Miserables.txt 1
bold	Miserables.txt 25
bolder	Miserables.txt 2
boldest	Miserables.txt 2
boldly	Miserables.txt 7
boldness	Miserables.txt 5
bole	Miserables.txt 1
boles	Miserables.txt 1
bolivar	Miserables.txt 2
bolivars	Miserables.txt 1
bologna	Miserables.txt 2
bolster	Miserables.txt 1
bolstered	Miserables.txt 1
bolt	Miserables.txt 9
bolted	Miserables.txt 11
bolts	Miserables.txt 9
bomb	Miserables.txt 3
bombance	Miserables.txt 1
bombarda	Miserables.txt 12
bombardas	Miserables.txt 2
bombarding	Miserables.txt 1
bombardment	Miserables.txt 1
bombs	Miserables.txt 3
bon	Miserables.txt 10
bonald	Miserables.txt 1
bonaparte	Miserables.txt 31
bonapartes	Miserables.txt 1
bonapartism	Miserables.txt 1
bonapartist	Miserables.txt 7
bonapartistes	Miserables.txt 1
bonapartists	Miserables.txt 3
bond	Miserables.txt 7
bonds	Miserables.txt 7
bondy	Miserables.txt 2
bone	Miserables.txt 12
bones	Miserables.txt 22
bonheur	Miserables.txt 1
bonheurs	Miserables.txt 1
bonhomme	Miserables.txt 1
bonjour	Miserables.txt 1
bonnet	Miserables.txt 23
bonneted	Miserables.txt 1
bonnets	Miserables.txt 2
bonoparte	Miserables.txt 1
bonorgue	Miserables.txt 1
bonte	Miserables.txt 1
bony	Miserables.txt 3
bonzes	Miserables.txt 1
boobies	Miserables.txt 2
booby	Miserables.txt 5
book	Miserables.txt 207
bookcase	Miserables.txt 6
bookcover	Miserables.txt 1
books	Miserables.txt 45
bookseller	Miserables.txt 6
bookshelf	Miserables.txt 1
boon	Miserables.txt 1
boor	Miserables.txt 1
boost	Miserables.txt 1
boot	Miserables.txt 15
booted	Miserables.txt 2
booth	Miserables.txt 3
booths	Miserables.txt 4
bootkick	Miserables.txt 1
boots	Miserables.txt 34
bord	Miserables.txt 1
bordeau	Miserables.txt 1
bordeaux	Miserables.txt 2
border	Miserables.txt 6
bordered	Miserables.txt 17
bordering	Miserables.txt 1
borders	Miserables.txt 7
bording	Miserables.txt 1
bore	Miserables.txt 60
borealis	Miserables.txt 1
bored	Miserables.txt 7
bores	Miserables.txt 4
bories	Miserables.txt 1
born	Miserables.txt 49
bornant	Miserables.txt 1
borne	Miserables.txt 20
borrow	Miserables.txt 9
borrowed	Miserables.txt 10
borrows	Miserables.txt 2
bos	Miserables.txt 2
bosh	Miserables.txt 3
bosom	Miserables.txt 9
bosoms	Miserables.txt 1
boss	Miserables.txt 3
bosse	Miserables.txt 1
bossuet	Miserables.txt 75
boston	Miserables.txt 1
botanist	Miserables.txt 2
botany	Miserables.txt 2
both	Miserables.txt 204
bother	Miserables.txt 4
bothers	Miserables.txt 3
botocudos	Miserables.txt 1
botte	Miserables.txt 4
bottle	Miserables.txt 18
bottles	Miserables.txt 20
bottom	Miserables.txt 117
bottomless	Miserables.txt 3
bottoms	Miserables.txt 2
boubers	Miserables.txt 1
boubiere	Miserables.txt 1
bouchard	Miserables.txt 3
bouche	Miserables.txt 2
boucher	Miserables.txt 3
boucherat	Miserables.txt 3
boucs	Miserables.txt 2
bouddha	Miserables.txt 2
boudoir	Miserables.txt 5
bouen	Miserables.txt 2
boufflers	Miserables.txt 1
bouge	Miserables.txt 1
bough	Miserables.txt 3
boughs	Miserables.txt 9
bought	Miserables.txt 13
bouginier	Miserables.txt 1
bougival	Miserables.txt 1
bougon	Miserables.txt 20
bougonmuche	Miserables.txt 1
bouh	Miserables.txt 1
bouibuis	Miserables.txt 1
bouillon	Miserables.txt 1
boujean	Miserables.txt 1
boulanger	Miserables.txt 5
boulard	Miserables.txt 1
boulatreulle	Miserables.txt 1
boulatruelle	Miserables.txt 47
boulders	Miserables.txt 1
boule	Miserables.txt 1
boulevard	Miserables.txt 105
boulevards	Miserables.txt 13
boulogne	Miserables.txt 1
bouloi	Miserables.txt 1
boulonnais	Miserables.txt 3
bouloy	Miserables.txt 1
boum	Miserables.txt 5
bound	Miserables.txt 46
boundaries	Miserables.txt 1
boundary	Miserables.txt 1
bounded	Miserables.txt 6
boundless	Miserables.txt 1
bounds	Miserables.txt 17
bounteous	Miserables.txt 1
bouquet	Miserables.txt 8
bouquetiere	Miserables.txt 1
bouquets	Miserables.txt 6
bouquinist	Miserables.txt 1
bourbe	Miserables.txt 2
bourbon	Miserables.txt 12
bourbons	Miserables.txt 16
bourdon	Miserables.txt 4
bourdonnais	Miserables.txt 1
bourgaillard	Miserables.txt 2
bourgeois	Miserables.txt 106
bourgeoise	Miserables.txt 7
bourgeoisie	Miserables.txt 22
bourgogne	Miserables.txt 2
bourgoin	Miserables.txt 2
bourgon	Miserables.txt 1
bourguin	Miserables.txt 1
bournon	Miserables.txt 1
bousingot	Miserables.txt 3
bout	Miserables.txt 3
bouvines	Miserables.txt 2
bow	Miserables.txt 13
bowed	Miserables.txt 27
bowels	Miserables.txt 5
bower	Miserables.txt 1
bowing	Miserables.txt 3
bowl	Miserables.txt 9
bowling	Miserables.txt 1
bowls	Miserables.txt 3
bows	Miserables.txt 2
box	Miserables.txt 71
boxed	Miserables.txt 5
boxer	Miserables.txt 2
boxes	Miserables.txt 15
boxing	Miserables.txt 2
boy	Miserables.txt 50
boyanches	Miserables.txt 1
boyhood	Miserables.txt 1
boys	Miserables.txt 18
bozzaris	Miserables.txt 1
brac	Miserables.txt 7
bracelets	Miserables.txt 2
brack	Miserables.txt 1
brackets	Miserables.txt 1
braggadocio	Miserables.txt 1
braggart	Miserables.txt 2
brags	Miserables.txt 1
brahmanism	Miserables.txt 1
brahmin	Miserables.txt 3
braid	Miserables.txt 1
braided	Miserables.txt 1
braidings	Miserables.txt 1
braids	Miserables.txt 1
brain	Miserables.txt 45
braine	Miserables.txt 12
brains	Miserables.txt 11
bramble	Miserables.txt 1
brambles	Miserables.txt 2
bran	Miserables.txt 1
branch	Miserables.txt 51
branches	Miserables.txt 51
branching	Miserables.txt 1
branchings	Miserables.txt 2
brand	Miserables.txt 7
brandebourg	Miserables.txt 1
branded	Miserables.txt 1
brandished	Miserables.txt 2
brandishing	Miserables.txt 7
brands	Miserables.txt 6
brandy	Miserables.txt 10
brandywine	Miserables.txt 1
branle	Miserables.txt 1
bras	Miserables.txt 6
brass	Miserables.txt 20
brassard	Miserables.txt 1
brat	Miserables.txt 21
brats	Miserables.txt 22
bravado	Miserables.txt 2
brave	Miserables.txt 26
bravely	Miserables.txt 1
bravery	Miserables.txt 15
bravest	Miserables.txt 2
bravo	Miserables.txt 3
brawl	Miserables.txt 1
brawling	Miserables.txt 1
braying	Miserables.txt 2
brazen	Miserables.txt 6
brazenness	Miserables.txt 1
brazier	Miserables.txt 22
braziers	Miserables.txt 1
brazilian	Miserables.txt 1
breach	Miserables.txt 19
breaches	Miserables.txt 4
bread	Miserables.txt 104
breadth	Miserables.txt 1
break	Miserables.txt 44
breakdown	Miserables.txt 1
breaker	Miserables.txt 1
breakfast	Miserables.txt 29
breakfasted	Miserables.txt 6
breakfasting	Miserables.txt 3
breaking	Miserables.txt 38
breaks	Miserables.txt 12
breast	Miserables.txt 70
breasts	Miserables.txt 9
breastworks	Miserables.txt 1
breath	Miserables.txt 94
breathable	Miserables.txt 2
breathe	Miserables.txt 27
breathed	Miserables.txt 34
breathes	Miserables.txt 2
breathing	Miserables.txt 25
breathless	Miserables.txt 12
breathlessness	Miserables.txt 1
breaths	Miserables.txt 10
bred	Miserables.txt 4
breech	Miserables.txt 2
breeches	Miserables.txt 7
breeds	Miserables.txt 1
breeze	Miserables.txt 21
breezes	Miserables.txt 2
brennus	Miserables.txt 3
brescia	Miserables.txt 1
brest	Miserables.txt 2
bretagne	Miserables.txt 4
brethren	Miserables.txt 2
breton	Miserables.txt 3
bretonne	Miserables.txt 1
bretonnerie	Miserables.txt 2
bretons	Miserables.txt 1
breul	Miserables.txt 1
brevet	Miserables.txt 23
breviary	Miserables.txt 2
brewing	Miserables.txt 1
briancon	Miserables.txt 2
briareus	Miserables.txt 1
briars	Miserables.txt 1
bribe	Miserables.txt 3
bribed	Miserables.txt 1
bribery	Miserables.txt 1
bric	Miserables.txt 8
brick	Miserables.txt 8
bricks	Miserables.txt 5
bridal	Miserables.txt 5
bride	Miserables.txt 12
bridegroom	Miserables.txt 3
bridge	Miserables.txt 53
bridges	Miserables.txt 12
bridle	Miserables.txt 4
bridles	Miserables.txt 1
brie	Miserables.txt 3
brief	Miserables.txt 15
briefless	Miserables.txt 1
briefly	Miserables.txt 2
brienne	Miserables.txt 2
brig	Miserables.txt 2
brigade	Miserables.txt 15
brigades	Miserables.txt 7
brigadier	Miserables.txt 3
brigand	Miserables.txt 10
brigandage	Miserables.txt 1
brigands	Miserables.txt 5
bright	Miserables.txt 9
brightened	Miserables.txt 2
brightly	Miserables.txt 4
brightness	Miserables.txt 3
brignolles	Miserables.txt 1
brilles	Miserables.txt 1
brilliance	Miserables.txt 2
brilliancy	Miserables.txt 6
brilliant	Miserables.txt 25
brilliantly	Miserables.txt 2
brim	Miserables.txt 4
brimmed	Miserables.txt 2
brims	Miserables.txt 1
bring	Miserables.txt 55
bringing	Miserables.txt 15
brings	Miserables.txt 6
brink	Miserables.txt 17
brioche	Miserables.txt 10
brioches	Miserables.txt 1
brique	Miserables.txt 1
brisk	Miserables.txt 4
briskly	Miserables.txt 10
bristle	Miserables.txt 1
bristled	Miserables.txt 2
bristles	Miserables.txt 1
bristling	Miserables.txt 22
britanny	Miserables.txt 1
british	Miserables.txt 2
bro	Miserables.txt 1
broad	Miserables.txt 44
broadening	Miserables.txt 2
broader	Miserables.txt 4
broadest	Miserables.txt 1
broadly	Miserables.txt 2
broadside	Miserables.txt 1
broadswords	Miserables.txt 1
brocken	Miserables.txt 1
broe	Miserables.txt 1
broidered	Miserables.txt 1
broke	Miserables.txt 45
broken	Miserables.txt 115
broker	Miserables.txt 3
bronze	Miserables.txt 7
bronzed	Miserables.txt 1
brood	Miserables.txt 1
brooded	Miserables.txt 3
broods	Miserables.txt 2
brook	Miserables.txt 4
brooks	Miserables.txt 2
broom	Miserables.txt 9
brooms	Miserables.txt 1
broos	Miserables.txt 1
broth	Miserables.txt 2
brothel	Miserables.txt 2
brother	Miserables.txt 103
brotherhood	Miserables.txt 3
brotherly	Miserables.txt 1
brothers	Miserables.txt 21
broths	Miserables.txt 1
brought	Miserables.txt 132
brow	Miserables.txt 85
brown	Miserables.txt 19
brows	Miserables.txt 7
browse	Miserables.txt 2
brrr	Miserables.txt 2
bruguiere	Miserables.txt 1
bruise	Miserables.txt 1
bruised	Miserables.txt 3
bruises	Miserables.txt 1
bruited	Miserables.txt 2
brujon	Miserables.txt 58
brula	Miserables.txt 1
brulart	Miserables.txt 1
brule	Miserables.txt 1
brulee	Miserables.txt 1
brumaire	Miserables.txt 3
brun	Miserables.txt 1
brune	Miserables.txt 2
bruneau	Miserables.txt 1
bruneseau	Miserables.txt 16
brunette	Miserables.txt 1
brunies	Miserables.txt 1
brunswick	Miserables.txt 6
brunswicks	Miserables.txt 1
bruqueselles	Miserables.txt 1
brush	Miserables.txt 6
brushed	Miserables.txt 6
brushes	Miserables.txt 3
brushing	Miserables.txt 2
brushwood	Miserables.txt 15
brusque	Miserables.txt 3
brusquely	Miserables.txt 2
brusqueness	Miserables.txt 1
brussels	Miserables.txt 15
brutal	Miserables.txt 9
brutalities	Miserables.txt 2
brutalize	Miserables.txt 1
brutalized	Miserables.txt 3
brutalizes	Miserables.txt 2
brutalizing	Miserables.txt 1
brutally	Miserables.txt 2
brute	Miserables.txt 12
brutes	Miserables.txt 4
brutishness	Miserables.txt 1
brutus	Miserables.txt 13
bruxelle	Miserables.txt 1
bruys	Miserables.txt 1
brye	Miserables.txt 1
bu	Miserables.txt 1
bubble	Miserables.txt 2
bubbled	Miserables.txt 1
bucelin	Miserables.txt 1
buck	Miserables.txt 4
bucket	Miserables.txt 32
bucketful	Miserables.txt 3
buckets	Miserables.txt 2
buckle	Miserables.txt 5
buckled	Miserables.txt 4
buckler	Miserables.txt 1
buckles	Miserables.txt 3
bucks	Miserables.txt 1
buckshot	Miserables.txt 1
bucolic	Miserables.txt 4
bucolion	Miserables.txt 1
bucolique	Miserables.txt 1
bud	Miserables.txt 2
budded	Miserables.txt 1
buddhism	Miserables.txt 1
budding	Miserables.txt 1
budge	Miserables.txt 1
budget	Miserables.txt 4
buds	Miserables.txt 3
buff	Miserables.txt 2
buffet	Miserables.txt 1
buffooneries	Miserables.txt 1
buffoons	Miserables.txt 1
bug	Miserables.txt 1
bugaboo	Miserables.txt 4
bugeaud	Miserables.txt 6
build	Miserables.txt 2
builders	Miserables.txt 9
building	Miserables.txt 58
buildings	Miserables.txt 25
built	Miserables.txt 41
bulb	Miserables.txt 1
bulge	Miserables.txt 1
bulk	Miserables.txt 1
bulky	Miserables.txt 3
bull	Miserables.txt 9
bullet	Miserables.txt 30
bulletins	Miserables.txt 7
bullets	Miserables.txt 29
bullied	Miserables.txt 1
bullion	Miserables.txt 2
bulls	Miserables.txt 1
bully	Miserables.txt 4
bulow	Miserables.txt 11
bumps	Miserables.txt 1
bunch	Miserables.txt 8
bunches	Miserables.txt 1
bundle	Miserables.txt 18
bundling	Miserables.txt 1
bung	Miserables.txt 1
buona	Miserables.txt 1
buonaparte	Miserables.txt 6
buonapartist	Miserables.txt 2
burden	Miserables.txt 16
burdened	Miserables.txt 2
burdens	Miserables.txt 1
burgesses	Miserables.txt 1
burglar	Miserables.txt 1
burglars	Miserables.txt 1
burglary	Miserables.txt 1
burgon	Miserables.txt 1
burgundy	Miserables.txt 5
burial	Miserables.txt 15
burials	Miserables.txt 2
buried	Miserables.txt 42
buries	Miserables.txt 3
burke	Miserables.txt 1
burlesque	Miserables.txt 1
burn	Miserables.txt 13
burned	Miserables.txt 22
burners	Miserables.txt 1
burning	Miserables.txt 34
burns	Miserables.txt 4
burnt	Miserables.txt 4
burrow	Miserables.txt 1
burrowed	Miserables.txt 1
burrows	Miserables.txt 1
burst	Miserables.txt 75
bursting	Miserables.txt 11
bursts	Miserables.txt 11
burtot	Miserables.txt 1
bury	Miserables.txt 7
burying	Miserables.txt 1
bus	Miserables.txt 2
buseaupied	Miserables.txt 1
bush	Miserables.txt 6
bushel	Miserables.txt 1
bushels	Miserables.txt 1
bushes	Miserables.txt 10
bushy	Miserables.txt 1
busied	Miserables.txt 6
busies	Miserables.txt 1
busily	Miserables.txt 4
business	Miserables.txt 52
busiris	Miserables.txt 1
buskins	Miserables.txt 1
bust	Miserables.txt 5
bustling	Miserables.txt 1
busts	Miserables.txt 1
busy	Miserables.txt 18
busybodies	Miserables.txt 1
busying	Miserables.txt 2
but	Miserables.txt 2048
butcher	Miserables.txt 9
butcheries	Miserables.txt 2
butt	Miserables.txt 5
butter	Miserables.txt 4
buttercup	Miserables.txt 1
buttercups	Miserables.txt 2
butterflies	Miserables.txt 11
butterfly	Miserables.txt 8
buttery	Miserables.txt 1
button	Miserables.txt 6
buttoned	Miserables.txt 12
buttonhole	Miserables.txt 2
buttoning	Miserables.txt 1
buttons	Miserables.txt 11
buttressed	Miserables.txt 3
butts	Miserables.txt 3
buy	Miserables.txt 22
buys	Miserables.txt 2
buzancais	Miserables.txt 1
buzz	Miserables.txt 1
buzzing	Miserables.txt 5
by	Miserables.txt 2473
bygone	Miserables.txt 2
byron	Miserables.txt 3
byronism	Miserables.txt 1
bystanders	Miserables.txt 2
