i	Miserables.txt 3862
ice	Miserables.txt 14
ices	Miserables.txt 2
ici	Miserables.txt 2
icicaille	Miserables.txt 4
icigo	Miserables.txt 2
iconia	Miserables.txt 1
iconoclast	Miserables.txt 1
icy	Miserables.txt 10
id	Miserables.txt 1
idea	Miserables.txt 194
ideal	Miserables.txt 69
idealize	Miserables.txt 1
idealized	Miserables.txt 1
ideally	Miserables.txt 1
ideas	Miserables.txt 95
idem	Miserables.txt 1
identical	Miserables.txt 9
identification	Miserables.txt 1
identified	Miserables.txt 1
identify	Miserables.txt 2
identity	Miserables.txt 21
ideologist	Miserables.txt 1
ideology	Miserables.txt 1
idiom	Miserables.txt 2
idioms	Miserables.txt 1
idiot	Miserables.txt 15
idiotic	Miserables.txt 4
idiots	Miserables.txt 1
idle	Miserables.txt 6
idleness	Miserables.txt 11
idler	Miserables.txt 5
idlers	Miserables.txt 4
idol	Miserables.txt 4
idolatry	Miserables.txt 4
idolize	Miserables.txt 3
idolized	Miserables.txt 6
idolizes	Miserables.txt 1
idyl	Miserables.txt 3
idyls	Miserables.txt 1
iena	Miserables.txt 1
iergue	Miserables.txt 1
if	Miserables.txt 738
igitur	Miserables.txt 1
ignite	Miserables.txt 2
ignited	Miserables.txt 1
ignoble	Miserables.txt 5
ignominious	Miserables.txt 1
ignominy	Miserables.txt 6
ignoramus	Miserables.txt 1
ignorance	Miserables.txt 25
ignorances	Miserables.txt 3
ignorant	Miserables.txt 39
ignorantin	Miserables.txt 1
ignorantly	Miserables.txt 1
ignore	Miserables.txt 6
ignored	Miserables.txt 6
ignores	Miserables.txt 5
ignoring	Miserables.txt 1
ii	Miserables.txt 105
iii	Miserables.txt 92
il	Miserables.txt 13
iliad	Miserables.txt 1
iliads	Miserables.txt 1
ill	Miserables.txt 63
illegal	Miserables.txt 1
illegible	Miserables.txt 4
illegitimacy	Miserables.txt 2
illegitimate	Miserables.txt 2
illicit	Miserables.txt 1
illimitable	Miserables.txt 1
illiterate	Miserables.txt 2
illness	Miserables.txt 6
illnesses	Miserables.txt 2
illogical	Miserables.txt 2
illogically	Miserables.txt 2
illuminate	Miserables.txt 3
illuminated	Miserables.txt 57
illuminates	Miserables.txt 1
illuminating	Miserables.txt 4
illumination	Miserables.txt 7
illuminations	Miserables.txt 3
illumined	Miserables.txt 4
illusion	Miserables.txt 14
illusions	Miserables.txt 11
illustrated	Miserables.txt 1
illustrates	Miserables.txt 1
illustration	Miserables.txt 41
illustrious	Miserables.txt 14
image	Miserables.txt 7
images	Miserables.txt 3
imaginable	Miserables.txt 1
imaginaire	Miserables.txt 1
imagination	Miserables.txt 11
imaginations	Miserables.txt 6
imagine	Miserables.txt 36
imagined	Miserables.txt 14
imagines	Miserables.txt 1
imagining	Miserables.txt 1
imaums	Miserables.txt 1
imbecile	Miserables.txt 6
imbeciles	Miserables.txt 1
imbecility	Miserables.txt 2
imbricated	Miserables.txt 1
imbue	Miserables.txt 1
imbued	Miserables.txt 3
imbushment	Miserables.txt 1
imitate	Miserables.txt 1
imitated	Miserables.txt 6
imitation	Miserables.txt 5
imitations	Miserables.txt 1
imitator	Miserables.txt 1
immaculate	Miserables.txt 2
immaterial	Miserables.txt 1
immediate	Miserables.txt 13
immediately	Miserables.txt 62
immemorial	Miserables.txt 6
immense	Miserables.txt 101
immensely	Miserables.txt 1
immensity	Miserables.txt 19
immersed	Miserables.txt 3
immersion	Miserables.txt 1
imminence	Miserables.txt 2
imminent	Miserables.txt 4
immobility	Miserables.txt 9
immoderately	Miserables.txt 1
immodest	Miserables.txt 1
immodestly	Miserables.txt 1
immodesty	Miserables.txt 2
immolating	Miserables.txt 1
immoral	Miserables.txt 1
immorality	Miserables.txt 1
immortal	Miserables.txt 11
immortality	Miserables.txt 4
immortalize	Miserables.txt 1
immovable	Miserables.txt 3
immovably	Miserables.txt 2
immured	Miserables.txt 2
immutable	Miserables.txt 3
imogene	Miserables.txt 1
imp	Miserables.txt 2
impalpable	Miserables.txt 1
impar	Miserables.txt 1
imparibus	Miserables.txt 1
impart	Miserables.txt 2
imparted	Miserables.txt 5
impartial	Miserables.txt 1
impartially	Miserables.txt 2
imparts	Miserables.txt 1
impassable	Miserables.txt 5
impasse	Miserables.txt 1
impassive	Miserables.txt 15
impatience	Miserables.txt 4
impatient	Miserables.txt 8
impatiently	Miserables.txt 1
impeccability	Miserables.txt 1
impeded	Miserables.txt 2
impelled	Miserables.txt 5
impelling	Miserables.txt 1
impending	Miserables.txt 3
impenetrability	Miserables.txt 1
impenetrable	Miserables.txt 13
imperative	Miserables.txt 1
imperatively	Miserables.txt 2
imperceptible	Miserables.txt 19
imperfectly	Miserables.txt 1
imperial	Miserables.txt 19
imperilled	Miserables.txt 1
imperious	Miserables.txt 11
imperiously	Miserables.txt 3
imperishable	Miserables.txt 1
imperishableness	Miserables.txt 1
impersonal	Miserables.txt 3
impertinence	Miserables.txt 1
impertinent	Miserables.txt 4
imperturbable	Miserables.txt 13
imperturbably	Miserables.txt 4
impetuosity	Miserables.txt 2
impetuous	Miserables.txt 2
impetuously	Miserables.txt 7
impious	Miserables.txt 5
implacable	Miserables.txt 13
implement	Miserables.txt 1
implicated	Miserables.txt 2
implied	Miserables.txt 3
implies	Miserables.txt 2
implore	Miserables.txt 3
implores	Miserables.txt 2
imply	Miserables.txt 2
importance	Miserables.txt 8
important	Miserables.txt 18
imported	Miserables.txt 1
importune	Miserables.txt 1
importuned	Miserables.txt 1
importunity	Miserables.txt 1
impose	Miserables.txt 3
imposed	Miserables.txt 8
imposes	Miserables.txt 1
imposing	Miserables.txt 5
impossibilities	Miserables.txt 2
impossibility	Miserables.txt 7
impossible	Miserables.txt 118
impost	Miserables.txt 1
imposts	Miserables.txt 3
imposture	Miserables.txt 1
impotence	Miserables.txt 1
impotent	Miserables.txt 2
impoverished	Miserables.txt 3
impoverishing	Miserables.txt 1
impoverishment	Miserables.txt 1
impracticable	Miserables.txt 1
imprecation	Miserables.txt 1
imprecations	Miserables.txt 1
impregnable	Miserables.txt 7
impregnated	Miserables.txt 7
impress	Miserables.txt 3
impressed	Miserables.txt 3
impresses	Miserables.txt 1
impressing	Miserables.txt 1
impression	Miserables.txt 19
impressions	Miserables.txt 4
impressive	Miserables.txt 1
imprint	Miserables.txt 5
imprinted	Miserables.txt 5
imprints	Miserables.txt 1
imprison	Miserables.txt 2
imprisoned	Miserables.txt 1
improbability	Miserables.txt 1
improbable	Miserables.txt 4
improper	Miserables.txt 1
improperly	Miserables.txt 1
impropriety	Miserables.txt 1
improve	Miserables.txt 1
improved	Miserables.txt 1
improvement	Miserables.txt 3
improvements	Miserables.txt 1
improvident	Miserables.txt 1
improvisation	Miserables.txt 6
improvise	Miserables.txt 2
improvised	Miserables.txt 9
improvises	Miserables.txt 1
imprudence	Miserables.txt 2
imprudences	Miserables.txt 1
imprudent	Miserables.txt 5
impudent	Miserables.txt 2
impulse	Miserables.txt 12
impulses	Miserables.txt 4
impulsive	Miserables.txt 1
impunity	Miserables.txt 3
impure	Miserables.txt 5
impute	Miserables.txt 1
imputed	Miserables.txt 1
in	Miserables.txt 11214
inaccessible	Miserables.txt 10
inaccurate	Miserables.txt 1
inactive	Miserables.txt 1
inactivity	Miserables.txt 2
inadequate	Miserables.txt 1
inadmissible	Miserables.txt 1
inadvertently	Miserables.txt 1
inanimate	Miserables.txt 1
inanition	Miserables.txt 1
inappropriately	Miserables.txt 1
inarticulate	Miserables.txt 4
inattention	Miserables.txt 2
inauspicious	Miserables.txt 2
incalculable	Miserables.txt 4
incapable	Miserables.txt 15
incapacitated	Miserables.txt 2
incarcerated	Miserables.txt 2
incarcerations	Miserables.txt 1
incarnate	Miserables.txt 4
incarnates	Miserables.txt 1
incarnation	Miserables.txt 2
incarnations	Miserables.txt 1
incendiaries	Miserables.txt 1
incendiary	Miserables.txt 2
incense	Miserables.txt 4
incensed	Miserables.txt 1
incentive	Miserables.txt 1
inception	Miserables.txt 2
incessant	Miserables.txt 2
incessantly	Miserables.txt 31
inch	Miserables.txt 4
inches	Miserables.txt 11
incident	Miserables.txt 21
incidental	Miserables.txt 1
incidents	Miserables.txt 11
incision	Miserables.txt 1
incitatus	Miserables.txt 1
incited	Miserables.txt 1
inclement	Miserables.txt 1
inclination	Miserables.txt 2
incline	Miserables.txt 5
inclined	Miserables.txt 25
include	Miserables.txt 2
included	Miserables.txt 8
includes	Miserables.txt 1
including	Miserables.txt 15
inclusive	Miserables.txt 1
incoherence	Miserables.txt 1
incoherences	Miserables.txt 1
incoherent	Miserables.txt 2
incombustible	Miserables.txt 1
income	Miserables.txt 22
incomparable	Miserables.txt 2
incompatible	Miserables.txt 1
incomplete	Miserables.txt 14
incomprehensibility	Miserables.txt 1
incomprehensible	Miserables.txt 7
inconceivable	Miserables.txt 1
inconceivably	Miserables.txt 1
incongruous	Miserables.txt 1
inconsiderate	Miserables.txt 1
inconsistency	Miserables.txt 1
inconsistently	Miserables.txt 1
inconsolable	Miserables.txt 1
inconstance	Miserables.txt 1
inconstant	Miserables.txt 2
incontestable	Miserables.txt 7
incontestably	Miserables.txt 4
inconvenience	Miserables.txt 6
inconvenienced	Miserables.txt 1
inconveniences	Miserables.txt 2
inconvenient	Miserables.txt 3
incorporated	Miserables.txt 1
incorrect	Miserables.txt 1
incorruptibility	Miserables.txt 3
incorruptible	Miserables.txt 9
increase	Miserables.txt 14
increased	Miserables.txt 28
increases	Miserables.txt 4
increasing	Miserables.txt 10
incredible	Miserables.txt 4
incredulous	Miserables.txt 2
incriminated	Miserables.txt 1
incroyable	Miserables.txt 1
incroyables	Miserables.txt 1
incrusted	Miserables.txt 4
incubation	Miserables.txt 4
inculcation	Miserables.txt 1
incur	Miserables.txt 2
incurable	Miserables.txt 5
incurred	Miserables.txt 2
incurring	Miserables.txt 3
indebted	Miserables.txt 7
indecency	Miserables.txt 1
indecent	Miserables.txt 4
indecently	Miserables.txt 1
indecision	Miserables.txt 10
indecorous	Miserables.txt 1
indeed	Miserables.txt 32
indefatigable	Miserables.txt 3
indefinable	Miserables.txt 5
indefinite	Miserables.txt 5
indefinitely	Miserables.txt 5
indelibly	Miserables.txt 1
indemnify	Miserables.txt 1
indemnity	Miserables.txt 3
indentations	Miserables.txt 1
independence	Miserables.txt 1
independent	Miserables.txt 3
independently	Miserables.txt 2
indescribable	Miserables.txt 57
indescribably	Miserables.txt 20
indestructible	Miserables.txt 2
index	Miserables.txt 1
india	Miserables.txt 11
indian	Miserables.txt 2
indians	Miserables.txt 1
indicate	Miserables.txt 14
indicated	Miserables.txt 36
indicates	Miserables.txt 4
indicating	Miserables.txt 2
indication	Miserables.txt 2
indications	Miserables.txt 3
indicative	Miserables.txt 1
indictment	Miserables.txt 2
indies	Miserables.txt 1
indifference	Miserables.txt 23
indifferences	Miserables.txt 1
indifferent	Miserables.txt 14
indifferently	Miserables.txt 4
indigance	Miserables.txt 1
indigant	Miserables.txt 1
indigence	Miserables.txt 8
indigent	Miserables.txt 8
indigestion	Miserables.txt 2
indignant	Miserables.txt 12
indignantly	Miserables.txt 3
indignatio	Miserables.txt 1
indignation	Miserables.txt 14
indignations	Miserables.txt 2
indignities	Miserables.txt 1
indignity	Miserables.txt 1
indigo	Miserables.txt 8
indirect	Miserables.txt 2
indirectly	Miserables.txt 2
indiscreet	Miserables.txt 3
indiscreetly	Miserables.txt 1
indiscretion	Miserables.txt 4
indispensable	Miserables.txt 14
indisputable	Miserables.txt 2
indissoluble	Miserables.txt 1
indistinct	Miserables.txt 16
indistinctly	Miserables.txt 5
indite	Miserables.txt 1
individual	Miserables.txt 37
individualities	Miserables.txt 1
individuality	Miserables.txt 2
individuals	Miserables.txt 5
indivisible	Miserables.txt 2
indoctrinate	Miserables.txt 1
indolence	Miserables.txt 1
indolent	Miserables.txt 1
indomitable	Miserables.txt 2
indoors	Miserables.txt 1
induce	Miserables.txt 7
induced	Miserables.txt 2
induction	Miserables.txt 1
indulge	Miserables.txt 9
indulged	Miserables.txt 16
indulgence	Miserables.txt 5
indulgent	Miserables.txt 4
indulges	Miserables.txt 2
indulging	Miserables.txt 2
industrial	Miserables.txt 2
industries	Miserables.txt 2
industrious	Miserables.txt 1
industry	Miserables.txt 16
inebriety	Miserables.txt 2
ineffable	Miserables.txt 28
inequality	Miserables.txt 2
inert	Miserables.txt 5
inertia	Miserables.txt 2
inertly	Miserables.txt 1
inevitable	Miserables.txt 5
inevitably	Miserables.txt 3
inexact	Miserables.txt 1
inexactness	Miserables.txt 1
inexcusable	Miserables.txt 1
inexhaustible	Miserables.txt 13
inexorability	Miserables.txt 1
inexorable	Miserables.txt 14
inexorably	Miserables.txt 6
inexpensive	Miserables.txt 1
inexperience	Miserables.txt 2
inexplicable	Miserables.txt 12
inexplicably	Miserables.txt 1
inexpressible	Miserables.txt 15
inexpressibly	Miserables.txt 1
inextricable	Miserables.txt 5
inextricably	Miserables.txt 1
infallibility	Miserables.txt 2
infallible	Miserables.txt 12
infallibly	Miserables.txt 4
infame	Miserables.txt 1
infamies	Miserables.txt 2
infamous	Miserables.txt 20
infamy	Miserables.txt 12
infancy	Miserables.txt 5
infant	Miserables.txt 10
infanticide	Miserables.txt 2
infantile	Miserables.txt 6
infantry	Miserables.txt 29
infantrymen	Miserables.txt 1
infants	Miserables.txt 2
infected	Miserables.txt 2
infectious	Miserables.txt 1
infects	Miserables.txt 1
infelix	Miserables.txt 1
inference	Miserables.txt 2
inferi	Miserables.txt 1
inferior	Miserables.txt 8
infernal	Miserables.txt 4
inferred	Miserables.txt 2
infers	Miserables.txt 1
infested	Miserables.txt 3
infidelity	Miserables.txt 3
infiltration	Miserables.txt 3
infima	Miserables.txt 1
infinite	Miserables.txt 57
infinitely	Miserables.txt 8
infinites	Miserables.txt 1
infinitesimal	Miserables.txt 1
infinities	Miserables.txt 3
infinity	Miserables.txt 9
infirm	Miserables.txt 6
infirmary	Miserables.txt 11
infirmities	Miserables.txt 5
infirmity	Miserables.txt 5
inflamed	Miserables.txt 2
inflammations	Miserables.txt 1
inflation	Miserables.txt 2
inflection	Miserables.txt 2
inflections	Miserables.txt 2
inflexibility	Miserables.txt 1
inflexible	Miserables.txt 3
inflict	Miserables.txt 3
inflicted	Miserables.txt 2
inflicting	Miserables.txt 1
inflicts	Miserables.txt 1
influence	Miserables.txt 14
influenced	Miserables.txt 2
influential	Miserables.txt 1
inform	Miserables.txt 8
information	Miserables.txt 29
informed	Miserables.txt 18
informer	Miserables.txt 2
infraction	Miserables.txt 5
infractions	Miserables.txt 2
infringement	Miserables.txt 1
infringing	Miserables.txt 1
infusion	Miserables.txt 1
infusoria	Miserables.txt 1
infusoriae	Miserables.txt 1
ing	Miserables.txt 1
ingenious	Miserables.txt 12
ingens	Miserables.txt 1
ingenuity	Miserables.txt 2
ingenuous	Miserables.txt 11
ingenuously	Miserables.txt 2
ingenuousness	Miserables.txt 8
ingrate	Miserables.txt 5
ingrates	Miserables.txt 2
ingratitude	Miserables.txt 6
ingrats	Miserables.txt 1
inhabit	Miserables.txt 3
inhabitable	Miserables.txt 1
inhabitant	Miserables.txt 8
inhabitants	Miserables.txt 22
inhabited	Miserables.txt 18
inhabits	Miserables.txt 5
inhalation	Miserables.txt 2
inhalations	Miserables.txt 1
inhale	Miserables.txt 2
inhaled	Miserables.txt 1
inhales	Miserables.txt 1
inherent	Miserables.txt 4
inherit	Miserables.txt 1
inheritance	Miserables.txt 9
inheritances	Miserables.txt 2
inherited	Miserables.txt 7
iniquities	Miserables.txt 4
iniquitous	Miserables.txt 3
iniquity	Miserables.txt 2
initial	Miserables.txt 1
initials	Miserables.txt 1
initiated	Miserables.txt 5
initiative	Miserables.txt 5
initiatives	Miserables.txt 1
initium	Miserables.txt 1
injunction	Miserables.txt 7
injunctions	Miserables.txt 3
injure	Miserables.txt 3
injured	Miserables.txt 9
injuries	Miserables.txt 3
injuring	Miserables.txt 1
injurious	Miserables.txt 2
injury	Miserables.txt 5
injustice	Miserables.txt 6
ink	Miserables.txt 21
inkermann	Miserables.txt 1
inkling	Miserables.txt 3
inks	Miserables.txt 1
inkstand	Miserables.txt 7
inlaid	Miserables.txt 2
inmost	Miserables.txt 5
inn	Miserables.txt 75
innate	Miserables.txt 1
inner	Miserables.txt 13
innkeeper	Miserables.txt 1
innocence	Miserables.txt 28
innocences	Miserables.txt 1
innocent	Miserables.txt 49
innocente	Miserables.txt 4
innocently	Miserables.txt 2
innocents	Miserables.txt 4
innocuous	Miserables.txt 1
inns	Miserables.txt 3
innuendoes	Miserables.txt 1
innumerable	Miserables.txt 9
inoculating	Miserables.txt 1
inoffensive	Miserables.txt 4
inopportunely	Miserables.txt 1
inordinately	Miserables.txt 1
inquire	Miserables.txt 15
inquired	Miserables.txt 36
inquires	Miserables.txt 1
inquiries	Miserables.txt 19
inquiring	Miserables.txt 3
inquiry	Miserables.txt 3
inquisition	Miserables.txt 1
inquisitiveness	Miserables.txt 1
inquisitor	Miserables.txt 1
insalubrity	Miserables.txt 1
insanity	Miserables.txt 1
inscribed	Miserables.txt 12
inscription	Miserables.txt 17
inscriptions	Miserables.txt 2
insect	Miserables.txt 2
insects	Miserables.txt 7
insensible	Miserables.txt 4
insensibly	Miserables.txt 3
inseparable	Miserables.txt 7
inserted	Miserables.txt 5
inside	Miserables.txt 35
insignificant	Miserables.txt 8
insinuated	Miserables.txt 2
insinuations	Miserables.txt 1
insipid	Miserables.txt 3
insipidity	Miserables.txt 1
insist	Miserables.txt 23
insisted	Miserables.txt 9
insistence	Miserables.txt 2
insisting	Miserables.txt 1
insists	Miserables.txt 6
insolence	Miserables.txt 4
insolent	Miserables.txt 3
insolently	Miserables.txt 1
insoluble	Miserables.txt 1
inspect	Miserables.txt 1
inspected	Miserables.txt 1
inspecteur	Miserables.txt 2
inspecting	Miserables.txt 2
inspection	Miserables.txt 4
inspector	Miserables.txt 50
inspectors	Miserables.txt 5
inspiration	Miserables.txt 3
inspire	Miserables.txt 12
inspired	Miserables.txt 23
inspirer	Miserables.txt 1
inspires	Miserables.txt 4
inspiring	Miserables.txt 3
install	Miserables.txt 6
installation	Miserables.txt 1
installed	Miserables.txt 16
installing	Miserables.txt 1
instance	Miserables.txt 14
instances	Miserables.txt 1
instant	Miserables.txt 87
instantaneously	Miserables.txt 1
instanter	Miserables.txt 2
instantly	Miserables.txt 30
instants	Miserables.txt 7
instead	Miserables.txt 50
instigate	Miserables.txt 1
instigation	Miserables.txt 1
instilled	Miserables.txt 1
instinct	Miserables.txt 60
instinctive	Miserables.txt 2
instinctively	Miserables.txt 3
instincts	Miserables.txt 11
institut	Miserables.txt 1
institute	Miserables.txt 4
instituted	Miserables.txt 8
institution	Miserables.txt 3
institutions	Miserables.txt 3
instruct	Miserables.txt 2
instructed	Miserables.txt 2
instruction	Miserables.txt 11
instructions	Miserables.txt 4
instructive	Miserables.txt 1
instructors	Miserables.txt 1
instrument	Miserables.txt 2
instruments	Miserables.txt 5
insue	Miserables.txt 1
insufferable	Miserables.txt 1
insufficient	Miserables.txt 2
insult	Miserables.txt 19
insulted	Miserables.txt 11
insulting	Miserables.txt 3
insults	Miserables.txt 10
insupportable	Miserables.txt 2
insure	Miserables.txt 1
insurgent	Miserables.txt 15
insurgents	Miserables.txt 51
insurrection	Miserables.txt 69
insurrections	Miserables.txt 5
intact	Miserables.txt 3
intangible	Miserables.txt 1
integuments	Miserables.txt 1
intellect	Miserables.txt 1
intellectual	Miserables.txt 4
intelligence	Miserables.txt 38
intelligences	Miserables.txt 1
intelligent	Miserables.txt 27
intelligible	Miserables.txt 1
intend	Miserables.txt 6
intended	Miserables.txt 13
intending	Miserables.txt 9
intends	Miserables.txt 1
intense	Miserables.txt 1
intensely	Miserables.txt 1
intensity	Miserables.txt 5
intent	Miserables.txt 5
intention	Miserables.txt 13
intentional	Miserables.txt 1
intentionally	Miserables.txt 4
intentions	Miserables.txt 3
intently	Miserables.txt 21
intentness	Miserables.txt 1
inter	Miserables.txt 1
intercept	Miserables.txt 2
intercepted	Miserables.txt 2
intercepting	Miserables.txt 1
interchange	Miserables.txt 2
intercourse	Miserables.txt 1
interdicted	Miserables.txt 3
interdicts	Miserables.txt 1
interest	Miserables.txt 32
interested	Miserables.txt 7
interesting	Miserables.txt 5
interests	Miserables.txt 18
interfere	Miserables.txt 4
interfered	Miserables.txt 5
interference	Miserables.txt 3
interfering	Miserables.txt 2
interim	Miserables.txt 2
interior	Miserables.txt 55
interlace	Miserables.txt 1
interlaced	Miserables.txt 3
interlacement	Miserables.txt 1
interlaces	Miserables.txt 1
interlacing	Miserables.txt 2
interlocutor	Miserables.txt 2
interlocutors	Miserables.txt 2
interloping	Miserables.txt 1
interlude	Miserables.txt 1
intermeddling	Miserables.txt 1
intermediary	Miserables.txt 3
intermediate	Miserables.txt 2
interment	Miserables.txt 7
interminable	Miserables.txt 2
intermingled	Miserables.txt 10
intermingling	Miserables.txt 1
intermission	Miserables.txt 1
intermissions	Miserables.txt 1
intermittences	Miserables.txt 3
intermittent	Miserables.txt 6
intermixture	Miserables.txt 1
intermixtures	Miserables.txt 1
internal	Miserables.txt 11
internally	Miserables.txt 2
international	Miserables.txt 1
interpellation	Miserables.txt 1
interpolated	Miserables.txt 2
interpolating	Miserables.txt 1
interposed	Miserables.txt 5
interpret	Miserables.txt 1
interpreted	Miserables.txt 3
interpreter	Miserables.txt 1
interred	Miserables.txt 3
interrogate	Miserables.txt 4
interrogated	Miserables.txt 10
interrogates	Miserables.txt 2
interrogating	Miserables.txt 3
interrogation	Miserables.txt 13
interrogations	Miserables.txt 1
interrogatory	Miserables.txt 4
interrupt	Miserables.txt 7
interrupted	Miserables.txt 33
interrupting	Miserables.txt 1
interruption	Miserables.txt 3
interrupts	Miserables.txt 1
intersect	Miserables.txt 1
intersected	Miserables.txt 9
intersecting	Miserables.txt 1
intersection	Miserables.txt 12
interspersing	Miserables.txt 1
interstice	Miserables.txt 1
intertwined	Miserables.txt 1
interval	Miserables.txt 6
intervals	Miserables.txt 31
intervene	Miserables.txt 1
intervened	Miserables.txt 7
intervenes	Miserables.txt 2
intervening	Miserables.txt 4
intervention	Miserables.txt 3
interview	Miserables.txt 2
interviews	Miserables.txt 1
intestinal	Miserables.txt 2
intestine	Miserables.txt 4
intestines	Miserables.txt 1
inthralment	Miserables.txt 1
intimacy	Miserables.txt 2
intimate	Miserables.txt 6
intimated	Miserables.txt 1
intimately	Miserables.txt 1
intimidate	Miserables.txt 1
intimidated	Miserables.txt 2
intimidates	Miserables.txt 1
into	Miserables.txt 993
intolerable	Miserables.txt 6
intolerant	Miserables.txt 1
intonation	Miserables.txt 7
intone	Miserables.txt 1
intoned	Miserables.txt 1
intoxicate	Miserables.txt 3
intoxicated	Miserables.txt 26
intoxicates	Miserables.txt 1
intoxicating	Miserables.txt 1
intoxication	Miserables.txt 17
intoxications	Miserables.txt 1
intractable	Miserables.txt 2
intrenchment	Miserables.txt 3
intrenchments	Miserables.txt 1
intrepid	Miserables.txt 19
intrepide	Miserables.txt 1
intrepidity	Miserables.txt 4
intrepidly	Miserables.txt 1
intricate	Miserables.txt 3
intrigue	Miserables.txt 1
intrigues	Miserables.txt 4
intrinsic	Miserables.txt 4
introduce	Miserables.txt 3
introduced	Miserables.txt 17
introduces	Miserables.txt 1
introducing	Miserables.txt 1
introduction	Miserables.txt 2
intruder	Miserables.txt 2
intrusive	Miserables.txt 1
intrusted	Miserables.txt 6
intuition	Miserables.txt 6
intuitively	Miserables.txt 1
inundate	Miserables.txt 2
inundated	Miserables.txt 14
inundates	Miserables.txt 1
inundating	Miserables.txt 1
inundation	Miserables.txt 2
inundations	Miserables.txt 2
inured	Miserables.txt 3
invade	Miserables.txt 1
invaded	Miserables.txt 6
invades	Miserables.txt 1
invading	Miserables.txt 1
invalid	Miserables.txt 9
invalidate	Miserables.txt 1
invalidating	Miserables.txt 2
invalides	Miserables.txt 20
invalidity	Miserables.txt 1
invalids	Miserables.txt 2
invariable	Miserables.txt 3
invariably	Miserables.txt 7
invasion	Miserables.txt 4
invasions	Miserables.txt 1
inveigled	Miserables.txt 1
invenerunt	Miserables.txt 1
invent	Miserables.txt 5
invented	Miserables.txt 22
invention	Miserables.txt 5
inventions	Miserables.txt 1
inventive	Miserables.txt 1
inventor	Miserables.txt 4
inventors	Miserables.txt 2
invents	Miserables.txt 3
inverse	Miserables.txt 4
invested	Miserables.txt 1
investigate	Miserables.txt 1
investigated	Miserables.txt 2
investigation	Miserables.txt 5
investigations	Miserables.txt 1
investment	Miserables.txt 2
invincible	Miserables.txt 6
inviolability	Miserables.txt 1
invisibility	Miserables.txt 1
invisible	Miserables.txt 33
invitation	Miserables.txt 1
invitations	Miserables.txt 3
invite	Miserables.txt 2
invited	Miserables.txt 8
inviting	Miserables.txt 2
invoked	Miserables.txt 1
involuntarily	Miserables.txt 3
involuntary	Miserables.txt 5
involutum	Miserables.txt 1
involve	Miserables.txt 3
involved	Miserables.txt 2
invulnerability	Miserables.txt 1
invulnerable	Miserables.txt 4
inward	Miserables.txt 29
inwardly	Miserables.txt 6
inwards	Miserables.txt 2
io	Miserables.txt 1
iodine	Miserables.txt 1
ionian	Miserables.txt 2
ira	Miserables.txt 5
irascible	Miserables.txt 2
ireland	Miserables.txt 3
irma	Miserables.txt 1
iron	Miserables.txt 163
ironed	Miserables.txt 1
ironical	Miserables.txt 3
ironically	Miserables.txt 1
ironies	Miserables.txt 1
ironmonger	Miserables.txt 3
ironmongery	Miserables.txt 1
irons	Miserables.txt 8
ironwork	Miserables.txt 1
irony	Miserables.txt 13
irradiates	Miserables.txt 1
irradiations	Miserables.txt 2
irrecoverable	Miserables.txt 1
irrefragable	Miserables.txt 2
irregular	Miserables.txt 11
irregularly	Miserables.txt 2
irreligious	Miserables.txt 1
irremediable	Miserables.txt 4
irremediably	Miserables.txt 1
irreparable	Miserables.txt 2
irreproachable	Miserables.txt 8
irresistible	Miserables.txt 13
irresistibly	Miserables.txt 7
irresolute	Miserables.txt 1
irresponsibility	Miserables.txt 1
irresponsible	Miserables.txt 3
irreverence	Miserables.txt 1
irrevocable	Miserables.txt 3
irritated	Miserables.txt 23
irritates	Miserables.txt 2
irritating	Miserables.txt 4
irritation	Miserables.txt 2
irruption	Miserables.txt 5
irruptions	Miserables.txt 1
irs	Miserables.txt 1
is	Miserables.txt 6194
isaac	Miserables.txt 2
isabeau	Miserables.txt 3
isabel	Miserables.txt 2
isabella	Miserables.txt 1
isaiah	Miserables.txt 2
isere	Miserables.txt 1
isis	Miserables.txt 2
island	Miserables.txt 7
islands	Miserables.txt 1
isle	Miserables.txt 6
isles	Miserables.txt 3
isn	Miserables.txt 13
isolated	Miserables.txt 22
isolating	Miserables.txt 1
isolation	Miserables.txt 12
israel	Miserables.txt 1
issoire	Miserables.txt 1
issue	Miserables.txt 14
issued	Miserables.txt 11
issues	Miserables.txt 1
issuing	Miserables.txt 1
issy	Miserables.txt 4
ist	Miserables.txt 1
it	Miserables.txt 6661
italian	Miserables.txt 13
italians	Miserables.txt 3
italie	Miserables.txt 1
italiens	Miserables.txt 1
italy	Miserables.txt 30
itch	Miserables.txt 1
item	Miserables.txt 2
items	Miserables.txt 2
itinerant	Miserables.txt 1
itinerary	Miserables.txt 6
its	Miserables.txt 893
itself	Miserables.txt 224
iturbide	Miserables.txt 1
iv	Miserables.txt 95
ivans	Miserables.txt 1
ivory	Miserables.txt 4
ivry	Miserables.txt 3
ivy	Miserables.txt 2
ix	Miserables.txt 33
