l	NotreDame_De_Paris.txt 42
la	NotreDame_De_Paris.txt 198
laas	NotreDame_De_Paris.txt 1
labor	NotreDame_De_Paris.txt 8
laborat	NotreDame_De_Paris.txt 3
laboratories	NotreDame_De_Paris.txt 1
laboratory	NotreDame_De_Paris.txt 3
laborious	NotreDame_De_Paris.txt 2
laboriously	NotreDame_De_Paris.txt 1
labors	NotreDame_De_Paris.txt 2
labyrinth	NotreDame_De_Paris.txt 10
labyrinthine	NotreDame_De_Paris.txt 1
lacabre	NotreDame_De_Paris.txt 1
lace	NotreDame_De_Paris.txt 6
laced	NotreDame_De_Paris.txt 1
lacerated	NotreDame_De_Paris.txt 2
laces	NotreDame_De_Paris.txt 2
lacework	NotreDame_De_Paris.txt 1
lack	NotreDame_De_Paris.txt 8
lacked	NotreDame_De_Paris.txt 6
lackey	NotreDame_De_Paris.txt 3
lackeys	NotreDame_De_Paris.txt 9
lacking	NotreDame_De_Paris.txt 5
lacks	NotreDame_De_Paris.txt 5
laconic	NotreDame_De_Paris.txt 1
laconics	NotreDame_De_Paris.txt 1
lad	NotreDame_De_Paris.txt 1
ladder	NotreDame_De_Paris.txt 44
ladders	NotreDame_De_Paris.txt 4
ladehors	NotreDame_De_Paris.txt 1
ladies	NotreDame_De_Paris.txt 7
ladre	NotreDame_De_Paris.txt 1
lads	NotreDame_De_Paris.txt 2
lady	NotreDame_De_Paris.txt 23
laggards	NotreDame_De_Paris.txt 1
laid	NotreDame_De_Paris.txt 24
lain	NotreDame_De_Paris.txt 2
lair	NotreDame_De_Paris.txt 6
lake	NotreDame_De_Paris.txt 4
lamb	NotreDame_De_Paris.txt 5
lambert	NotreDame_De_Paris.txt 1
lambs	NotreDame_De_Paris.txt 1
lame	NotreDame_De_Paris.txt 14
lament	NotreDame_De_Paris.txt 1
lamentable	NotreDame_De_Paris.txt 4
lamentation	NotreDame_De_Paris.txt 1
lamenting	NotreDame_De_Paris.txt 1
laminas	NotreDame_De_Paris.txt 1
lamp	NotreDame_De_Paris.txt 21
lamplighter	NotreDame_De_Paris.txt 1
lamps	NotreDame_De_Paris.txt 5
lance	NotreDame_De_Paris.txt 3
lances	NotreDame_De_Paris.txt 5
lancet	NotreDame_De_Paris.txt 1
land	NotreDame_De_Paris.txt 6
landed	NotreDame_De_Paris.txt 3
landing	NotreDame_De_Paris.txt 3
landless	NotreDame_De_Paris.txt 1
landry	NotreDame_De_Paris.txt 2
lands	NotreDame_De_Paris.txt 1
landscape	NotreDame_De_Paris.txt 1
lane	NotreDame_De_Paris.txt 2
language	NotreDame_De_Paris.txt 17
languages	NotreDame_De_Paris.txt 1
languor	NotreDame_De_Paris.txt 1
laniare	NotreDame_De_Paris.txt 1
lantern	NotreDame_De_Paris.txt 16
lanterns	NotreDame_De_Paris.txt 2
lanturn	NotreDame_De_Paris.txt 1
lapis	NotreDame_De_Paris.txt 1
laps	NotreDame_De_Paris.txt 1
lapse	NotreDame_De_Paris.txt 2
laquasio	NotreDame_De_Paris.txt 1
larcenies	NotreDame_De_Paris.txt 1
lard	NotreDame_De_Paris.txt 1
larder	NotreDame_De_Paris.txt 1
large	NotreDame_De_Paris.txt 80
largely	NotreDame_De_Paris.txt 1
larger	NotreDame_De_Paris.txt 8
largest	NotreDame_De_Paris.txt 4
lark	NotreDame_De_Paris.txt 3
las	NotreDame_De_Paris.txt 2
lasciate	NotreDame_De_Paris.txt 2
lash	NotreDame_De_Paris.txt 2
lashes	NotreDame_De_Paris.txt 2
last	NotreDame_De_Paris.txt 126
lasted	NotreDame_De_Paris.txt 9
lastly	NotreDame_De_Paris.txt 14
lasts	NotreDame_De_Paris.txt 1
latch	NotreDame_De_Paris.txt 1
late	NotreDame_De_Paris.txt 14
lately	NotreDame_De_Paris.txt 1
latent	NotreDame_De_Paris.txt 1
later	NotreDame_De_Paris.txt 31
lateral	NotreDame_De_Paris.txt 5
laterally	NotreDame_De_Paris.txt 1
laths	NotreDame_De_Paris.txt 3
latin	NotreDame_De_Paris.txt 24
latinitas	NotreDame_De_Paris.txt 1
latter	NotreDame_De_Paris.txt 23
lattice	NotreDame_De_Paris.txt 1
latticed	NotreDame_De_Paris.txt 3
laudable	NotreDame_De_Paris.txt 1
laudamus	NotreDame_De_Paris.txt 1
lauded	NotreDame_De_Paris.txt 1
laugh	NotreDame_De_Paris.txt 48
laughed	NotreDame_De_Paris.txt 17
laughing	NotreDame_De_Paris.txt 16
laughs	NotreDame_De_Paris.txt 3
laughter	NotreDame_De_Paris.txt 40
launched	NotreDame_De_Paris.txt 6
launching	NotreDame_De_Paris.txt 1
laundress	NotreDame_De_Paris.txt 1
laundresses	NotreDame_De_Paris.txt 1
laurel	NotreDame_De_Paris.txt 1
laurent	NotreDame_De_Paris.txt 4
laurier	NotreDame_De_Paris.txt 1
lava	NotreDame_De_Paris.txt 2
lavatory	NotreDame_De_Paris.txt 1
lavished	NotreDame_De_Paris.txt 1
lavishes	NotreDame_De_Paris.txt 1
lavishing	NotreDame_De_Paris.txt 1
lavishly	NotreDame_De_Paris.txt 1
law	NotreDame_De_Paris.txt 44
lawful	NotreDame_De_Paris.txt 1
lawless	NotreDame_De_Paris.txt 1
laws	NotreDame_De_Paris.txt 10
lawyer	NotreDame_De_Paris.txt 1
lay	NotreDame_De_Paris.txt 31
laye	NotreDame_De_Paris.txt 2
layer	NotreDame_De_Paris.txt 11
layers	NotreDame_De_Paris.txt 3
laying	NotreDame_De_Paris.txt 6
layman	NotreDame_De_Paris.txt 2
lazar	NotreDame_De_Paris.txt 2
laziness	NotreDame_De_Paris.txt 2
lazuli	NotreDame_De_Paris.txt 1
lazy	NotreDame_De_Paris.txt 5
le	NotreDame_De_Paris.txt 58
lead	NotreDame_De_Paris.txt 24
leaden	NotreDame_De_Paris.txt 8
leader	NotreDame_De_Paris.txt 1
leading	NotreDame_De_Paris.txt 7
leads	NotreDame_De_Paris.txt 9
leaf	NotreDame_De_Paris.txt 12
leafy	NotreDame_De_Paris.txt 1
league	NotreDame_De_Paris.txt 3
leagues	NotreDame_De_Paris.txt 11
lean	NotreDame_De_Paris.txt 2
leaned	NotreDame_De_Paris.txt 7
leaning	NotreDame_De_Paris.txt 16
leanness	NotreDame_De_Paris.txt 2
leap	NotreDame_De_Paris.txt 5
leaped	NotreDame_De_Paris.txt 7
leaping	NotreDame_De_Paris.txt 7
learn	NotreDame_De_Paris.txt 4
learned	NotreDame_De_Paris.txt 29
learning	NotreDame_De_Paris.txt 11
learns	NotreDame_De_Paris.txt 1
least	NotreDame_De_Paris.txt 53
leather	NotreDame_De_Paris.txt 20
leave	NotreDame_De_Paris.txt 30
leavened	NotreDame_De_Paris.txt 3
leaves	NotreDame_De_Paris.txt 14
leaveth	NotreDame_De_Paris.txt 1
leaving	NotreDame_De_Paris.txt 12
leclerc	NotreDame_De_Paris.txt 1
lecornu	NotreDame_De_Paris.txt 8
lectern	NotreDame_De_Paris.txt 1
lectoure	NotreDame_De_Paris.txt 1
lecture	NotreDame_De_Paris.txt 1
led	NotreDame_De_Paris.txt 19
ledge	NotreDame_De_Paris.txt 2
leech	NotreDame_De_Paris.txt 6
left	NotreDame_De_Paris.txt 103
leg	NotreDame_De_Paris.txt 15
legal	NotreDame_De_Paris.txt 2
legally	NotreDame_De_Paris.txt 1
leganez	NotreDame_De_Paris.txt 1
legate	NotreDame_De_Paris.txt 8
legends	NotreDame_De_Paris.txt 1
legged	NotreDame_De_Paris.txt 3
legion	NotreDame_De_Paris.txt 3
legions	NotreDame_De_Paris.txt 1
legislation	NotreDame_De_Paris.txt 2
legitur	NotreDame_De_Paris.txt 1
legless	NotreDame_De_Paris.txt 3
legris	NotreDame_De_Paris.txt 2
legs	NotreDame_De_Paris.txt 31
leisure	NotreDame_De_Paris.txt 3
lemy	NotreDame_De_Paris.txt 1
lend	NotreDame_De_Paris.txt 6
length	NotreDame_De_Paris.txt 43
lengthened	NotreDame_De_Paris.txt 1
lengths	NotreDame_De_Paris.txt 1
lengthwise	NotreDame_De_Paris.txt 1
lent	NotreDame_De_Paris.txt 3
leo	NotreDame_De_Paris.txt 1
leopards	NotreDame_De_Paris.txt 1
lepers	NotreDame_De_Paris.txt 1
leprosy	NotreDame_De_Paris.txt 1
leprous	NotreDame_De_Paris.txt 2
les	NotreDame_De_Paris.txt 10
lescrivain	NotreDame_De_Paris.txt 1
lesions	NotreDame_De_Paris.txt 1
lespinasse	NotreDame_De_Paris.txt 1
less	NotreDame_De_Paris.txt 84
lesser	NotreDame_De_Paris.txt 2
lesson	NotreDame_De_Paris.txt 2
lest	NotreDame_De_Paris.txt 6
lestins	NotreDame_De_Paris.txt 1
let	NotreDame_De_Paris.txt 123
lethargic	NotreDame_De_Paris.txt 1
lets	NotreDame_De_Paris.txt 2
letter	NotreDame_De_Paris.txt 6
lettered	NotreDame_De_Paris.txt 3
letters	NotreDame_De_Paris.txt 34
letting	NotreDame_De_Paris.txt 2
lettuce	NotreDame_De_Paris.txt 2
leur	NotreDame_De_Paris.txt 1
level	NotreDame_De_Paris.txt 7
levels	NotreDame_De_Paris.txt 1
levers	NotreDame_De_Paris.txt 2
lewd	NotreDame_De_Paris.txt 3
lewdness	NotreDame_De_Paris.txt 1
lex	NotreDame_De_Paris.txt 1
lexicon	NotreDame_De_Paris.txt 1
lez	NotreDame_De_Paris.txt 1
lheulier	NotreDame_De_Paris.txt 5
li	NotreDame_De_Paris.txt 18
liability	NotreDame_De_Paris.txt 4
liable	NotreDame_De_Paris.txt 1
liard	NotreDame_De_Paris.txt 1
liards	NotreDame_De_Paris.txt 5
liberal	NotreDame_De_Paris.txt 3
libero	NotreDame_De_Paris.txt 1
liberties	NotreDame_De_Paris.txt 2
libertine	NotreDame_De_Paris.txt 6
liberty	NotreDame_De_Paris.txt 15
libraries	NotreDame_De_Paris.txt 1
library	NotreDame_De_Paris.txt 2
lic	NotreDame_De_Paris.txt 1
license	NotreDame_De_Paris.txt 17
licensed	NotreDame_De_Paris.txt 2
licentiate	NotreDame_De_Paris.txt 2
lick	NotreDame_De_Paris.txt 1
licking	NotreDame_De_Paris.txt 2
lids	NotreDame_De_Paris.txt 1
lie	NotreDame_De_Paris.txt 7
lied	NotreDame_De_Paris.txt 2
lieds	NotreDame_De_Paris.txt 1
lief	NotreDame_De_Paris.txt 1
lies	NotreDame_De_Paris.txt 6
liest	NotreDame_De_Paris.txt 2
lieu	NotreDame_De_Paris.txt 3
lieutenant	NotreDame_De_Paris.txt 5
lieutenants	NotreDame_De_Paris.txt 2
life	NotreDame_De_Paris.txt 93
lifeless	NotreDame_De_Paris.txt 3
lift	NotreDame_De_Paris.txt 1
lifted	NotreDame_De_Paris.txt 7
lifting	NotreDame_De_Paris.txt 1
ligatures	NotreDame_De_Paris.txt 1
light	NotreDame_De_Paris.txt 122
lighted	NotreDame_De_Paris.txt 28
lighting	NotreDame_De_Paris.txt 2
lightly	NotreDame_De_Paris.txt 1
lightness	NotreDame_De_Paris.txt 2
lightning	NotreDame_De_Paris.txt 18
lightnings	NotreDame_De_Paris.txt 4
lights	NotreDame_De_Paris.txt 5
like	NotreDame_De_Paris.txt 404
liked	NotreDame_De_Paris.txt 5
likely	NotreDame_De_Paris.txt 1
likes	NotreDame_De_Paris.txt 2
likewise	NotreDame_De_Paris.txt 4
lily	NotreDame_De_Paris.txt 1
limb	NotreDame_De_Paris.txt 6
limbs	NotreDame_De_Paris.txt 10
limestone	NotreDame_De_Paris.txt 1
limit	NotreDame_De_Paris.txt 2
limitation	NotreDame_De_Paris.txt 3
limited	NotreDame_De_Paris.txt 6
limits	NotreDame_De_Paris.txt 2
limo	NotreDame_De_Paris.txt 1
limp	NotreDame_De_Paris.txt 1
limpid	NotreDame_De_Paris.txt 1
limping	NotreDame_De_Paris.txt 5
limps	NotreDame_De_Paris.txt 1
line	NotreDame_De_Paris.txt 23
lineage	NotreDame_De_Paris.txt 1
lined	NotreDame_De_Paris.txt 2
linen	NotreDame_De_Paris.txt 6
lines	NotreDame_De_Paris.txt 14
ling	NotreDame_De_Paris.txt 1
lingered	NotreDame_De_Paris.txt 4
link	NotreDame_De_Paris.txt 1
linked	NotreDame_De_Paris.txt 2
links	NotreDame_De_Paris.txt 3
linsey	NotreDame_De_Paris.txt 2
lion	NotreDame_De_Paris.txt 11
lioness	NotreDame_De_Paris.txt 2
lions	NotreDame_De_Paris.txt 10
lip	NotreDame_De_Paris.txt 4
lips	NotreDame_De_Paris.txt 45
liquid	NotreDame_De_Paris.txt 1
lis	NotreDame_De_Paris.txt 6
lisped	NotreDame_De_Paris.txt 2
list	NotreDame_De_Paris.txt 2
listen	NotreDame_De_Paris.txt 45
listened	NotreDame_De_Paris.txt 19
listener	NotreDame_De_Paris.txt 1
listeners	NotreDame_De_Paris.txt 1
listening	NotreDame_De_Paris.txt 21
litany	NotreDame_De_Paris.txt 1
literally	NotreDame_De_Paris.txt 1
literary	NotreDame_De_Paris.txt 16
literature	NotreDame_De_Paris.txt 3
litigants	NotreDame_De_Paris.txt 1
litter	NotreDame_De_Paris.txt 4
little	NotreDame_De_Paris.txt 369
liv	NotreDame_De_Paris.txt 1
live	NotreDame_De_Paris.txt 13
lived	NotreDame_De_Paris.txt 6
lively	NotreDame_De_Paris.txt 10
livery	NotreDame_De_Paris.txt 3
lives	NotreDame_De_Paris.txt 2
livid	NotreDame_De_Paris.txt 3
living	NotreDame_De_Paris.txt 31
livres	NotreDame_De_Paris.txt 42
lizard	NotreDame_De_Paris.txt 1
ll	NotreDame_De_Paris.txt 17
load	NotreDame_De_Paris.txt 2
loaded	NotreDame_De_Paris.txt 20
loads	NotreDame_De_Paris.txt 1
loadstones	NotreDame_De_Paris.txt 1
loaf	NotreDame_De_Paris.txt 2
loans	NotreDame_De_Paris.txt 1
loath	NotreDame_De_Paris.txt 1
lobe	NotreDame_De_Paris.txt 1
localities	NotreDame_De_Paris.txt 1
locality	NotreDame_De_Paris.txt 1
located	NotreDame_De_Paris.txt 4
locations	NotreDame_De_Paris.txt 2
loches	NotreDame_De_Paris.txt 1
lock	NotreDame_De_Paris.txt 7
locked	NotreDame_De_Paris.txt 1
locks	NotreDame_De_Paris.txt 3
locksmith	NotreDame_De_Paris.txt 1
locksmiths	NotreDame_De_Paris.txt 4
locus	NotreDame_De_Paris.txt 1
lodge	NotreDame_De_Paris.txt 3
lodged	NotreDame_De_Paris.txt 1
lodging	NotreDame_De_Paris.txt 7
loemnoeus	NotreDame_De_Paris.txt 1
loetare	NotreDame_De_Paris.txt 1
lofty	NotreDame_De_Paris.txt 34
log	NotreDame_De_Paris.txt 1
logic	NotreDame_De_Paris.txt 2
logical	NotreDame_De_Paris.txt 2
loi	NotreDame_De_Paris.txt 1
loins	NotreDame_De_Paris.txt 3
lolling	NotreDame_De_Paris.txt 2
lombard	NotreDame_De_Paris.txt 2
lombards	NotreDame_De_Paris.txt 1
london	NotreDame_De_Paris.txt 3
loneliness	NotreDame_De_Paris.txt 1
lonely	NotreDame_De_Paris.txt 1
long	NotreDame_De_Paris.txt 151
longer	NotreDame_De_Paris.txt 135
longest	NotreDame_De_Paris.txt 2
longshoremen	NotreDame_De_Paris.txt 1
longue	NotreDame_De_Paris.txt 1
longuejoue	NotreDame_De_Paris.txt 1
lons	NotreDame_De_Paris.txt 1
look	NotreDame_De_Paris.txt 81
looked	NotreDame_De_Paris.txt 66
looking	NotreDame_De_Paris.txt 19
lookout	NotreDame_De_Paris.txt 1
looks	NotreDame_De_Paris.txt 13
loophole	NotreDame_De_Paris.txt 4
loopholes	NotreDame_De_Paris.txt 2
loose	NotreDame_De_Paris.txt 6
loosed	NotreDame_De_Paris.txt 1
loosened	NotreDame_De_Paris.txt 2
loosing	NotreDame_De_Paris.txt 1
lord	NotreDame_De_Paris.txt 33
lords	NotreDame_De_Paris.txt 11
lordship	NotreDame_De_Paris.txt 1
lordships	NotreDame_De_Paris.txt 1
lore	NotreDame_De_Paris.txt 1
lorraine	NotreDame_De_Paris.txt 1
los	NotreDame_De_Paris.txt 1
lose	NotreDame_De_Paris.txt 11
loses	NotreDame_De_Paris.txt 2
losing	NotreDame_De_Paris.txt 1
loss	NotreDame_De_Paris.txt 2
lost	NotreDame_De_Paris.txt 56
lot	NotreDame_De_Paris.txt 1
loud	NotreDame_De_Paris.txt 12
louder	NotreDame_De_Paris.txt 3
loudest	NotreDame_De_Paris.txt 1
loudly	NotreDame_De_Paris.txt 4
louis	NotreDame_De_Paris.txt 99
loungers	NotreDame_De_Paris.txt 1
lout	NotreDame_De_Paris.txt 3
loutish	NotreDame_De_Paris.txt 1
louts	NotreDame_De_Paris.txt 10
louvain	NotreDame_De_Paris.txt 1
louviers	NotreDame_De_Paris.txt 1
louvre	NotreDame_De_Paris.txt 19
love	NotreDame_De_Paris.txt 133
loved	NotreDame_De_Paris.txt 22
lovely	NotreDame_De_Paris.txt 5
lover	NotreDame_De_Paris.txt 6
lovers	NotreDame_De_Paris.txt 7
loves	NotreDame_De_Paris.txt 10
loveth	NotreDame_De_Paris.txt 1
loving	NotreDame_De_Paris.txt 2
lovingly	NotreDame_De_Paris.txt 2
low	NotreDame_De_Paris.txt 94
lower	NotreDame_De_Paris.txt 25
lowered	NotreDame_De_Paris.txt 14
lowest	NotreDame_De_Paris.txt 1
lowly	NotreDame_De_Paris.txt 1
loyal	NotreDame_De_Paris.txt 1
loyally	NotreDame_De_Paris.txt 1
loyalty	NotreDame_De_Paris.txt 1
loys	NotreDame_De_Paris.txt 1
lozenges	NotreDame_De_Paris.txt 1
luck	NotreDame_De_Paris.txt 2
luckily	NotreDame_De_Paris.txt 2
lucky	NotreDame_De_Paris.txt 1
lucques	NotreDame_De_Paris.txt 1
ludovici	NotreDame_De_Paris.txt 1
ludovico	NotreDame_De_Paris.txt 1
lugubrious	NotreDame_De_Paris.txt 7
lukewarmness	NotreDame_De_Paris.txt 1
lull	NotreDame_De_Paris.txt 1
lulle	NotreDame_De_Paris.txt 1
lulled	NotreDame_De_Paris.txt 3
luminary	NotreDame_De_Paris.txt 1
luminous	NotreDame_De_Paris.txt 9
lump	NotreDame_De_Paris.txt 1
lungs	NotreDame_De_Paris.txt 4
lurking	NotreDame_De_Paris.txt 1
lust	NotreDame_De_Paris.txt 1
luther	NotreDame_De_Paris.txt 5
luxembourg	NotreDame_De_Paris.txt 3
luxuriant	NotreDame_De_Paris.txt 4
luxuriantly	NotreDame_De_Paris.txt 1
luxuriosa	NotreDame_De_Paris.txt 1
luxury	NotreDame_De_Paris.txt 2
lying	NotreDame_De_Paris.txt 16
lynx	NotreDame_De_Paris.txt 1
lyon	NotreDame_De_Paris.txt 1
lyons	NotreDame_De_Paris.txt 1
lyre	NotreDame_De_Paris.txt 1
lyric	NotreDame_De_Paris.txt 1
lys	NotreDame_De_Paris.txt 62
