wafted	NotreDame_De_Paris.txt 1
wager	NotreDame_De_Paris.txt 3
wages	NotreDame_De_Paris.txt 5
wagged	NotreDame_De_Paris.txt 1
wagon	NotreDame_De_Paris.txt 1
wagtail	NotreDame_De_Paris.txt 1
wagtails	NotreDame_De_Paris.txt 1
wailed	NotreDame_De_Paris.txt 1
wailing	NotreDame_De_Paris.txt 1
wainscoated	NotreDame_De_Paris.txt 1
wainscoating	NotreDame_De_Paris.txt 1
waist	NotreDame_De_Paris.txt 11
waistcoat	NotreDame_De_Paris.txt 1
wait	NotreDame_De_Paris.txt 18
waited	NotreDame_De_Paris.txt 10
waiters	NotreDame_De_Paris.txt 1
waiting	NotreDame_De_Paris.txt 24
waitress	NotreDame_De_Paris.txt 1
wake	NotreDame_De_Paris.txt 1
waked	NotreDame_De_Paris.txt 3
wakening	NotreDame_De_Paris.txt 1
waking	NotreDame_De_Paris.txt 3
walk	NotreDame_De_Paris.txt 12
walked	NotreDame_De_Paris.txt 22
walking	NotreDame_De_Paris.txt 17
walks	NotreDame_De_Paris.txt 6
wall	NotreDame_De_Paris.txt 95
walled	NotreDame_De_Paris.txt 4
wallet	NotreDame_De_Paris.txt 1
wallflowers	NotreDame_De_Paris.txt 1
walling	NotreDame_De_Paris.txt 1
walls	NotreDame_De_Paris.txt 44
wan	NotreDame_De_Paris.txt 4
wand	NotreDame_De_Paris.txt 3
wandering	NotreDame_De_Paris.txt 3
wands	NotreDame_De_Paris.txt 1
want	NotreDame_De_Paris.txt 29
wanted	NotreDame_De_Paris.txt 10
wanton	NotreDame_De_Paris.txt 3
wants	NotreDame_De_Paris.txt 6
war	NotreDame_De_Paris.txt 8
warbler	NotreDame_De_Paris.txt 2
warblers	NotreDame_De_Paris.txt 2
ward	NotreDame_De_Paris.txt 1
warden	NotreDame_De_Paris.txt 2
wardens	NotreDame_De_Paris.txt 1
warder	NotreDame_De_Paris.txt 1
warehouse	NotreDame_De_Paris.txt 1
warlike	NotreDame_De_Paris.txt 1
warm	NotreDame_De_Paris.txt 13
warmed	NotreDame_De_Paris.txt 1
warmer	NotreDame_De_Paris.txt 3
warming	NotreDame_De_Paris.txt 2
warmly	NotreDame_De_Paris.txt 2
warms	NotreDame_De_Paris.txt 2
warmth	NotreDame_De_Paris.txt 2
warn	NotreDame_De_Paris.txt 3
warned	NotreDame_De_Paris.txt 5
warning	NotreDame_De_Paris.txt 3
warp	NotreDame_De_Paris.txt 1
warrant	NotreDame_De_Paris.txt 1
warranties	NotreDame_De_Paris.txt 3
warranty	NotreDame_De_Paris.txt 2
wart	NotreDame_De_Paris.txt 5
warts	NotreDame_De_Paris.txt 4
was	NotreDame_De_Paris.txt 2245
wash	NotreDame_De_Paris.txt 2
washed	NotreDame_De_Paris.txt 1
washing	NotreDame_De_Paris.txt 1
wasn	NotreDame_De_Paris.txt 1
wasp	NotreDame_De_Paris.txt 4
wasted	NotreDame_De_Paris.txt 2
wastes	NotreDame_De_Paris.txt 1
wasting	NotreDame_De_Paris.txt 1
watch	NotreDame_De_Paris.txt 41
watched	NotreDame_De_Paris.txt 15
watches	NotreDame_De_Paris.txt 3
watching	NotreDame_De_Paris.txt 9
water	NotreDame_De_Paris.txt 72
watering	NotreDame_De_Paris.txt 1
waters	NotreDame_De_Paris.txt 4
waterspouts	NotreDame_De_Paris.txt 1
wave	NotreDame_De_Paris.txt 2
wavered	NotreDame_De_Paris.txt 7
wavering	NotreDame_De_Paris.txt 2
wavers	NotreDame_De_Paris.txt 1
waves	NotreDame_De_Paris.txt 11
waving	NotreDame_De_Paris.txt 4
wax	NotreDame_De_Paris.txt 13
way	NotreDame_De_Paris.txt 116
ways	NotreDame_De_Paris.txt 9
we	NotreDame_De_Paris.txt 339
weak	NotreDame_De_Paris.txt 7
weaken	NotreDame_De_Paris.txt 1
weaker	NotreDame_De_Paris.txt 2
weakly	NotreDame_De_Paris.txt 1
weakness	NotreDame_De_Paris.txt 2
wealth	NotreDame_De_Paris.txt 2
wealthy	NotreDame_De_Paris.txt 2
weapon	NotreDame_De_Paris.txt 4
weapons	NotreDame_De_Paris.txt 4
wear	NotreDame_De_Paris.txt 7
wearest	NotreDame_De_Paris.txt 1
wearies	NotreDame_De_Paris.txt 2
weariness	NotreDame_De_Paris.txt 4
wearing	NotreDame_De_Paris.txt 1
wearisome	NotreDame_De_Paris.txt 1
wears	NotreDame_De_Paris.txt 5
weary	NotreDame_De_Paris.txt 7
weasel	NotreDame_De_Paris.txt 1
weather	NotreDame_De_Paris.txt 3
weathercocks	NotreDame_De_Paris.txt 1
weaving	NotreDame_De_Paris.txt 1
weazand	NotreDame_De_Paris.txt 3
web	NotreDame_De_Paris.txt 14
webs	NotreDame_De_Paris.txt 3
wed	NotreDame_De_Paris.txt 3
wedded	NotreDame_De_Paris.txt 1
wedding	NotreDame_De_Paris.txt 3
wedge	NotreDame_De_Paris.txt 2
week	NotreDame_De_Paris.txt 8
weeks	NotreDame_De_Paris.txt 3
weep	NotreDame_De_Paris.txt 9
weeping	NotreDame_De_Paris.txt 6
weighed	NotreDame_De_Paris.txt 2
weighing	NotreDame_De_Paris.txt 4
weight	NotreDame_De_Paris.txt 11
welcome	NotreDame_De_Paris.txt 5
well	NotreDame_De_Paris.txt 159
welled	NotreDame_De_Paris.txt 2
wells	NotreDame_De_Paris.txt 3
wench	NotreDame_De_Paris.txt 22
wenches	NotreDame_De_Paris.txt 7
went	NotreDame_De_Paris.txt 66
wept	NotreDame_De_Paris.txt 13
were	NotreDame_De_Paris.txt 520
wert	NotreDame_De_Paris.txt 1
west	NotreDame_De_Paris.txt 11
western	NotreDame_De_Paris.txt 6
wet	NotreDame_De_Paris.txt 3
whale	NotreDame_De_Paris.txt 1
wharf	NotreDame_De_Paris.txt 1
what	NotreDame_De_Paris.txt 505
whatever	NotreDame_De_Paris.txt 10
whatsoever	NotreDame_De_Paris.txt 2
wheat	NotreDame_De_Paris.txt 12
wheel	NotreDame_De_Paris.txt 17
wheeled	NotreDame_De_Paris.txt 3
wheels	NotreDame_De_Paris.txt 10
whelp	NotreDame_De_Paris.txt 1
when	NotreDame_De_Paris.txt 441
whence	NotreDame_De_Paris.txt 20
whenever	NotreDame_De_Paris.txt 1
where	NotreDame_De_Paris.txt 164
whereat	NotreDame_De_Paris.txt 1
wherein	NotreDame_De_Paris.txt 5
whereon	NotreDame_De_Paris.txt 1
whereupon	NotreDame_De_Paris.txt 1
wherewith	NotreDame_De_Paris.txt 3
wherewithal	NotreDame_De_Paris.txt 4
whether	NotreDame_De_Paris.txt 37
whew	NotreDame_De_Paris.txt 1
which	NotreDame_De_Paris.txt 1759
while	NotreDame_De_Paris.txt 105
whilst	NotreDame_De_Paris.txt 1
whimsical	NotreDame_De_Paris.txt 4
whine	NotreDame_De_Paris.txt 1
whip	NotreDame_De_Paris.txt 2
whipping	NotreDame_De_Paris.txt 1
whips	NotreDame_De_Paris.txt 2
whirled	NotreDame_De_Paris.txt 6
whirling	NotreDame_De_Paris.txt 1
whirlpools	NotreDame_De_Paris.txt 1
whirls	NotreDame_De_Paris.txt 1
whirlwind	NotreDame_De_Paris.txt 5
whirlwinds	NotreDame_De_Paris.txt 1
whiskered	NotreDame_De_Paris.txt 1
whiskers	NotreDame_De_Paris.txt 1
whisper	NotreDame_De_Paris.txt 3
whispered	NotreDame_De_Paris.txt 4
whispering	NotreDame_De_Paris.txt 3
whispers	NotreDame_De_Paris.txt 1
whistle	NotreDame_De_Paris.txt 7
whistled	NotreDame_De_Paris.txt 2
whistling	NotreDame_De_Paris.txt 8
white	NotreDame_De_Paris.txt 86
whiteness	NotreDame_De_Paris.txt 4
whitening	NotreDame_De_Paris.txt 1
whitest	NotreDame_De_Paris.txt 1
whitewashed	NotreDame_De_Paris.txt 1
whitewashes	NotreDame_De_Paris.txt 1
whither	NotreDame_De_Paris.txt 17
whitish	NotreDame_De_Paris.txt 2
whizzed	NotreDame_De_Paris.txt 1
who	NotreDame_De_Paris.txt 701
whoever	NotreDame_De_Paris.txt 2
whole	NotreDame_De_Paris.txt 106
wholly	NotreDame_De_Paris.txt 17
whom	NotreDame_De_Paris.txt 126
whorls	NotreDame_De_Paris.txt 1
whose	NotreDame_De_Paris.txt 147
why	NotreDame_De_Paris.txt 60
wick	NotreDame_De_Paris.txt 3
wicked	NotreDame_De_Paris.txt 4
wicket	NotreDame_De_Paris.txt 6
wickets	NotreDame_De_Paris.txt 1
wide	NotreDame_De_Paris.txt 21
widely	NotreDame_De_Paris.txt 1
wider	NotreDame_De_Paris.txt 2
widest	NotreDame_De_Paris.txt 2
widow	NotreDame_De_Paris.txt 5
widows	NotreDame_De_Paris.txt 4
width	NotreDame_De_Paris.txt 1
wield	NotreDame_De_Paris.txt 1
wife	NotreDame_De_Paris.txt 27
wild	NotreDame_De_Paris.txt 33
wildest	NotreDame_De_Paris.txt 1
wildly	NotreDame_De_Paris.txt 3
will	NotreDame_De_Paris.txt 413
willed	NotreDame_De_Paris.txt 3
william	NotreDame_De_Paris.txt 1
willing	NotreDame_De_Paris.txt 9
willingly	NotreDame_De_Paris.txt 2
wills	NotreDame_De_Paris.txt 3
wilt	NotreDame_De_Paris.txt 4
win	NotreDame_De_Paris.txt 2
wince	NotreDame_De_Paris.txt 1
winchestre	NotreDame_De_Paris.txt 1
wincing	NotreDame_De_Paris.txt 2
wind	NotreDame_De_Paris.txt 19
winding	NotreDame_De_Paris.txt 3
windings	NotreDame_De_Paris.txt 2
windmill	NotreDame_De_Paris.txt 1
windmills	NotreDame_De_Paris.txt 2
window	NotreDame_De_Paris.txt 116
windows	NotreDame_De_Paris.txt 62
winds	NotreDame_De_Paris.txt 2
wine	NotreDame_De_Paris.txt 29
wing	NotreDame_De_Paris.txt 1
winged	NotreDame_De_Paris.txt 5
wings	NotreDame_De_Paris.txt 20
winking	NotreDame_De_Paris.txt 2
winter	NotreDame_De_Paris.txt 20
wipe	NotreDame_De_Paris.txt 2
wiped	NotreDame_De_Paris.txt 2
wiping	NotreDame_De_Paris.txt 2
wire	NotreDame_De_Paris.txt 1
wisdom	NotreDame_De_Paris.txt 3
wise	NotreDame_De_Paris.txt 14
wisely	NotreDame_De_Paris.txt 1
wish	NotreDame_De_Paris.txt 36
wished	NotreDame_De_Paris.txt 19
wishes	NotreDame_De_Paris.txt 5
wishing	NotreDame_De_Paris.txt 1
wit	NotreDame_De_Paris.txt 2
witch	NotreDame_De_Paris.txt 17
witchcraft	NotreDame_De_Paris.txt 6
witchcrafts	NotreDame_De_Paris.txt 1
witches	NotreDame_De_Paris.txt 19
with	NotreDame_De_Paris.txt 1861
withdraw	NotreDame_De_Paris.txt 3
withdrawing	NotreDame_De_Paris.txt 1
withdrawn	NotreDame_De_Paris.txt 3
withdrew	NotreDame_De_Paris.txt 11
wither	NotreDame_De_Paris.txt 1
withered	NotreDame_De_Paris.txt 4
withering	NotreDame_De_Paris.txt 1
withers	NotreDame_De_Paris.txt 1
withheld	NotreDame_De_Paris.txt 1
within	NotreDame_De_Paris.txt 37
without	NotreDame_De_Paris.txt 220
witness	NotreDame_De_Paris.txt 7
witnessed	NotreDame_De_Paris.txt 2
witnesses	NotreDame_De_Paris.txt 1
wits	NotreDame_De_Paris.txt 2
witted	NotreDame_De_Paris.txt 1
wives	NotreDame_De_Paris.txt 3
woe	NotreDame_De_Paris.txt 2
woke	NotreDame_De_Paris.txt 3
wolf	NotreDame_De_Paris.txt 6
wolves	NotreDame_De_Paris.txt 2
woman	NotreDame_De_Paris.txt 112
women	NotreDame_De_Paris.txt 80
won	NotreDame_De_Paris.txt 3
wonderful	NotreDame_De_Paris.txt 3
wonderment	NotreDame_De_Paris.txt 1
wonders	NotreDame_De_Paris.txt 1
wondrous	NotreDame_De_Paris.txt 1
wont	NotreDame_De_Paris.txt 4
wood	NotreDame_De_Paris.txt 28
woodcutter	NotreDame_De_Paris.txt 1
woodcutters	NotreDame_De_Paris.txt 1
wooden	NotreDame_De_Paris.txt 18
woodland	NotreDame_De_Paris.txt 1
woods	NotreDame_De_Paris.txt 4
woodwork	NotreDame_De_Paris.txt 8
wool	NotreDame_De_Paris.txt 2
woolen	NotreDame_De_Paris.txt 2
woolsey	NotreDame_De_Paris.txt 2
word	NotreDame_De_Paris.txt 105
words	NotreDame_De_Paris.txt 75
wore	NotreDame_De_Paris.txt 28
work	NotreDame_De_Paris.txt 114
worked	NotreDame_De_Paris.txt 2
worker	NotreDame_De_Paris.txt 1
workers	NotreDame_De_Paris.txt 1
working	NotreDame_De_Paris.txt 4
workman	NotreDame_De_Paris.txt 1
workmen	NotreDame_De_Paris.txt 4
works	NotreDame_De_Paris.txt 42
workshop	NotreDame_De_Paris.txt 1
world	NotreDame_De_Paris.txt 67
worlds	NotreDame_De_Paris.txt 1
worm	NotreDame_De_Paris.txt 2
wormeaten	NotreDame_De_Paris.txt 6
worms	NotreDame_De_Paris.txt 1
worn	NotreDame_De_Paris.txt 11
worry	NotreDame_De_Paris.txt 1
worse	NotreDame_De_Paris.txt 8
worship	NotreDame_De_Paris.txt 1
worst	NotreDame_De_Paris.txt 2
worsted	NotreDame_De_Paris.txt 1
worth	NotreDame_De_Paris.txt 17
worthy	NotreDame_De_Paris.txt 23
would	NotreDame_De_Paris.txt 320
wouldst	NotreDame_De_Paris.txt 1
wound	NotreDame_De_Paris.txt 14
wounded	NotreDame_De_Paris.txt 7
wounds	NotreDame_De_Paris.txt 5
woven	NotreDame_De_Paris.txt 1
wrath	NotreDame_De_Paris.txt 22
wrathful	NotreDame_De_Paris.txt 2
wreak	NotreDame_De_Paris.txt 1
wrenched	NotreDame_De_Paris.txt 3
wrenching	NotreDame_De_Paris.txt 1
wrestling	NotreDame_De_Paris.txt 1
wretch	NotreDame_De_Paris.txt 24
wretched	NotreDame_De_Paris.txt 24
wretchedness	NotreDame_De_Paris.txt 1
wretches	NotreDame_De_Paris.txt 6
wringers	NotreDame_De_Paris.txt 1
wringing	NotreDame_De_Paris.txt 1
wrinkle	NotreDame_De_Paris.txt 3
wrinkled	NotreDame_De_Paris.txt 12
wrinkles	NotreDame_De_Paris.txt 4
wrists	NotreDame_De_Paris.txt 1
write	NotreDame_De_Paris.txt 11
writer	NotreDame_De_Paris.txt 1
writes	NotreDame_De_Paris.txt 3
writhe	NotreDame_De_Paris.txt 1
writhed	NotreDame_De_Paris.txt 11
writhes	NotreDame_De_Paris.txt 1
writhing	NotreDame_De_Paris.txt 3
writing	NotreDame_De_Paris.txt 8
written	NotreDame_De_Paris.txt 26
wrong	NotreDame_De_Paris.txt 8
wrote	NotreDame_De_Paris.txt 9
wrought	NotreDame_De_Paris.txt 5
wrung	NotreDame_De_Paris.txt 3
wry	NotreDame_De_Paris.txt 1
www	NotreDame_De_Paris.txt 6
