kaleidoscope	NotreDame_De_Paris.txt 1
kantersten	NotreDame_De_Paris.txt 1
karnac	NotreDame_De_Paris.txt 1
keep	NotreDame_De_Paris.txt 19
keeper	NotreDame_De_Paris.txt 4
keeping	NotreDame_De_Paris.txt 8
keeps	NotreDame_De_Paris.txt 4
kennel	NotreDame_De_Paris.txt 2
kept	NotreDame_De_Paris.txt 10
key	NotreDame_De_Paris.txt 15
keyhole	NotreDame_De_Paris.txt 1
keys	NotreDame_De_Paris.txt 2
keystone	NotreDame_De_Paris.txt 4
khan	NotreDame_De_Paris.txt 1
kick	NotreDame_De_Paris.txt 6
kicked	NotreDame_De_Paris.txt 2
kill	NotreDame_De_Paris.txt 19
killed	NotreDame_De_Paris.txt 12
kills	NotreDame_De_Paris.txt 3
kind	NotreDame_De_Paris.txt 5
kindliness	NotreDame_De_Paris.txt 1
kindly	NotreDame_De_Paris.txt 2
kindness	NotreDame_De_Paris.txt 2
king	NotreDame_De_Paris.txt 300
kingdom	NotreDame_De_Paris.txt 8
kingdoms	NotreDame_De_Paris.txt 1
kings	NotreDame_De_Paris.txt 29
kiss	NotreDame_De_Paris.txt 15
kissed	NotreDame_De_Paris.txt 7
kisses	NotreDame_De_Paris.txt 14
kissing	NotreDame_De_Paris.txt 6
kitchen	NotreDame_De_Paris.txt 1
kitchens	NotreDame_De_Paris.txt 3
kitten	NotreDame_De_Paris.txt 1
knacker	NotreDame_De_Paris.txt 2
knave	NotreDame_De_Paris.txt 25
knaves	NotreDame_De_Paris.txt 8
knawed	NotreDame_De_Paris.txt 1
knee	NotreDame_De_Paris.txt 13
kneed	NotreDame_De_Paris.txt 1
kneel	NotreDame_De_Paris.txt 2
kneeling	NotreDame_De_Paris.txt 4
knees	NotreDame_De_Paris.txt 56
knelt	NotreDame_De_Paris.txt 7
knew	NotreDame_De_Paris.txt 39
knife	NotreDame_De_Paris.txt 10
knight	NotreDame_De_Paris.txt 1
knitted	NotreDame_De_Paris.txt 2
knock	NotreDame_De_Paris.txt 6
knocked	NotreDame_De_Paris.txt 3
knocker	NotreDame_De_Paris.txt 1
knocking	NotreDame_De_Paris.txt 1
knot	NotreDame_De_Paris.txt 1
knots	NotreDame_De_Paris.txt 3
knotted	NotreDame_De_Paris.txt 10
know	NotreDame_De_Paris.txt 192
knoweth	NotreDame_De_Paris.txt 3
knowing	NotreDame_De_Paris.txt 13
knowledge	NotreDame_De_Paris.txt 3
known	NotreDame_De_Paris.txt 12
knows	NotreDame_De_Paris.txt 26
koburger	NotreDame_De_Paris.txt 1
koran	NotreDame_De_Paris.txt 1
kuere	NotreDame_De_Paris.txt 1
kyrie	NotreDame_De_Paris.txt 2
