quadrangular	NotreDame_De_Paris.txt 1
quadrilateral	NotreDame_De_Paris.txt 2
quaff	NotreDame_De_Paris.txt 2
quaint	NotreDame_De_Paris.txt 1
qualem	NotreDame_De_Paris.txt 1
qualities	NotreDame_De_Paris.txt 1
quality	NotreDame_De_Paris.txt 6
quam	NotreDame_De_Paris.txt 1
quand	NotreDame_De_Paris.txt 3
quandary	NotreDame_De_Paris.txt 1
quando	NotreDame_De_Paris.txt 2
quantity	NotreDame_De_Paris.txt 5
quarrel	NotreDame_De_Paris.txt 5
quarrels	NotreDame_De_Paris.txt 4
quarter	NotreDame_De_Paris.txt 21
quarters	NotreDame_De_Paris.txt 12
quartette	NotreDame_De_Paris.txt 1
quarts	NotreDame_De_Paris.txt 1
quasi	NotreDame_De_Paris.txt 2
quasimodo	NotreDame_De_Paris.txt 248
quatrain	NotreDame_De_Paris.txt 1
quatre	NotreDame_De_Paris.txt 3
quatrelivres	NotreDame_De_Paris.txt 2
quatuor	NotreDame_De_Paris.txt 1
quaver	NotreDame_De_Paris.txt 1
quavering	NotreDame_De_Paris.txt 1
quay	NotreDame_De_Paris.txt 19
quays	NotreDame_De_Paris.txt 1
que	NotreDame_De_Paris.txt 9
queen	NotreDame_De_Paris.txt 11
queer	NotreDame_De_Paris.txt 3
quemadmodum	NotreDame_De_Paris.txt 1
quench	NotreDame_De_Paris.txt 1
quenouille	NotreDame_De_Paris.txt 1
quentin	NotreDame_De_Paris.txt 1
querette	NotreDame_De_Paris.txt 1
quest	NotreDame_De_Paris.txt 1
queste	NotreDame_De_Paris.txt 1
question	NotreDame_De_Paris.txt 42
questioned	NotreDame_De_Paris.txt 3
questions	NotreDame_De_Paris.txt 5
queue	NotreDame_De_Paris.txt 6
queues	NotreDame_De_Paris.txt 1
qui	NotreDame_De_Paris.txt 12
quia	NotreDame_De_Paris.txt 1
quibblers	NotreDame_De_Paris.txt 1
quibbles	NotreDame_De_Paris.txt 1
quibusdam	NotreDame_De_Paris.txt 1
quick	NotreDame_De_Paris.txt 14
quicker	NotreDame_De_Paris.txt 3
quickly	NotreDame_De_Paris.txt 18
quickness	NotreDame_De_Paris.txt 1
quicksand	NotreDame_De_Paris.txt 1
quiet	NotreDame_De_Paris.txt 3
quieted	NotreDame_De_Paris.txt 2
quietly	NotreDame_De_Paris.txt 2
quip	NotreDame_De_Paris.txt 1
quit	NotreDame_De_Paris.txt 6
quita	NotreDame_De_Paris.txt 1
quite	NotreDame_De_Paris.txt 39
quits	NotreDame_De_Paris.txt 1
quitted	NotreDame_De_Paris.txt 16
quitting	NotreDame_De_Paris.txt 1
quiver	NotreDame_De_Paris.txt 8
quivered	NotreDame_De_Paris.txt 7
quivering	NotreDame_De_Paris.txt 7
quod	NotreDame_De_Paris.txt 1
quoe	NotreDame_De_Paris.txt 9
quoi	NotreDame_De_Paris.txt 1
quoniam	NotreDame_De_Paris.txt 1
quotation	NotreDame_De_Paris.txt 1
quotations	NotreDame_De_Paris.txt 1
quote	NotreDame_De_Paris.txt 1
quoth	NotreDame_De_Paris.txt 1
