j	NotreDame_De_Paris.txt 2
jabbering	NotreDame_De_Paris.txt 2
jack	NotreDame_De_Paris.txt 1
jackal	NotreDame_De_Paris.txt 1
jacket	NotreDame_De_Paris.txt 2
jackets	NotreDame_De_Paris.txt 3
jacob	NotreDame_De_Paris.txt 1
jacqueline	NotreDame_De_Paris.txt 4
jacqueries	NotreDame_De_Paris.txt 1
jacques	NotreDame_De_Paris.txt 93
jagged	NotreDame_De_Paris.txt 1
jail	NotreDame_De_Paris.txt 3
jailer	NotreDame_De_Paris.txt 2
jailers	NotreDame_De_Paris.txt 1
jails	NotreDame_De_Paris.txt 1
jamb	NotreDame_De_Paris.txt 1
jamblique	NotreDame_De_Paris.txt 1
jambs	NotreDame_De_Paris.txt 1
james	NotreDame_De_Paris.txt 1
janitor	NotreDame_De_Paris.txt 1
january	NotreDame_De_Paris.txt 14
janvier	NotreDame_De_Paris.txt 1
jardin	NotreDame_De_Paris.txt 1
jargon	NotreDame_De_Paris.txt 3
jargons	NotreDame_De_Paris.txt 1
jaw	NotreDame_De_Paris.txt 3
jaws	NotreDame_De_Paris.txt 5
je	NotreDame_De_Paris.txt 5
jealous	NotreDame_De_Paris.txt 5
jealousies	NotreDame_De_Paris.txt 1
jealousy	NotreDame_De_Paris.txt 10
jean	NotreDame_De_Paris.txt 25
jeanne	NotreDame_De_Paris.txt 1
jeer	NotreDame_De_Paris.txt 2
jeered	NotreDame_De_Paris.txt 1
jeerers	NotreDame_De_Paris.txt 1
jeering	NotreDame_De_Paris.txt 2
jeers	NotreDame_De_Paris.txt 1
jehan	NotreDame_De_Paris.txt 164
jehanne	NotreDame_De_Paris.txt 6
jehanneton	NotreDame_De_Paris.txt 1
jehau	NotreDame_De_Paris.txt 1
jerk	NotreDame_De_Paris.txt 1
jerkin	NotreDame_De_Paris.txt 6
jerks	NotreDame_De_Paris.txt 3
jerky	NotreDame_De_Paris.txt 1
jerusalem	NotreDame_De_Paris.txt 1
jest	NotreDame_De_Paris.txt 5
jesus	NotreDame_De_Paris.txt 7
jets	NotreDame_De_Paris.txt 1
jetted	NotreDame_De_Paris.txt 1
jeune	NotreDame_De_Paris.txt 3
jew	NotreDame_De_Paris.txt 7
jewel	NotreDame_De_Paris.txt 1
jewish	NotreDame_De_Paris.txt 1
jews	NotreDame_De_Paris.txt 2
jingle	NotreDame_De_Paris.txt 1
jingling	NotreDame_De_Paris.txt 1
joachim	NotreDame_De_Paris.txt 1
joannes	NotreDame_De_Paris.txt 11
job	NotreDame_De_Paris.txt 7
jobs	NotreDame_De_Paris.txt 1
jockey	NotreDame_De_Paris.txt 1
jodouyne	NotreDame_De_Paris.txt 1
johannes	NotreDame_De_Paris.txt 2
johannis	NotreDame_De_Paris.txt 1
john	NotreDame_De_Paris.txt 9
joie	NotreDame_De_Paris.txt 1
join	NotreDame_De_Paris.txt 2
joined	NotreDame_De_Paris.txt 8
joiner	NotreDame_De_Paris.txt 2
joint	NotreDame_De_Paris.txt 2
jointly	NotreDame_De_Paris.txt 1
joints	NotreDame_De_Paris.txt 2
joinville	NotreDame_De_Paris.txt 1
joist	NotreDame_De_Paris.txt 1
joists	NotreDame_De_Paris.txt 1
jolly	NotreDame_De_Paris.txt 3
jolt	NotreDame_De_Paris.txt 1
josas	NotreDame_De_Paris.txt 8
jostled	NotreDame_De_Paris.txt 1
jostling	NotreDame_De_Paris.txt 1
jour	NotreDame_De_Paris.txt 2
journey	NotreDame_De_Paris.txt 1
jouvenel	NotreDame_De_Paris.txt 1
jouy	NotreDame_De_Paris.txt 1
jovial	NotreDame_De_Paris.txt 4
joviality	NotreDame_De_Paris.txt 2
jowl	NotreDame_De_Paris.txt 1
joy	NotreDame_De_Paris.txt 44
joyful	NotreDame_De_Paris.txt 1
joyfully	NotreDame_De_Paris.txt 1
joyous	NotreDame_De_Paris.txt 17
joyously	NotreDame_De_Paris.txt 6
joys	NotreDame_De_Paris.txt 1
juan	NotreDame_De_Paris.txt 1
juardini	NotreDame_De_Paris.txt 1
judas	NotreDame_De_Paris.txt 1
judea	NotreDame_De_Paris.txt 1
judge	NotreDame_De_Paris.txt 26
judged	NotreDame_De_Paris.txt 3
judges	NotreDame_De_Paris.txt 13
judging	NotreDame_De_Paris.txt 3
judgment	NotreDame_De_Paris.txt 8
judgments	NotreDame_De_Paris.txt 1
judicature	NotreDame_De_Paris.txt 1
judicial	NotreDame_De_Paris.txt 3
judiciary	NotreDame_De_Paris.txt 1
judicious	NotreDame_De_Paris.txt 2
judiciously	NotreDame_De_Paris.txt 2
judicium	NotreDame_De_Paris.txt 1
jug	NotreDame_De_Paris.txt 11
juge	NotreDame_De_Paris.txt 1
juggler	NotreDame_De_Paris.txt 1
jugs	NotreDame_De_Paris.txt 4
juiverie	NotreDame_De_Paris.txt 2
julian	NotreDame_De_Paris.txt 6
juliet	NotreDame_De_Paris.txt 1
july	NotreDame_De_Paris.txt 3
jumi	NotreDame_De_Paris.txt 1
jumped	NotreDame_De_Paris.txt 1
junction	NotreDame_De_Paris.txt 1
june	NotreDame_De_Paris.txt 1
jupiter	NotreDame_De_Paris.txt 39
juribus	NotreDame_De_Paris.txt 1
jurisconsults	NotreDame_De_Paris.txt 1
jurisdiction	NotreDame_De_Paris.txt 4
jurisdictions	NotreDame_De_Paris.txt 3
jusqu	NotreDame_De_Paris.txt 1
just	NotreDame_De_Paris.txt 119
justice	NotreDame_De_Paris.txt 46
justices	NotreDame_De_Paris.txt 2
justiciaries	NotreDame_De_Paris.txt 1
justiciary	NotreDame_De_Paris.txt 1
justify	NotreDame_De_Paris.txt 2
justitiam	NotreDame_De_Paris.txt 1
justly	NotreDame_De_Paris.txt 2
juv	NotreDame_De_Paris.txt 1
juxta	NotreDame_De_Paris.txt 1
juxtaposition	NotreDame_De_Paris.txt 1
