kader	Miserables.txt 1
kaleidoscope	Miserables.txt 1
keel	Miserables.txt 6
keen	Miserables.txt 1
keener	Miserables.txt 1
keenly	Miserables.txt 1
keep	Miserables.txt 69
keeper	Miserables.txt 49
keepers	Miserables.txt 3
keeping	Miserables.txt 21
keeps	Miserables.txt 8
keepsakes	Miserables.txt 1
kekcaa	Miserables.txt 2
kekscheb	Miserables.txt 1
keksekca	Miserables.txt 2
kellermann	Miserables.txt 4
kellner	Miserables.txt 1
kempt	Miserables.txt 5
kennel	Miserables.txt 6
kept	Miserables.txt 66
keravenant	Miserables.txt 1
kerchief	Miserables.txt 4
kerchiefs	Miserables.txt 1
kettle	Miserables.txt 1
key	Miserables.txt 68
keyhole	Miserables.txt 3
keys	Miserables.txt 5
khorassan	Miserables.txt 1
kian	Miserables.txt 1
kick	Miserables.txt 8
kicked	Miserables.txt 3
kicking	Miserables.txt 1
kicks	Miserables.txt 5
kielmansegg	Miserables.txt 1
kill	Miserables.txt 27
killed	Miserables.txt 80
killing	Miserables.txt 4
kills	Miserables.txt 10
kilns	Miserables.txt 2
kind	Miserables.txt 35
kindle	Miserables.txt 1
kindled	Miserables.txt 1
kindles	Miserables.txt 2
kindliness	Miserables.txt 2
kindly	Miserables.txt 21
kindness	Miserables.txt 19
kindnesses	Miserables.txt 1
kinds	Miserables.txt 3
king	Miserables.txt 124
kingdom	Miserables.txt 5
kingdoms	Miserables.txt 2
kingly	Miserables.txt 1
kings	Miserables.txt 35
kinsman	Miserables.txt 1
kirikikiou	Miserables.txt 2
kislar	Miserables.txt 1
kiss	Miserables.txt 25
kissed	Miserables.txt 23
kisses	Miserables.txt 7
kissing	Miserables.txt 1
kisss	Miserables.txt 2
kitchen	Miserables.txt 21
kitchens	Miserables.txt 2
kitten	Miserables.txt 3
kleber	Miserables.txt 3
kluze	Miserables.txt 1
knacker	Miserables.txt 3
knapsack	Miserables.txt 18
knapsacks	Miserables.txt 1
knave	Miserables.txt 3
knavery	Miserables.txt 2
knaves	Miserables.txt 1
kneaded	Miserables.txt 1
knee	Miserables.txt 36
kneecap	Miserables.txt 1
kneel	Miserables.txt 6
kneeling	Miserables.txt 10
kneels	Miserables.txt 2
kneepan	Miserables.txt 1
knees	Miserables.txt 82
knell	Miserables.txt 6
knells	Miserables.txt 1
knelt	Miserables.txt 12
knew	Miserables.txt 170
knickknacks	Miserables.txt 1
knife	Miserables.txt 31
knight	Miserables.txt 3
knighted	Miserables.txt 1
knights	Miserables.txt 1
knitted	Miserables.txt 7
knitting	Miserables.txt 4
knives	Miserables.txt 7
knob	Miserables.txt 6
knock	Miserables.txt 17
knocked	Miserables.txt 18
knocker	Miserables.txt 7
knocking	Miserables.txt 5
knocks	Miserables.txt 3
knoll	Miserables.txt 5
knolls	Miserables.txt 1
knot	Miserables.txt 17
knots	Miserables.txt 4
knotted	Miserables.txt 11
knotting	Miserables.txt 2
knotty	Miserables.txt 2
know	Miserables.txt 520
knowest	Miserables.txt 3
knoweth	Miserables.txt 1
knowing	Miserables.txt 54
knowingly	Miserables.txt 1
knowledge	Miserables.txt 10
known	Miserables.txt 104
knows	Miserables.txt 128
knuckle	Miserables.txt 1
kock	Miserables.txt 1
kosciusko	Miserables.txt 2
kruideniers	Miserables.txt 2
kylsom	Miserables.txt 3
