t	Miserables.txt 380
ta	Miserables.txt 6
tabaraud	Miserables.txt 1
table	Miserables.txt 228
tablecloth	Miserables.txt 1
tables	Miserables.txt 25
tablet	Miserables.txt 1
tabs	Miserables.txt 1
taches	Miserables.txt 1
tacit	Miserables.txt 3
tacitly	Miserables.txt 2
taciturn	Miserables.txt 5
taciturnity	Miserables.txt 2
tacitus	Miserables.txt 10
tacituses	Miserables.txt 1
tact	Miserables.txt 1
tactics	Miserables.txt 9
tadpoles	Miserables.txt 1
taf	Miserables.txt 1
taffeta	Miserables.txt 2
tail	Miserables.txt 17
tailors	Miserables.txt 1
tails	Miserables.txt 8
taint	Miserables.txt 2
tainted	Miserables.txt 2
tainville	Miserables.txt 1
take	Miserables.txt 372
taken	Miserables.txt 295
takes	Miserables.txt 63
taking	Miserables.txt 130
tal	Miserables.txt 1
talapoins	Miserables.txt 1
talavera	Miserables.txt 2
talbot	Miserables.txt 1
tale	Miserables.txt 12
talent	Miserables.txt 10
talents	Miserables.txt 9
tales	Miserables.txt 3
talisman	Miserables.txt 1
talk	Miserables.txt 61
talkative	Miserables.txt 4
talked	Miserables.txt 42
talker	Miserables.txt 4
talking	Miserables.txt 66
talks	Miserables.txt 9
tall	Miserables.txt 42
taller	Miserables.txt 5
talleyrand	Miserables.txt 6
tallow	Miserables.txt 3
tally	Miserables.txt 1
talma	Miserables.txt 5
talon	Miserables.txt 1
talons	Miserables.txt 3
tambour	Miserables.txt 1
tame	Miserables.txt 1
tan	Miserables.txt 2
tandem	Miserables.txt 1
tanflute	Miserables.txt 1
tangible	Miserables.txt 1
tangle	Miserables.txt 1
tangled	Miserables.txt 2
tank	Miserables.txt 1
tanned	Miserables.txt 2
tanneries	Miserables.txt 1
tantalus	Miserables.txt 2
tantamount	Miserables.txt 1
tap	Miserables.txt 27
tape	Miserables.txt 2
tapecu	Miserables.txt 1
taper	Miserables.txt 6
tapers	Miserables.txt 1
tapestries	Miserables.txt 2
tapestry	Miserables.txt 3
tapissieres	Miserables.txt 1
tapped	Miserables.txt 10
tapping	Miserables.txt 1
taps	Miserables.txt 3
tarantula	Miserables.txt 1
tardy	Miserables.txt 4
tares	Miserables.txt 2
target	Miserables.txt 2
tariff	Miserables.txt 5
tarpaulin	Miserables.txt 1
tarpaulins	Miserables.txt 1
tarrying	Miserables.txt 1
tarsus	Miserables.txt 1
tartan	Miserables.txt 1
tartar	Miserables.txt 1
tarts	Miserables.txt 1
tartuffe	Miserables.txt 3
task	Miserables.txt 25
tasse	Miserables.txt 1
tassel	Miserables.txt 1
tassels	Miserables.txt 1
taste	Miserables.txt 38
tasted	Miserables.txt 4
tastes	Miserables.txt 1
tasting	Miserables.txt 2
tatter	Miserables.txt 1
tatterdemalions	Miserables.txt 1
tattered	Miserables.txt 17
tatters	Miserables.txt 4
tattooed	Miserables.txt 3
taudis	Miserables.txt 1
taught	Miserables.txt 17
taule	Miserables.txt 2
tavannes	Miserables.txt 1
tavern	Miserables.txt 26
taverns	Miserables.txt 5
tax	Miserables.txt 10
taxes	Miserables.txt 8
te	Miserables.txt 10
tea	Miserables.txt 6
teach	Miserables.txt 11
teacher	Miserables.txt 1
teachers	Miserables.txt 2
teaching	Miserables.txt 2
teachings	Miserables.txt 1
team	Miserables.txt 5
teams	Miserables.txt 3
tear	Miserables.txt 35
tearer	Miserables.txt 1
tearing	Miserables.txt 12
tearless	Miserables.txt 1
tears	Miserables.txt 41
tease	Miserables.txt 2
teasing	Miserables.txt 5
tecelin	Miserables.txt 1
teeth	Miserables.txt 94
teglath	Miserables.txt 1
telegraph	Miserables.txt 2
telegraphic	Miserables.txt 1
telemachus	Miserables.txt 1
telescope	Miserables.txt 3
tell	Miserables.txt 173
teller	Miserables.txt 4
tellers	Miserables.txt 1
telling	Miserables.txt 20
tells	Miserables.txt 10
temerity	Miserables.txt 1
temper	Miserables.txt 4
temperament	Miserables.txt 1
temperaments	Miserables.txt 1
temperate	Miserables.txt 2
temperature	Miserables.txt 3
tempered	Miserables.txt 7
tempers	Miserables.txt 1
tempest	Miserables.txt 16
tempests	Miserables.txt 1
temple	Miserables.txt 42
temples	Miserables.txt 11
temporal	Miserables.txt 1
temporarily	Miserables.txt 1
temporary	Miserables.txt 7
temps	Miserables.txt 3
temptation	Miserables.txt 6
temptations	Miserables.txt 3
tempted	Miserables.txt 9
tempting	Miserables.txt 4
ten	Miserables.txt 118
tenable	Miserables.txt 1
tenacious	Miserables.txt 4
tenaciously	Miserables.txt 1
tenacity	Miserables.txt 4
tenait	Miserables.txt 2
tenant	Miserables.txt 7
tenants	Miserables.txt 1
tend	Miserables.txt 2
tende	Miserables.txt 1
tended	Miserables.txt 1
tendencies	Miserables.txt 1
tendency	Miserables.txt 6
tender	Miserables.txt 38
tenderest	Miserables.txt 3
tenderly	Miserables.txt 8
tenderness	Miserables.txt 26
tending	Miserables.txt 2
tendre	Miserables.txt 1
tendrils	Miserables.txt 2
tends	Miserables.txt 2
tenfold	Miserables.txt 2
tennine	Miserables.txt 1
tennis	Miserables.txt 3
tenor	Miserables.txt 1
tens	Miserables.txt 1
tension	Miserables.txt 5
tent	Miserables.txt 2
tenth	Miserables.txt 5
tenthly	Miserables.txt 1
terentius	Miserables.txt 1
tergiversation	Miserables.txt 1
term	Miserables.txt 7
termed	Miserables.txt 4
terminate	Miserables.txt 5
terminated	Miserables.txt 15
terminates	Miserables.txt 3
terminating	Miserables.txt 2
termination	Miserables.txt 7
termites	Miserables.txt 1
terms	Miserables.txt 47
ternaux	Miserables.txt 1
terra	Miserables.txt 1
terrace	Miserables.txt 4
terraces	Miserables.txt 2
terrae	Miserables.txt 1
terram	Miserables.txt 1
terraqueous	Miserables.txt 1
terray	Miserables.txt 1
terre	Miserables.txt 3
terrestrial	Miserables.txt 9
terreur	Miserables.txt 1
terrible	Miserables.txt 223
terribly	Miserables.txt 1
terrific	Miserables.txt 1
terrified	Miserables.txt 52
terrifies	Miserables.txt 3
terrify	Miserables.txt 2
terrifying	Miserables.txt 11
territory	Miserables.txt 4
terror	Miserables.txt 76
terrorism	Miserables.txt 3
terrorist	Miserables.txt 1
terrors	Miserables.txt 6
tertullian	Miserables.txt 1
tes	Miserables.txt 3
tessier	Miserables.txt 1
test	Miserables.txt 4
testament	Miserables.txt 6
tested	Miserables.txt 1
tester	Miserables.txt 1
testify	Miserables.txt 2
testimony	Miserables.txt 5
tete	Miserables.txt 5
tetes	Miserables.txt 1
tetons	Miserables.txt 1
teucer	Miserables.txt 1
teuthranis	Miserables.txt 1
teuton	Miserables.txt 1
text	Miserables.txt 11
texts	Miserables.txt 3
th	Miserables.txt 129
thales	Miserables.txt 1
thames	Miserables.txt 1
than	Miserables.txt 866
thank	Miserables.txt 15
thanked	Miserables.txt 6
thanking	Miserables.txt 1
thanks	Miserables.txt 65
that	Miserables.txt 7924
thatched	Miserables.txt 9
thaw	Miserables.txt 2
thawed	Miserables.txt 1
the	Miserables.txt 41093
theatre	Miserables.txt 28
theatres	Miserables.txt 6
theatrical	Miserables.txt 3
thebaid	Miserables.txt 1
theban	Miserables.txt 1
thebes	Miserables.txt 4
thee	Miserables.txt 34
theft	Miserables.txt 51
thefts	Miserables.txt 1
their	Miserables.txt 1252
theirs	Miserables.txt 7
them	Miserables.txt 1068
theme	Miserables.txt 1
themis	Miserables.txt 1
themselves	Miserables.txt 250
then	Miserables.txt 1038
thenard	Miserables.txt 5
thenardier	Miserables.txt 534
thenardiers	Miserables.txt 54
thence	Miserables.txt 16
thenceforth	Miserables.txt 11
theocritus	Miserables.txt 1
theodore	Miserables.txt 1
theodule	Miserables.txt 49
theological	Miserables.txt 2
theology	Miserables.txt 2
theophilus	Miserables.txt 1
theorem	Miserables.txt 1
theoretical	Miserables.txt 1
theories	Miserables.txt 7
theorists	Miserables.txt 2
theory	Miserables.txt 7
theramene	Miserables.txt 1
therapontigonus	Miserables.txt 1
there	Miserables.txt 2682
thereabouts	Miserables.txt 2
thereafter	Miserables.txt 4
thereby	Miserables.txt 6
therefore	Miserables.txt 30
therefrom	Miserables.txt 1
therein	Miserables.txt 25
theresa	Miserables.txt 1
therese	Miserables.txt 5
thereto	Miserables.txt 3
thereupon	Miserables.txt 10
therewith	Miserables.txt 1
thermes	Miserables.txt 1
thermidor	Miserables.txt 3
thermometer	Miserables.txt 2
thermometers	Miserables.txt 1
thermopylae	Miserables.txt 4
thesauros	Miserables.txt 1
these	Miserables.txt 1008
theses	Miserables.txt 1
theseus	Miserables.txt 1
thesis	Miserables.txt 1
thespis	Miserables.txt 1
thesprion	Miserables.txt 1
thessaly	Miserables.txt 1
they	Miserables.txt 2127
thibet	Miserables.txt 1
thibord	Miserables.txt 1
thick	Miserables.txt 24
thicker	Miserables.txt 2
thicket	Miserables.txt 24
thickets	Miserables.txt 5
thickness	Miserables.txt 6
thicknesses	Miserables.txt 2
thickset	Miserables.txt 2
thief	Miserables.txt 44
thierry	Miserables.txt 2
thiers	Miserables.txt 1
thieves	Miserables.txt 17
thieving	Miserables.txt 2
thigh	Miserables.txt 1
thighs	Miserables.txt 3
thil	Miserables.txt 1
thin	Miserables.txt 49
thine	Miserables.txt 3
thing	Miserables.txt 323
things	Miserables.txt 303
think	Miserables.txt 224
thinker	Miserables.txt 15
thinkers	Miserables.txt 10
thinking	Miserables.txt 74
thinks	Miserables.txt 22
thinned	Miserables.txt 3
thinner	Miserables.txt 2
thinness	Miserables.txt 1
third	Miserables.txt 96
thirdly	Miserables.txt 2
thirds	Miserables.txt 4
thirst	Miserables.txt 10
thirsting	Miserables.txt 1
thirsts	Miserables.txt 2
thirsty	Miserables.txt 11
thirteen	Miserables.txt 12
thirteenth	Miserables.txt 6
thirty	Miserables.txt 101
this	Miserables.txt 4008
thisbe	Miserables.txt 1
thistles	Miserables.txt 1
thither	Miserables.txt 56
tholomyes	Miserables.txt 66
thomas	Miserables.txt 3
thongs	Miserables.txt 1
thorigny	Miserables.txt 2
thorn	Miserables.txt 4
thorns	Miserables.txt 3
thorny	Miserables.txt 2
thorough	Miserables.txt 5
thoroughbred	Miserables.txt 1
thoroughfare	Miserables.txt 1
thoroughly	Miserables.txt 40
those	Miserables.txt 735
thou	Miserables.txt 125
thouars	Miserables.txt 1
though	Miserables.txt 355
thought	Miserables.txt 496
thoughtful	Miserables.txt 42
thoughtfully	Miserables.txt 13
thoughtfulness	Miserables.txt 2
thoughtless	Miserables.txt 2
thoughts	Miserables.txt 85
thousand	Miserables.txt 187
thousands	Miserables.txt 4
thracius	Miserables.txt 1
thrashings	Miserables.txt 1
thrasybulus	Miserables.txt 1
thread	Miserables.txt 38
threadbare	Miserables.txt 16
threads	Miserables.txt 14
threat	Miserables.txt 1
threaten	Miserables.txt 2
threatened	Miserables.txt 7
threatening	Miserables.txt 15
threatens	Miserables.txt 5
threats	Miserables.txt 1
three	Miserables.txt 477
threshold	Miserables.txt 28
thresholds	Miserables.txt 5
threw	Miserables.txt 43
thrice	Miserables.txt 3
thrill	Miserables.txt 2
thrilled	Miserables.txt 1
thrives	Miserables.txt 1
throat	Miserables.txt 36
throats	Miserables.txt 7
throbbed	Miserables.txt 1
throbbing	Miserables.txt 2
throes	Miserables.txt 2
throne	Miserables.txt 21
thrones	Miserables.txt 7
throng	Miserables.txt 35
thronging	Miserables.txt 1
throngs	Miserables.txt 8
through	Miserables.txt 531
throughout	Miserables.txt 15
throve	Miserables.txt 1
throw	Miserables.txt 31
throwing	Miserables.txt 14
thrown	Miserables.txt 50
throws	Miserables.txt 2
thrushes	Miserables.txt 1
thrust	Miserables.txt 75
thrusting	Miserables.txt 13
thrusts	Miserables.txt 6
thuin	Miserables.txt 1
thumb	Miserables.txt 18
thumbs	Miserables.txt 2
thumped	Miserables.txt 1
thunder	Miserables.txt 39
thunderbolt	Miserables.txt 5
thunderbolts	Miserables.txt 3
thunderclap	Miserables.txt 1
thundered	Miserables.txt 3
thundering	Miserables.txt 8
thunders	Miserables.txt 6
thunderstruck	Miserables.txt 2
thunes	Miserables.txt 3
thuneurs	Miserables.txt 1
thus	Miserables.txt 227
thuya	Miserables.txt 1
thwarted	Miserables.txt 1
thy	Miserables.txt 40
thygelion	Miserables.txt 1
thym	Miserables.txt 1
thyme	Miserables.txt 3
thyself	Miserables.txt 1
tiara	Miserables.txt 2
tiber	Miserables.txt 4
tiberii	Miserables.txt 1
tiberim	Miserables.txt 2
tiberius	Miserables.txt 3
tibullus	Miserables.txt 1
ticketed	Miserables.txt 1
tickets	Miserables.txt 2
ticking	Miserables.txt 2
tickled	Miserables.txt 1
ticklish	Miserables.txt 1
tide	Miserables.txt 5
tidy	Miserables.txt 2
tie	Miserables.txt 3
tied	Miserables.txt 9
tierce	Miserables.txt 1
tiercelin	Miserables.txt 1
tiers	Miserables.txt 1
tiger	Miserables.txt 25
tigers	Miserables.txt 3
tight	Miserables.txt 3
tightly	Miserables.txt 3
tights	Miserables.txt 2
tigre	Miserables.txt 1
tigress	Miserables.txt 2
tilbury	Miserables.txt 19
tiled	Miserables.txt 2
tiler	Miserables.txt 1
tiles	Miserables.txt 1
till	Miserables.txt 6
tillac	Miserables.txt 2
tilled	Miserables.txt 1
tilly	Miserables.txt 1
tilsit	Miserables.txt 1
tilted	Miserables.txt 1
timaloumisaine	Miserables.txt 1
timaloumison	Miserables.txt 1
timber	Miserables.txt 16
time	Miserables.txt 762
times	Miserables.txt 135
timid	Miserables.txt 20
timidity	Miserables.txt 9
timidly	Miserables.txt 9
timoleon	Miserables.txt 1
tin	Miserables.txt 11
tincture	Miserables.txt 1
tine	Miserables.txt 1
tinge	Miserables.txt 1
tinged	Miserables.txt 1
tiniest	Miserables.txt 3
tinkling	Miserables.txt 1
tinques	Miserables.txt 5
tinsel	Miserables.txt 2
tint	Miserables.txt 1
tinted	Miserables.txt 1
tiny	Miserables.txt 42
tip	Miserables.txt 20
tipped	Miserables.txt 3
tips	Miserables.txt 8
tipsy	Miserables.txt 2
tiptoe	Miserables.txt 11
tiraient	Miserables.txt 1
tirais	Miserables.txt 1
tirait	Miserables.txt 1
tire	Miserables.txt 1
tirecuir	Miserables.txt 1
tired	Miserables.txt 7
tirer	Miserables.txt 1
tires	Miserables.txt 2
tiresome	Miserables.txt 1
tiridate	Miserables.txt 1
tis	Miserables.txt 14
titan	Miserables.txt 1
titanic	Miserables.txt 8
titans	Miserables.txt 5
tithes	Miserables.txt 1
titi	Miserables.txt 4
titian	Miserables.txt 1
title	Miserables.txt 20
titlepage	Miserables.txt 9
titles	Miserables.txt 2
titus	Miserables.txt 1
tityrus	Miserables.txt 1
tivoli	Miserables.txt 2
tm	Miserables.txt 57
to	Miserables.txt 13950
toad	Miserables.txt 5
toads	Miserables.txt 2
toast	Miserables.txt 1
tobacco	Miserables.txt 13
tocsin	Miserables.txt 7
tocsins	Miserables.txt 2
toda	Miserables.txt 1
today	Miserables.txt 3
toddle	Miserables.txt 1
toe	Miserables.txt 1
toes	Miserables.txt 3
toga	Miserables.txt 1
together	Miserables.txt 106
toi	Miserables.txt 2
toil	Miserables.txt 34
toiled	Miserables.txt 5
toilers	Miserables.txt 2
toilet	Miserables.txt 17
toilette	Miserables.txt 4
toilettes	Miserables.txt 2
toils	Miserables.txt 6
toilsome	Miserables.txt 1
tolbiac	Miserables.txt 1
told	Miserables.txt 134
tolerable	Miserables.txt 9
tolerably	Miserables.txt 47
tolerance	Miserables.txt 1
tolerant	Miserables.txt 1
tolerate	Miserables.txt 1
tolerated	Miserables.txt 7
toll	Miserables.txt 4
tolleron	Miserables.txt 2
tolls	Miserables.txt 1
tolosa	Miserables.txt 1
tomb	Miserables.txt 61
tombe	Miserables.txt 3
tombs	Miserables.txt 7
tomcat	Miserables.txt 1
tomorrow	Miserables.txt 2
tomtits	Miserables.txt 1
ton	Miserables.txt 13
tone	Miserables.txt 85
toned	Miserables.txt 1
tones	Miserables.txt 13
tongres	Miserables.txt 1
tongs	Miserables.txt 2
tongue	Miserables.txt 45
tongues	Miserables.txt 8
tonnerre	Miserables.txt 2
tonsure	Miserables.txt 1
too	Miserables.txt 283
took	Miserables.txt 402
tool	Miserables.txt 9
tools	Miserables.txt 8
tooth	Miserables.txt 4
toothless	Miserables.txt 3
top	Miserables.txt 82
topcoat	Miserables.txt 1
topman	Miserables.txt 4
topple	Miserables.txt 1
tops	Miserables.txt 4
topsy	Miserables.txt 2
topsyturveydom	Miserables.txt 1
torch	Miserables.txt 24
torches	Miserables.txt 4
tore	Miserables.txt 26
torment	Miserables.txt 4
tormented	Miserables.txt 3
tormenting	Miserables.txt 1
torments	Miserables.txt 3
torn	Miserables.txt 44
torpid	Miserables.txt 1
torpor	Miserables.txt 1
torrent	Miserables.txt 4
torrents	Miserables.txt 2
torsades	Miserables.txt 2
torso	Miserables.txt 2
torsos	Miserables.txt 1
tortiller	Miserables.txt 1
tortouse	Miserables.txt 1
tortuous	Miserables.txt 4
torture	Miserables.txt 19
tortured	Miserables.txt 1
tortures	Miserables.txt 4
torturing	Miserables.txt 1
toryne	Miserables.txt 1
toss	Miserables.txt 5
tossed	Miserables.txt 13
tosses	Miserables.txt 1
tossing	Miserables.txt 1
tossings	Miserables.txt 1
total	Miserables.txt 22
totally	Miserables.txt 7
totals	Miserables.txt 1
tottered	Miserables.txt 1
tottering	Miserables.txt 8
tottlingen	Miserables.txt 1
tou	Miserables.txt 6
touch	Miserables.txt 39
touched	Miserables.txt 75
touches	Miserables.txt 7
touching	Miserables.txt 29
tough	Miserables.txt 2
toujours	Miserables.txt 3
toul	Miserables.txt 1
toulon	Miserables.txt 29
toulousan	Miserables.txt 1
toulouse	Miserables.txt 5
touquet	Miserables.txt 3
tour	Miserables.txt 8
tournefort	Miserables.txt 1
tournois	Miserables.txt 1
tournon	Miserables.txt 1
tours	Miserables.txt 2
tourteau	Miserables.txt 1
tous	Miserables.txt 2
toussaint	Miserables.txt 56
tout	Miserables.txt 6
toute	Miserables.txt 1
tow	Miserables.txt 4
toward	Miserables.txt 16
towards	Miserables.txt 318
towed	Miserables.txt 1
tower	Miserables.txt 13
towered	Miserables.txt 3
towers	Miserables.txt 8
towing	Miserables.txt 1
town	Miserables.txt 114
townhall	Miserables.txt 2
towns	Miserables.txt 10
townsman	Miserables.txt 1
townspeople	Miserables.txt 1
toy	Miserables.txt 3
toyed	Miserables.txt 1
trabuceros	Miserables.txt 1
trace	Miserables.txt 26
traced	Miserables.txt 7
traces	Miserables.txt 16
tracing	Miserables.txt 1
track	Miserables.txt 15
tracked	Miserables.txt 4
tracks	Miserables.txt 1
tractable	Miserables.txt 1
traction	Miserables.txt 1
tracts	Miserables.txt 1
trade	Miserables.txt 20
trademark	Miserables.txt 11
trader	Miserables.txt 1
trades	Miserables.txt 3
tradesman	Miserables.txt 3
tradesmen	Miserables.txt 1
tradition	Miserables.txt 13
traditions	Miserables.txt 3
tradunt	Miserables.txt 1
tragedies	Miserables.txt 2
tragedy	Miserables.txt 8
tragic	Miserables.txt 40
trail	Miserables.txt 5
trailing	Miserables.txt 1
trails	Miserables.txt 2
train	Miserables.txt 12
trained	Miserables.txt 4
training	Miserables.txt 1
trains	Miserables.txt 2
trait	Miserables.txt 3
traitor	Miserables.txt 5
traitorously	Miserables.txt 1
traitors	Miserables.txt 5
traits	Miserables.txt 1
trajectory	Miserables.txt 2
trammelled	Miserables.txt 2
tramp	Miserables.txt 3
tramping	Miserables.txt 1
trample	Miserables.txt 2
trampled	Miserables.txt 4
trampling	Miserables.txt 5
tranchelevent	Miserables.txt 4
tranquil	Miserables.txt 42
tranquillities	Miserables.txt 1
tranquillity	Miserables.txt 20
tranquilly	Miserables.txt 15
transcribe	Miserables.txt 4
transcribing	Miserables.txt 1
transcription	Miserables.txt 1
transfer	Miserables.txt 1
transferred	Miserables.txt 9
transfiguration	Miserables.txt 8
transfigurations	Miserables.txt 1
transfigure	Miserables.txt 2
transfigured	Miserables.txt 15
transfigures	Miserables.txt 1
transfiguring	Miserables.txt 1
transfixed	Miserables.txt 1
transform	Miserables.txt 7
transformation	Miserables.txt 9
transformations	Miserables.txt 1
transformed	Miserables.txt 8
transforms	Miserables.txt 1
transgressed	Miserables.txt 1
transgressing	Miserables.txt 1
transit	Miserables.txt 3
transition	Miserables.txt 12
transitions	Miserables.txt 1
transitory	Miserables.txt 1
translate	Miserables.txt 1
translated	Miserables.txt 6
translating	Miserables.txt 1
translation	Miserables.txt 6
translations	Miserables.txt 3
translator	Miserables.txt 1
translators	Miserables.txt 1
transmitted	Miserables.txt 6
transmutation	Miserables.txt 1
transnonain	Miserables.txt 3
transparencies	Miserables.txt 1
transparency	Miserables.txt 7
transparent	Miserables.txt 7
transport	Miserables.txt 9
transported	Miserables.txt 1
transports	Miserables.txt 5
transteverin	Miserables.txt 1
transverse	Miserables.txt 6
trap	Miserables.txt 43
trapeze	Miserables.txt 1
trapezium	Miserables.txt 5
trappe	Miserables.txt 1
trappist	Miserables.txt 1
traps	Miserables.txt 9
travel	Miserables.txt 12
travelled	Miserables.txt 11
traveller	Miserables.txt 51
travellers	Miserables.txt 16
travelling	Miserables.txt 10
travells	Miserables.txt 2
travels	Miserables.txt 6
travers	Miserables.txt 2
traverse	Miserables.txt 23
traversed	Miserables.txt 69
traverses	Miserables.txt 1
traversiere	Miserables.txt 2
traversing	Miserables.txt 16
treacheries	Miserables.txt 2
treacherous	Miserables.txt 11
treacherously	Miserables.txt 1
treachery	Miserables.txt 3
tread	Miserables.txt 13
treading	Miserables.txt 1
treads	Miserables.txt 1
treason	Miserables.txt 2
treasons	Miserables.txt 1
treasure	Miserables.txt 18
treasurer	Miserables.txt 2
treasures	Miserables.txt 5
treasury	Miserables.txt 2
treat	Miserables.txt 16
treated	Miserables.txt 22
treaties	Miserables.txt 2
treating	Miserables.txt 5
treatise	Miserables.txt 1
treatment	Miserables.txt 4
treats	Miserables.txt 3
treaty	Miserables.txt 1
trebled	Miserables.txt 1
trebles	Miserables.txt 1
trebling	Miserables.txt 1
tree	Miserables.txt 78
trees	Miserables.txt 135
trefoil	Miserables.txt 1
trefoils	Miserables.txt 1
trellis	Miserables.txt 3
tremble	Miserables.txt 20
trembled	Miserables.txt 41
trembles	Miserables.txt 3
trembling	Miserables.txt 52
tremblingly	Miserables.txt 1
tremendous	Miserables.txt 17
tremendously	Miserables.txt 1
tremolo	Miserables.txt 1
tremor	Miserables.txt 12
tremors	Miserables.txt 3
tremulous	Miserables.txt 1
trench	Miserables.txt 13
trenches	Miserables.txt 3
trenton	Miserables.txt 1
trepidation	Miserables.txt 2
tres	Miserables.txt 2
tresor	Miserables.txt 1
tresses	Miserables.txt 1
trestaillon	Miserables.txt 2
trestles	Miserables.txt 1
tria	Miserables.txt 1
trial	Miserables.txt 22
trials	Miserables.txt 6
triangle	Miserables.txt 2
triangular	Miserables.txt 5
tribe	Miserables.txt 2
tribes	Miserables.txt 1
tribunal	Miserables.txt 6
tribunals	Miserables.txt 5
tribunaux	Miserables.txt 1
tribune	Miserables.txt 4
tribunes	Miserables.txt 1
tributaries	Miserables.txt 1
tribute	Miserables.txt 3
trick	Miserables.txt 5
tricked	Miserables.txt 1
trickery	Miserables.txt 2
trickle	Miserables.txt 2
trickled	Miserables.txt 12
trickles	Miserables.txt 2
trickling	Miserables.txt 1
tricks	Miserables.txt 3
tricolored	Miserables.txt 9
tricot	Miserables.txt 1
trident	Miserables.txt 1
tried	Miserables.txt 63
triel	Miserables.txt 1
tries	Miserables.txt 10
trifle	Miserables.txt 12
trifles	Miserables.txt 3
trifling	Miserables.txt 2
trigger	Miserables.txt 6
triggerless	Miserables.txt 3
trim	Miserables.txt 1
trimaient	Miserables.txt 1
trimalcion	Miserables.txt 1
trime	Miserables.txt 1
trimmed	Miserables.txt 2
trimming	Miserables.txt 1
trinity	Miserables.txt 2
trinkets	Miserables.txt 7
trinquelague	Miserables.txt 1
trios	Miserables.txt 1
trip	Miserables.txt 26
triple	Miserables.txt 8
triplicity	Miserables.txt 1
tripods	Miserables.txt 3
tripping	Miserables.txt 2
trips	Miserables.txt 9
tristan	Miserables.txt 1
triste	Miserables.txt 1
trithemus	Miserables.txt 1
triton	Miserables.txt 2
triumph	Miserables.txt 27
triumphal	Miserables.txt 3
triumphant	Miserables.txt 13
triumphantly	Miserables.txt 3
triumphed	Miserables.txt 3
triumphing	Miserables.txt 1
triumphs	Miserables.txt 5
trivial	Miserables.txt 3
triviality	Miserables.txt 1
trocadero	Miserables.txt 1
trod	Miserables.txt 1
trodden	Miserables.txt 3
trogoff	Miserables.txt 1
trois	Miserables.txt 1
troisieme	Miserables.txt 1
tronche	Miserables.txt 1
trone	Miserables.txt 4
troop	Miserables.txt 9
trooped	Miserables.txt 2
troops	Miserables.txt 22
trophonius	Miserables.txt 1
trophy	Miserables.txt 3
trot	Miserables.txt 9
trottait	Miserables.txt 1
trotted	Miserables.txt 2
trotting	Miserables.txt 1
trouble	Miserables.txt 50
troubled	Miserables.txt 47
troubles	Miserables.txt 9
troublesome	Miserables.txt 5
troubling	Miserables.txt 6
troublous	Miserables.txt 1
troupe	Miserables.txt 4
trousers	Miserables.txt 57
trousseau	Miserables.txt 2
trout	Miserables.txt 1
trouvaille	Miserables.txt 1
trouverez	Miserables.txt 1
trove	Miserables.txt 2
trowsers	Miserables.txt 1
troy	Miserables.txt 2
truanderie	Miserables.txt 14
truant	Miserables.txt 1
truce	Miserables.txt 4
truck	Miserables.txt 2
trucks	Miserables.txt 1
true	Miserables.txt 170
truer	Miserables.txt 1
truest	Miserables.txt 1
truffled	Miserables.txt 1
truffles	Miserables.txt 2
truly	Miserables.txt 23
trump	Miserables.txt 3
trumpet	Miserables.txt 9
trumpets	Miserables.txt 16
trumps	Miserables.txt 1
truncated	Miserables.txt 2
trundled	Miserables.txt 1
trunk	Miserables.txt 14
trunks	Miserables.txt 5
trunnions	Miserables.txt 1
truss	Miserables.txt 6
trusses	Miserables.txt 2
trust	Miserables.txt 10
trusted	Miserables.txt 6
trusting	Miserables.txt 2
trustworthy	Miserables.txt 2
trusty	Miserables.txt 2
truth	Miserables.txt 104
truths	Miserables.txt 8
try	Miserables.txt 26
trying	Miserables.txt 16
tryphon	Miserables.txt 5
trysting	Miserables.txt 1
ts	Miserables.txt 1
tso	Miserables.txt 1
tu	Miserables.txt 21
tua	Miserables.txt 1
tuas	Miserables.txt 1
tub	Miserables.txt 4
tube	Miserables.txt 1
tubercle	Miserables.txt 1
tubercles	Miserables.txt 1
tubular	Miserables.txt 2
tuck	Miserables.txt 2
tucked	Miserables.txt 2
tucking	Miserables.txt 1
tuesday	Miserables.txt 21
tuesdays	Miserables.txt 1
tuft	Miserables.txt 4
tufted	Miserables.txt 3
tufts	Miserables.txt 1
tug	Miserables.txt 3
tugendbund	Miserables.txt 1
tugged	Miserables.txt 1
tuileries	Miserables.txt 21
tuiles	Miserables.txt 1
tulip	Miserables.txt 1
tulipe	Miserables.txt 1
tulips	Miserables.txt 5
tumble	Miserables.txt 4
tumbled	Miserables.txt 7
tumbling	Miserables.txt 3
tumbrel	Miserables.txt 1
tumbril	Miserables.txt 2
tumbrils	Miserables.txt 2
tumors	Miserables.txt 1
tumult	Miserables.txt 33
tumults	Miserables.txt 1
tumultuous	Miserables.txt 17
tumultuously	Miserables.txt 6
tun	Miserables.txt 3
tune	Miserables.txt 1
tunes	Miserables.txt 1
tunnel	Miserables.txt 2
tunnels	Miserables.txt 2
turcaret	Miserables.txt 1
tureen	Miserables.txt 1
turenne	Miserables.txt 2
turf	Miserables.txt 8
turgot	Miserables.txt 3
turin	Miserables.txt 2
turk	Miserables.txt 6
turkey	Miserables.txt 7
turkheim	Miserables.txt 1
turkish	Miserables.txt 1
turks	Miserables.txt 1
turn	Miserables.txt 147
turned	Miserables.txt 332
turning	Miserables.txt 67
turnip	Miserables.txt 1
turnkey	Miserables.txt 5
turnkeys	Miserables.txt 1
turnover	Miserables.txt 2
turnovers	Miserables.txt 2
turns	Miserables.txt 31
turpentine	Miserables.txt 1
turpitude	Miserables.txt 2
turpitudes	Miserables.txt 1
turquoises	Miserables.txt 1
turris	Miserables.txt 1
turtle	Miserables.txt 2
turtledoves	Miserables.txt 1
turvy	Miserables.txt 2
tusks	Miserables.txt 1
tussle	Miserables.txt 1
tutor	Miserables.txt 1
tutu	Miserables.txt 2
tuy	Miserables.txt 1
tuyaux	Miserables.txt 1
twaddle	Miserables.txt 3
twain	Miserables.txt 3
twang	Miserables.txt 1
twas	Miserables.txt 1
twelfth	Miserables.txt 5
twelve	Miserables.txt 49
twentieth	Miserables.txt 4
twenty	Miserables.txt 194
twice	Miserables.txt 22
twig	Miserables.txt 1
twigs	Miserables.txt 2
twilight	Miserables.txt 57
twin	Miserables.txt 1
twine	Miserables.txt 2
twined	Miserables.txt 1
twinge	Miserables.txt 1
twinkle	Miserables.txt 1
twinkling	Miserables.txt 14
twirling	Miserables.txt 1
twist	Miserables.txt 4
twisted	Miserables.txt 7
twisting	Miserables.txt 4
twists	Miserables.txt 2
twitching	Miserables.txt 1
twitchings	Miserables.txt 2
twits	Miserables.txt 1
twitter	Miserables.txt 1
twittering	Miserables.txt 1
twitters	Miserables.txt 1
two	Miserables.txt 1214
twos	Miserables.txt 2
txt	Miserables.txt 1
tying	Miserables.txt 2
tymbraeus	Miserables.txt 1
type	Miserables.txt 8
types	Miserables.txt 2
typhus	Miserables.txt 3
tyrannica	Miserables.txt 1
tyrannical	Miserables.txt 1
tyrannies	Miserables.txt 4
tyrannize	Miserables.txt 1
tyranny	Miserables.txt 5
tyrant	Miserables.txt 19
tyrants	Miserables.txt 6
tyre	Miserables.txt 1
tzar	Miserables.txt 2
