u	NotreDame_De_Paris.txt 3
ubi	NotreDame_De_Paris.txt 2
ubiquity	NotreDame_De_Paris.txt 1
ueya	NotreDame_De_Paris.txt 1
ugene	NotreDame_De_Paris.txt 1
ugh	NotreDame_De_Paris.txt 3
uglier	NotreDame_De_Paris.txt 1
ugliest	NotreDame_De_Paris.txt 1
ugliness	NotreDame_De_Paris.txt 10
ugly	NotreDame_De_Paris.txt 12
ulcer	NotreDame_De_Paris.txt 1
ultimam	NotreDame_De_Paris.txt 1
umbras	NotreDame_De_Paris.txt 1
un	NotreDame_De_Paris.txt 9
una	NotreDame_De_Paris.txt 1
unable	NotreDame_De_Paris.txt 7
unaccustomed	NotreDame_De_Paris.txt 1
unaided	NotreDame_De_Paris.txt 1
unanimous	NotreDame_De_Paris.txt 3
unanimously	NotreDame_De_Paris.txt 1
unanswerable	NotreDame_De_Paris.txt 1
unattached	NotreDame_De_Paris.txt 5
unbearable	NotreDame_De_Paris.txt 1
unbooted	NotreDame_De_Paris.txt 1
unbound	NotreDame_De_Paris.txt 2
unbridled	NotreDame_De_Paris.txt 1
unbroken	NotreDame_De_Paris.txt 1
unbuckled	NotreDame_De_Paris.txt 1
unbuttoned	NotreDame_De_Paris.txt 1
unceasingly	NotreDame_De_Paris.txt 2
unchangeable	NotreDame_De_Paris.txt 1
uncle	NotreDame_De_Paris.txt 3
unclean	NotreDame_De_Paris.txt 1
uncomfortable	NotreDame_De_Paris.txt 1
uncommon	NotreDame_De_Paris.txt 1
unconcern	NotreDame_De_Paris.txt 1
unconquerable	NotreDame_De_Paris.txt 1
unconscious	NotreDame_De_Paris.txt 3
unconsciously	NotreDame_De_Paris.txt 1
uncovered	NotreDame_De_Paris.txt 3
uncovering	NotreDame_De_Paris.txt 1
unde	NotreDame_De_Paris.txt 1
undeceive	NotreDame_De_Paris.txt 1
undeceiveth	NotreDame_De_Paris.txt 1
undecided	NotreDame_De_Paris.txt 3
under	NotreDame_De_Paris.txt 112
undergo	NotreDame_De_Paris.txt 1
undergoes	NotreDame_De_Paris.txt 1
undergoing	NotreDame_De_Paris.txt 1
undergone	NotreDame_De_Paris.txt 1
underground	NotreDame_De_Paris.txt 1
underhand	NotreDame_De_Paris.txt 1
underlings	NotreDame_De_Paris.txt 2
underlying	NotreDame_De_Paris.txt 1
underneath	NotreDame_De_Paris.txt 3
understand	NotreDame_De_Paris.txt 30
understanding	NotreDame_De_Paris.txt 9
understands	NotreDame_De_Paris.txt 3
understood	NotreDame_De_Paris.txt 25
undertake	NotreDame_De_Paris.txt 4
undertaking	NotreDame_De_Paris.txt 1
underwent	NotreDame_De_Paris.txt 1
undid	NotreDame_De_Paris.txt 2
undisturbed	NotreDame_De_Paris.txt 1
undoubtedly	NotreDame_De_Paris.txt 1
undressed	NotreDame_De_Paris.txt 1
undulated	NotreDame_De_Paris.txt 1
undulates	NotreDame_De_Paris.txt 1
undulating	NotreDame_De_Paris.txt 1
undulations	NotreDame_De_Paris.txt 1
une	NotreDame_De_Paris.txt 3
unearth	NotreDame_De_Paris.txt 1
uneasily	NotreDame_De_Paris.txt 3
uneasiness	NotreDame_De_Paris.txt 4
uneasy	NotreDame_De_Paris.txt 10
unemployed	NotreDame_De_Paris.txt 1
unendingly	NotreDame_De_Paris.txt 1
unenforceability	NotreDame_De_Paris.txt 1
unequal	NotreDame_De_Paris.txt 1
uneven	NotreDame_De_Paris.txt 1
unevenness	NotreDame_De_Paris.txt 1
unexpected	NotreDame_De_Paris.txt 8
unfastened	NotreDame_De_Paris.txt 3
unfastening	NotreDame_De_Paris.txt 1
unfold	NotreDame_De_Paris.txt 1
unfolded	NotreDame_De_Paris.txt 1
unfortunate	NotreDame_De_Paris.txt 14
unfortunately	NotreDame_De_Paris.txt 8
unfortunates	NotreDame_De_Paris.txt 1
ungracefully	NotreDame_De_Paris.txt 1
ungrateful	NotreDame_De_Paris.txt 1
unguent	NotreDame_De_Paris.txt 1
unguents	NotreDame_De_Paris.txt 2
unhappiness	NotreDame_De_Paris.txt 6
unhappy	NotreDame_De_Paris.txt 57
unheard	NotreDame_De_Paris.txt 3
unhewn	NotreDame_De_Paris.txt 1
unhitched	NotreDame_De_Paris.txt 1
unhorsed	NotreDame_De_Paris.txt 1
unicorn	NotreDame_De_Paris.txt 1
uniform	NotreDame_De_Paris.txt 7
unintelligible	NotreDame_De_Paris.txt 4
union	NotreDame_De_Paris.txt 2
unique	NotreDame_De_Paris.txt 1
unit	NotreDame_De_Paris.txt 1
unite	NotreDame_De_Paris.txt 1
united	NotreDame_De_Paris.txt 14
unites	NotreDame_De_Paris.txt 1
unity	NotreDame_De_Paris.txt 9
universal	NotreDame_De_Paris.txt 10
universe	NotreDame_De_Paris.txt 5
university	NotreDame_De_Paris.txt 46
unjust	NotreDame_De_Paris.txt 1
unjustly	NotreDame_De_Paris.txt 1
unknown	NotreDame_De_Paris.txt 15
unlace	NotreDame_De_Paris.txt 1
unless	NotreDame_De_Paris.txt 14
unlettered	NotreDame_De_Paris.txt 1
unlike	NotreDame_De_Paris.txt 1
unlink	NotreDame_De_Paris.txt 1
unlocked	NotreDame_De_Paris.txt 1
unloose	NotreDame_De_Paris.txt 1
unloosed	NotreDame_De_Paris.txt 2
unlucky	NotreDame_De_Paris.txt 7
unmercifully	NotreDame_De_Paris.txt 1
unnecessary	NotreDame_De_Paris.txt 2
unnoticed	NotreDame_De_Paris.txt 1
unpaved	NotreDame_De_Paris.txt 3
unpleasant	NotreDame_De_Paris.txt 2
unpopularity	NotreDame_De_Paris.txt 2
unprecedented	NotreDame_De_Paris.txt 1
unpublished	NotreDame_De_Paris.txt 1
unpunished	NotreDame_De_Paris.txt 1
unravelling	NotreDame_De_Paris.txt 1
unreasonable	NotreDame_De_Paris.txt 2
unrelenting	NotreDame_De_Paris.txt 1
unrhymed	NotreDame_De_Paris.txt 1
unrivalled	NotreDame_De_Paris.txt 1
unrolled	NotreDame_De_Paris.txt 1
unrolling	NotreDame_De_Paris.txt 1
unseasonable	NotreDame_De_Paris.txt 1
unshapely	NotreDame_De_Paris.txt 1
unsheathed	NotreDame_De_Paris.txt 1
unsolicited	NotreDame_De_Paris.txt 1
unspeakable	NotreDame_De_Paris.txt 2
unsuccessful	NotreDame_De_Paris.txt 1
unsuitable	NotreDame_De_Paris.txt 1
untamed	NotreDame_De_Paris.txt 1
untied	NotreDame_De_Paris.txt 2
until	NotreDame_De_Paris.txt 30
untoward	NotreDame_De_Paris.txt 1
untwined	NotreDame_De_Paris.txt 1
unum	NotreDame_De_Paris.txt 1
unusual	NotreDame_De_Paris.txt 1
unuttered	NotreDame_De_Paris.txt 1
unwieldy	NotreDame_De_Paris.txt 1
unwilling	NotreDame_De_Paris.txt 1
unwinding	NotreDame_De_Paris.txt 1
unwonted	NotreDame_De_Paris.txt 1
unyielding	NotreDame_De_Paris.txt 1
unzains	NotreDame_De_Paris.txt 3
up	NotreDame_De_Paris.txt 236
updated	NotreDame_De_Paris.txt 1
uplifted	NotreDame_De_Paris.txt 2
upon	NotreDame_De_Paris.txt 430
upper	NotreDame_De_Paris.txt 23
upright	NotreDame_De_Paris.txt 9
uprights	NotreDame_De_Paris.txt 1
uproar	NotreDame_De_Paris.txt 16
uprooted	NotreDame_De_Paris.txt 1
upset	NotreDame_De_Paris.txt 4
upsets	NotreDame_De_Paris.txt 1
upstairs	NotreDame_De_Paris.txt 2
upward	NotreDame_De_Paris.txt 1
upwards	NotreDame_De_Paris.txt 4
urania	NotreDame_De_Paris.txt 1
urcens	NotreDame_De_Paris.txt 1
urchins	NotreDame_De_Paris.txt 2
urge	NotreDame_De_Paris.txt 1
urged	NotreDame_De_Paris.txt 1
urgently	NotreDame_De_Paris.txt 1
urging	NotreDame_De_Paris.txt 2
ursins	NotreDame_De_Paris.txt 2
us	NotreDame_De_Paris.txt 148
usage	NotreDame_De_Paris.txt 2
use	NotreDame_De_Paris.txt 25
used	NotreDame_De_Paris.txt 11
useless	NotreDame_De_Paris.txt 9
uselessness	NotreDame_De_Paris.txt 1
user	NotreDame_De_Paris.txt 3
usher	NotreDame_De_Paris.txt 15
using	NotreDame_De_Paris.txt 5
usque	NotreDame_De_Paris.txt 1
usual	NotreDame_De_Paris.txt 8
usually	NotreDame_De_Paris.txt 2
ut	NotreDame_De_Paris.txt 3
utensils	NotreDame_De_Paris.txt 5
utility	NotreDame_De_Paris.txt 2
utmost	NotreDame_De_Paris.txt 1
utrecht	NotreDame_De_Paris.txt 1
utter	NotreDame_De_Paris.txt 11
utterance	NotreDame_De_Paris.txt 1
uttered	NotreDame_De_Paris.txt 33
uttering	NotreDame_De_Paris.txt 14
utterly	NotreDame_De_Paris.txt 9
