o	Miserables.txt 203
oak	Miserables.txt 4
oaks	Miserables.txt 2
oars	Miserables.txt 2
oath	Miserables.txt 12
oaths	Miserables.txt 6
oats	Miserables.txt 8
obduracy	Miserables.txt 2
obedience	Miserables.txt 28
obedient	Miserables.txt 1
obedientia	Miserables.txt 1
obeissais	Miserables.txt 1
obey	Miserables.txt 13
obeyed	Miserables.txt 27
obeying	Miserables.txt 6
obeys	Miserables.txt 4
obit	Miserables.txt 1
object	Miserables.txt 62
objected	Miserables.txt 2
objection	Miserables.txt 8
objections	Miserables.txt 10
objectless	Miserables.txt 3
objects	Miserables.txt 16
oblationem	Miserables.txt 1
obligation	Miserables.txt 1
obligations	Miserables.txt 1
obligatory	Miserables.txt 2
obliged	Miserables.txt 81
obligingly	Miserables.txt 1
oblique	Miserables.txt 3
obliterate	Miserables.txt 1
obliterated	Miserables.txt 3
obliteration	Miserables.txt 7
oblivion	Miserables.txt 6
oblivisci	Miserables.txt 1
oblong	Miserables.txt 6
obregon	Miserables.txt 1
obscene	Miserables.txt 3
obscenities	Miserables.txt 1
obscenity	Miserables.txt 1
obscure	Miserables.txt 65
obscured	Miserables.txt 4
obscurely	Miserables.txt 4
obscurest	Miserables.txt 1
obscurities	Miserables.txt 4
obscurity	Miserables.txt 53
obscurum	Miserables.txt 3
observable	Miserables.txt 1
observation	Miserables.txt 14
observations	Miserables.txt 3
observatoire	Miserables.txt 3
observatory	Miserables.txt 3
observe	Miserables.txt 13
observed	Miserables.txt 58
observer	Miserables.txt 14
observers	Miserables.txt 1
observes	Miserables.txt 4
observing	Miserables.txt 9
obsession	Miserables.txt 1
obsessions	Miserables.txt 1
obsolete	Miserables.txt 3
obstacle	Miserables.txt 19
obstacles	Miserables.txt 8
obstinacy	Miserables.txt 6
obstinate	Miserables.txt 9
obstinately	Miserables.txt 6
obstruct	Miserables.txt 1
obstructed	Miserables.txt 4
obstructions	Miserables.txt 1
obtain	Miserables.txt 18
obtaine	Miserables.txt 1
obtained	Miserables.txt 15
obtaining	Miserables.txt 6
obtains	Miserables.txt 1
obtuse	Miserables.txt 1
obverse	Miserables.txt 2
obviate	Miserables.txt 1
obviates	Miserables.txt 1
obvious	Miserables.txt 2
obviously	Miserables.txt 4
occasion	Miserables.txt 87
occasional	Miserables.txt 1
occasionally	Miserables.txt 14
occasioned	Miserables.txt 2
occasions	Miserables.txt 18
occident	Miserables.txt 2
occult	Miserables.txt 4
occupant	Miserables.txt 2
occupants	Miserables.txt 1
occupation	Miserables.txt 8
occupations	Miserables.txt 3
occupied	Miserables.txt 57
occupies	Miserables.txt 2
occupy	Miserables.txt 11
occupying	Miserables.txt 4
occur	Miserables.txt 18
occurred	Miserables.txt 52
occurrence	Miserables.txt 4
occurrences	Miserables.txt 1
occurring	Miserables.txt 2
occurs	Miserables.txt 3
ocean	Miserables.txt 18
oceans	Miserables.txt 1
ochlocracy	Miserables.txt 3
ochre	Miserables.txt 2
octagonal	Miserables.txt 1
octavius	Miserables.txt 1
octavo	Miserables.txt 1
october	Miserables.txt 10
octogenarian	Miserables.txt 6
octogenarians	Miserables.txt 1
octogenaries	Miserables.txt 1
odalisque	Miserables.txt 1
odalisques	Miserables.txt 1
odd	Miserables.txt 23
oddity	Miserables.txt 2
oddly	Miserables.txt 5
odeon	Miserables.txt 5
odes	Miserables.txt 1
odeur	Miserables.txt 1
odious	Miserables.txt 8
odor	Miserables.txt 24
odorless	Miserables.txt 1
odors	Miserables.txt 2
odry	Miserables.txt 1
oeil	Miserables.txt 2
of	Miserables.txt 19950
off	Miserables.txt 305
offence	Miserables.txt 12
offences	Miserables.txt 2
offended	Miserables.txt 2
offender	Miserables.txt 3
offends	Miserables.txt 1
offensive	Miserables.txt 2
offer	Miserables.txt 31
offered	Miserables.txt 46
offering	Miserables.txt 15
offerings	Miserables.txt 1
offers	Miserables.txt 15
office	Miserables.txt 41
officer	Miserables.txt 54
officers	Miserables.txt 21
offices	Miserables.txt 10
official	Miserables.txt 22
officially	Miserables.txt 1
officials	Miserables.txt 2
officiated	Miserables.txt 2
officiating	Miserables.txt 4
officious	Miserables.txt 2
offset	Miserables.txt 1
offshoot	Miserables.txt 1
often	Miserables.txt 104
oftener	Miserables.txt 2
oftenest	Miserables.txt 1
og	Miserables.txt 2
ogibewas	Miserables.txt 1
ogle	Miserables.txt 1
ogling	Miserables.txt 2
ogre	Miserables.txt 3
ogrepines	Miserables.txt 1
ogress	Miserables.txt 1
oh	Miserables.txt 159
ohain	Miserables.txt 12
ohe	Miserables.txt 1
oheee	Miserables.txt 1
oil	Miserables.txt 8
oiled	Miserables.txt 2
oils	Miserables.txt 1
oily	Miserables.txt 1
oise	Miserables.txt 3
oiseau	Miserables.txt 3
ojos	Miserables.txt 1
old	Miserables.txt 886
olden	Miserables.txt 8
older	Miserables.txt 9
oldest	Miserables.txt 2
oldish	Miserables.txt 1
oligarchies	Miserables.txt 1
olivateurs	Miserables.txt 1
olive	Miserables.txt 4
ollioules	Miserables.txt 1
olympian	Miserables.txt 1
olympie	Miserables.txt 1
olympus	Miserables.txt 6
ombre	Miserables.txt 2
ominous	Miserables.txt 1
omissions	Miserables.txt 1
omit	Miserables.txt 8
omitted	Miserables.txt 4
omitting	Miserables.txt 1
omnibus	Miserables.txt 16
omnibuses	Miserables.txt 3
omnipotence	Miserables.txt 3
omnipotent	Miserables.txt 1
ompteda	Miserables.txt 2
on	Miserables.txt 4473
once	Miserables.txt 485
one	Miserables.txt 3347
onerous	Miserables.txt 1
ones	Miserables.txt 37
oneself	Miserables.txt 22
onions	Miserables.txt 1
onkelos	Miserables.txt 1
online	Miserables.txt 4
onlooker	Miserables.txt 1
only	Miserables.txt 784
onomatopoeia	Miserables.txt 1
onset	Miserables.txt 1
onsets	Miserables.txt 1
onslaught	Miserables.txt 1
ont	Miserables.txt 3
onte	Miserables.txt 1
onward	Miserables.txt 5
onwards	Miserables.txt 1
ooze	Miserables.txt 6
oozing	Miserables.txt 2
opaca	Miserables.txt 1
opacities	Miserables.txt 1
opacity	Miserables.txt 1
opaque	Miserables.txt 3
opaqueness	Miserables.txt 2
open	Miserables.txt 237
opened	Miserables.txt 220
openhearted	Miserables.txt 1
opening	Miserables.txt 64
openings	Miserables.txt 10
opens	Miserables.txt 17
openwork	Miserables.txt 1
opera	Miserables.txt 11
operated	Miserables.txt 3
operating	Miserables.txt 1
operation	Miserables.txt 12
operations	Miserables.txt 4
ophelia	Miserables.txt 1
opheltios	Miserables.txt 1
opiates	Miserables.txt 1
opinion	Miserables.txt 29
opinions	Miserables.txt 26
opium	Miserables.txt 1
opoponach	Miserables.txt 1
opponent	Miserables.txt 3
opportune	Miserables.txt 2
opportunely	Miserables.txt 5
opportunities	Miserables.txt 5
opportunity	Miserables.txt 20
oppose	Miserables.txt 9
opposed	Miserables.txt 7
opposing	Miserables.txt 2
opposite	Miserables.txt 51
opposites	Miserables.txt 1
opposition	Miserables.txt 8
oppositions	Miserables.txt 1
oppress	Miserables.txt 1
oppressed	Miserables.txt 7
oppresses	Miserables.txt 1
oppression	Miserables.txt 7
oppressions	Miserables.txt 1
oppressive	Miserables.txt 1
oppressor	Miserables.txt 1
opprobrium	Miserables.txt 3
optical	Miserables.txt 4
optimism	Miserables.txt 1
opulence	Miserables.txt 4
opulent	Miserables.txt 5
or	Miserables.txt 965
oracle	Miserables.txt 4
oracles	Miserables.txt 3
orange	Miserables.txt 8
orare	Miserables.txt 2
oration	Miserables.txt 4
oratoire	Miserables.txt 1
orator	Miserables.txt 5
oratorical	Miserables.txt 1
oratorie	Miserables.txt 1
orators	Miserables.txt 2
oratory	Miserables.txt 16
orbi	Miserables.txt 1
orbis	Miserables.txt 2
orbits	Miserables.txt 1
orchard	Miserables.txt 18
orchards	Miserables.txt 1
ordained	Miserables.txt 6
orde	Miserables.txt 1
order	Miserables.txt 318
ordered	Miserables.txt 15
ordering	Miserables.txt 2
orderly	Miserables.txt 2
orders	Miserables.txt 45
ordinance	Miserables.txt 1
ordinances	Miserables.txt 2
ordinarily	Miserables.txt 9
ordinary	Miserables.txt 23
ordnance	Miserables.txt 3
orestes	Miserables.txt 3
orfevres	Miserables.txt 1
orfila	Miserables.txt 2
org	Miserables.txt 13
organ	Miserables.txt 4
organic	Miserables.txt 2
organism	Miserables.txt 1
organization	Miserables.txt 4
organizations	Miserables.txt 2
organize	Miserables.txt 1
organized	Miserables.txt 8
organizing	Miserables.txt 1
organs	Miserables.txt 3
orgies	Miserables.txt 1
orgue	Miserables.txt 2
orgueil	Miserables.txt 1
orgues	Miserables.txt 1
orgy	Miserables.txt 2
orient	Miserables.txt 7
oriental	Miserables.txt 4
orientalist	Miserables.txt 1
orientation	Miserables.txt 1
orifice	Miserables.txt 3
oriflamme	Miserables.txt 1
origenes	Miserables.txt 1
origin	Miserables.txt 19
original	Miserables.txt 7
originalities	Miserables.txt 1
originality	Miserables.txt 2
originals	Miserables.txt 2
originated	Miserables.txt 1
originator	Miserables.txt 1
originators	Miserables.txt 1
origins	Miserables.txt 1
orion	Miserables.txt 12
orison	Miserables.txt 2
orisons	Miserables.txt 3
orleanist	Miserables.txt 1
orleans	Miserables.txt 10
orme	Miserables.txt 2
ormes	Miserables.txt 1
ornament	Miserables.txt 3
ornamented	Miserables.txt 17
ornamenting	Miserables.txt 2
ornaments	Miserables.txt 2
orphan	Miserables.txt 10
orphaned	Miserables.txt 2
orphans	Miserables.txt 5
orphic	Miserables.txt 1
orsay	Miserables.txt 1
orthodox	Miserables.txt 2
orthodoxy	Miserables.txt 1
orthographer	Miserables.txt 1
orthographical	Miserables.txt 2
orthography	Miserables.txt 8
orviot	Miserables.txt 1
oscar	Miserables.txt 2
oscars	Miserables.txt 2
oscillate	Miserables.txt 1
oscillated	Miserables.txt 4
oscillating	Miserables.txt 1
oscillation	Miserables.txt 3
oscillations	Miserables.txt 2
oses	Miserables.txt 1
osier	Miserables.txt 1
osprey	Miserables.txt 1
ossa	Miserables.txt 1
ossian	Miserables.txt 1
ossified	Miserables.txt 1
ostend	Miserables.txt 1
ostentation	Miserables.txt 3
ostrich	Miserables.txt 1
othello	Miserables.txt 1
other	Miserables.txt 906
others	Miserables.txt 130
otherwise	Miserables.txt 42
otho	Miserables.txt 1
otos	Miserables.txt 1
otrante	Miserables.txt 1
otter	Miserables.txt 1
ottoman	Miserables.txt 2
ou	Miserables.txt 20
oubliettes	Miserables.txt 1
ouen	Miserables.txt 1
ouest	Miserables.txt 12
ouf	Miserables.txt 1
ought	Miserables.txt 53
oumoumie	Miserables.txt 1
ounce	Miserables.txt 1
ounces	Miserables.txt 4
our	Miserables.txt 336
ourang	Miserables.txt 1
ourcine	Miserables.txt 3
ourcq	Miserables.txt 2
ourika	Miserables.txt 1
ours	Miserables.txt 14
ourselves	Miserables.txt 58
out	Miserables.txt 992
outan	Miserables.txt 1
outbreak	Miserables.txt 2
outburst	Miserables.txt 6
outbursts	Miserables.txt 3
outcome	Miserables.txt 6
outcry	Miserables.txt 3
outdated	Miserables.txt 1
outdid	Miserables.txt 2
outdo	Miserables.txt 1
outdoors	Miserables.txt 3
outer	Miserables.txt 18
outfit	Miserables.txt 12
outfits	Miserables.txt 2
outlay	Miserables.txt 1
outlet	Miserables.txt 17
outlets	Miserables.txt 1
outline	Miserables.txt 9
outlined	Miserables.txt 24
outlines	Miserables.txt 10
outlook	Miserables.txt 3
outposts	Miserables.txt 1
outpour	Miserables.txt 1
outpouring	Miserables.txt 1
outrage	Miserables.txt 5
outraged	Miserables.txt 1
outrageous	Miserables.txt 2
outrages	Miserables.txt 1
outraging	Miserables.txt 1
outset	Miserables.txt 2
outside	Miserables.txt 109
outsider	Miserables.txt 1
outskirts	Miserables.txt 2
outspread	Miserables.txt 6
outspreading	Miserables.txt 1
outstretched	Miserables.txt 9
outstripping	Miserables.txt 1
outwardly	Miserables.txt 1
oval	Miserables.txt 2
ovation	Miserables.txt 1
oven	Miserables.txt 2
ovens	Miserables.txt 1
over	Miserables.txt 560
overbalanced	Miserables.txt 1
overboard	Miserables.txt 1
overcame	Miserables.txt 2
overcast	Miserables.txt 2
overcoat	Miserables.txt 3
overcoats	Miserables.txt 1
overcome	Miserables.txt 7
overflow	Miserables.txt 6
overflowed	Miserables.txt 8
overflowing	Miserables.txt 6
overflows	Miserables.txt 2
overfull	Miserables.txt 1
overhead	Miserables.txt 12
overheard	Miserables.txt 7
overhears	Miserables.txt 1
overleaped	Miserables.txt 1
overload	Miserables.txt 1
overpassed	Miserables.txt 1
overpowered	Miserables.txt 3
overpowering	Miserables.txt 2
overseers	Miserables.txt 2
overshadowed	Miserables.txt 2
overshot	Miserables.txt 2
oversight	Miserables.txt 1
overspread	Miserables.txt 2
overstep	Miserables.txt 2
overstepped	Miserables.txt 2
overstepping	Miserables.txt 1
oversteps	Miserables.txt 1
overtake	Miserables.txt 2
overtaken	Miserables.txt 2
overtaking	Miserables.txt 1
overthrew	Miserables.txt 2
overthrow	Miserables.txt 7
overthrowing	Miserables.txt 4
overthrown	Miserables.txt 7
overthrows	Miserables.txt 2
overtopped	Miserables.txt 1
overturn	Miserables.txt 2
overturned	Miserables.txt 12
overturning	Miserables.txt 2
overwhelm	Miserables.txt 4
overwhelmed	Miserables.txt 37
overwhelming	Miserables.txt 6
overwhelms	Miserables.txt 6
owe	Miserables.txt 20
owed	Miserables.txt 25
owen	Miserables.txt 1
owes	Miserables.txt 6
owing	Miserables.txt 5
owl	Miserables.txt 11
owls	Miserables.txt 4
own	Miserables.txt 331
owned	Miserables.txt 12
owner	Miserables.txt 8
owning	Miserables.txt 2
owns	Miserables.txt 5
ox	Miserables.txt 4
oxen	Miserables.txt 1
oxidization	Miserables.txt 1
oxycrat	Miserables.txt 1
oyster	Miserables.txt 7
oysters	Miserables.txt 5
