gable	NotreDame_De_Paris.txt 2
gables	NotreDame_De_Paris.txt 11
gabrielle	NotreDame_De_Paris.txt 2
gadfly	NotreDame_De_Paris.txt 1
gadine	NotreDame_De_Paris.txt 1
gaillard	NotreDame_De_Paris.txt 1
gaillefontaine	NotreDame_De_Paris.txt 7
gain	NotreDame_De_Paris.txt 2
gained	NotreDame_De_Paris.txt 5
gains	NotreDame_De_Paris.txt 1
gala	NotreDame_De_Paris.txt 1
galgal	NotreDame_De_Paris.txt 1
galiache	NotreDame_De_Paris.txt 2
galilee	NotreDame_De_Paris.txt 9
galiot	NotreDame_De_Paris.txt 1
gall	NotreDame_De_Paris.txt 1
gallant	NotreDame_De_Paris.txt 12
gallantly	NotreDame_De_Paris.txt 1
gallantries	NotreDame_De_Paris.txt 1
gallantry	NotreDame_De_Paris.txt 3
galleries	NotreDame_De_Paris.txt 8
gallery	NotreDame_De_Paris.txt 37
galleys	NotreDame_De_Paris.txt 1
gallic	NotreDame_De_Paris.txt 3
gallicane	NotreDame_De_Paris.txt 1
gallop	NotreDame_De_Paris.txt 5
galloping	NotreDame_De_Paris.txt 2
gallows	NotreDame_De_Paris.txt 31
galvanized	NotreDame_De_Paris.txt 1
gambler	NotreDame_De_Paris.txt 2
gamblers	NotreDame_De_Paris.txt 1
gambling	NotreDame_De_Paris.txt 1
gambolling	NotreDame_De_Paris.txt 1
gambols	NotreDame_De_Paris.txt 1
game	NotreDame_De_Paris.txt 8
games	NotreDame_De_Paris.txt 1
gamester	NotreDame_De_Paris.txt 1
gaming	NotreDame_De_Paris.txt 5
gamins	NotreDame_De_Paris.txt 1
gamut	NotreDame_De_Paris.txt 1
gang	NotreDame_De_Paris.txt 1
gant	NotreDame_De_Paris.txt 1
gap	NotreDame_De_Paris.txt 3
gaped	NotreDame_De_Paris.txt 1
gapers	NotreDame_De_Paris.txt 1
gaping	NotreDame_De_Paris.txt 4
gaps	NotreDame_De_Paris.txt 1
garb	NotreDame_De_Paris.txt 3
garde	NotreDame_De_Paris.txt 1
garden	NotreDame_De_Paris.txt 10
gardener	NotreDame_De_Paris.txt 3
gardens	NotreDame_De_Paris.txt 9
gargantua	NotreDame_De_Paris.txt 1
gargle	NotreDame_De_Paris.txt 1
gargoyles	NotreDame_De_Paris.txt 2
garland	NotreDame_De_Paris.txt 1
garlande	NotreDame_De_Paris.txt 1
garlands	NotreDame_De_Paris.txt 2
garlin	NotreDame_De_Paris.txt 1
garment	NotreDame_De_Paris.txt 7
garments	NotreDame_De_Paris.txt 15
garmoise	NotreDame_De_Paris.txt 1
garnished	NotreDame_De_Paris.txt 4
garofolo	NotreDame_De_Paris.txt 1
garret	NotreDame_De_Paris.txt 2
garrison	NotreDame_De_Paris.txt 4
garrisons	NotreDame_De_Paris.txt 1
garroted	NotreDame_De_Paris.txt 1
garrulous	NotreDame_De_Paris.txt 2
gas	NotreDame_De_Paris.txt 1
gate	NotreDame_De_Paris.txt 20
gates	NotreDame_De_Paris.txt 11
gateway	NotreDame_De_Paris.txt 1
gathered	NotreDame_De_Paris.txt 4
gathering	NotreDame_De_Paris.txt 1
gauch	NotreDame_De_Paris.txt 5
gauls	NotreDame_De_Paris.txt 2
gaulti	NotreDame_De_Paris.txt 5
gaunt	NotreDame_De_Paris.txt 3
gauze	NotreDame_De_Paris.txt 4
gave	NotreDame_De_Paris.txt 50
gay	NotreDame_De_Paris.txt 9
gayer	NotreDame_De_Paris.txt 1
gayeties	NotreDame_De_Paris.txt 1
gayety	NotreDame_De_Paris.txt 7
gayly	NotreDame_De_Paris.txt 7
gaze	NotreDame_De_Paris.txt 26
gazed	NotreDame_De_Paris.txt 42
gazelle	NotreDame_De_Paris.txt 1
gazers	NotreDame_De_Paris.txt 1
gazes	NotreDame_De_Paris.txt 3
gazette	NotreDame_De_Paris.txt 1
gazing	NotreDame_De_Paris.txt 29
gbnewby	NotreDame_De_Paris.txt 1
geese	NotreDame_De_Paris.txt 1
gehenna	NotreDame_De_Paris.txt 1
gele	NotreDame_De_Paris.txt 1
genaille	NotreDame_De_Paris.txt 1
gencienne	NotreDame_De_Paris.txt 2
gendarme	NotreDame_De_Paris.txt 10
gendarmeri	NotreDame_De_Paris.txt 1
gendarmes	NotreDame_De_Paris.txt 2
general	NotreDame_De_Paris.txt 31
generalizing	NotreDame_De_Paris.txt 1
generally	NotreDame_De_Paris.txt 8
generals	NotreDame_De_Paris.txt 1
generating	NotreDame_De_Paris.txt 2
generation	NotreDame_De_Paris.txt 2
generations	NotreDame_De_Paris.txt 4
generis	NotreDame_De_Paris.txt 1
generous	NotreDame_De_Paris.txt 2
genesis	NotreDame_De_Paris.txt 1
genest	NotreDame_De_Paris.txt 1
genevi	NotreDame_De_Paris.txt 17
genio	NotreDame_De_Paris.txt 1
genius	NotreDame_De_Paris.txt 16
genoilhac	NotreDame_De_Paris.txt 1
gentilly	NotreDame_De_Paris.txt 2
gentle	NotreDame_De_Paris.txt 15
gentleman	NotreDame_De_Paris.txt 13
gentlemen	NotreDame_De_Paris.txt 25
gentleness	NotreDame_De_Paris.txt 6
gentler	NotreDame_De_Paris.txt 1
gently	NotreDame_De_Paris.txt 20
gentry	NotreDame_De_Paris.txt 1
genuflections	NotreDame_De_Paris.txt 1
genuine	NotreDame_De_Paris.txt 1
geographical	NotreDame_De_Paris.txt 1
geometriam	NotreDame_De_Paris.txt 1
geometrical	NotreDame_De_Paris.txt 9
geometry	NotreDame_De_Paris.txt 3
george	NotreDame_De_Paris.txt 2
gergeole	NotreDame_De_Paris.txt 1
germ	NotreDame_De_Paris.txt 3
germain	NotreDame_De_Paris.txt 22
germaine	NotreDame_De_Paris.txt 1
germainen	NotreDame_De_Paris.txt 1
germaini	NotreDame_De_Paris.txt 1
german	NotreDame_De_Paris.txt 3
germans	NotreDame_De_Paris.txt 2
germany	NotreDame_De_Paris.txt 1
gervais	NotreDame_De_Paris.txt 5
gervaise	NotreDame_De_Paris.txt 29
ges	NotreDame_De_Paris.txt 1
gesticulating	NotreDame_De_Paris.txt 1
gesture	NotreDame_De_Paris.txt 21
gestures	NotreDame_De_Paris.txt 14
get	NotreDame_De_Paris.txt 34
getting	NotreDame_De_Paris.txt 11
gewgaws	NotreDame_De_Paris.txt 1
gheldolf	NotreDame_De_Paris.txt 1
ghent	NotreDame_De_Paris.txt 15
ghost	NotreDame_De_Paris.txt 2
ghosts	NotreDame_De_Paris.txt 1
gi	NotreDame_De_Paris.txt 1
giant	NotreDame_De_Paris.txt 10
gibard	NotreDame_De_Paris.txt 3
gibbet	NotreDame_De_Paris.txt 32
gibbets	NotreDame_De_Paris.txt 7
gibet	NotreDame_De_Paris.txt 1
giborne	NotreDame_De_Paris.txt 4
giddy	NotreDame_De_Paris.txt 3
gieffroy	NotreDame_De_Paris.txt 3
gif	NotreDame_De_Paris.txt 1
giffarde	NotreDame_De_Paris.txt 1
gift	NotreDame_De_Paris.txt 4
gifts	NotreDame_De_Paris.txt 1
gigantic	NotreDame_De_Paris.txt 18
gilbert	NotreDame_De_Paris.txt 2
gilbertus	NotreDame_De_Paris.txt 1
gild	NotreDame_De_Paris.txt 1
gilded	NotreDame_De_Paris.txt 19
gilding	NotreDame_De_Paris.txt 1
gillaume	NotreDame_De_Paris.txt 1
gilles	NotreDame_De_Paris.txt 7
gillet	NotreDame_De_Paris.txt 1
gilt	NotreDame_De_Paris.txt 8
gimlet	NotreDame_De_Paris.txt 1
gimlets	NotreDame_De_Paris.txt 1
girded	NotreDame_De_Paris.txt 1
girdle	NotreDame_De_Paris.txt 11
girdles	NotreDame_De_Paris.txt 1
girl	NotreDame_De_Paris.txt 203
girls	NotreDame_De_Paris.txt 21
gironin	NotreDame_De_Paris.txt 1
girorou	NotreDame_De_Paris.txt 1
gisquette	NotreDame_De_Paris.txt 20
gist	NotreDame_De_Paris.txt 1
give	NotreDame_De_Paris.txt 65
given	NotreDame_De_Paris.txt 43
gives	NotreDame_De_Paris.txt 7
giveth	NotreDame_De_Paris.txt 1
giving	NotreDame_De_Paris.txt 17
glaber	NotreDame_De_Paris.txt 1
glace	NotreDame_De_Paris.txt 1
glacial	NotreDame_De_Paris.txt 6
glad	NotreDame_De_Paris.txt 4
gladly	NotreDame_De_Paris.txt 9
glance	NotreDame_De_Paris.txt 73
glanced	NotreDame_De_Paris.txt 7
glances	NotreDame_De_Paris.txt 16
glancing	NotreDame_De_Paris.txt 4
glare	NotreDame_De_Paris.txt 1
glared	NotreDame_De_Paris.txt 2
glaring	NotreDame_De_Paris.txt 2
glass	NotreDame_De_Paris.txt 32
glasses	NotreDame_De_Paris.txt 4
glassy	NotreDame_De_Paris.txt 1
glatigny	NotreDame_De_Paris.txt 3
glaueini	NotreDame_De_Paris.txt 1
glazed	NotreDame_De_Paris.txt 1
glazier	NotreDame_De_Paris.txt 1
gleam	NotreDame_De_Paris.txt 7
gleamed	NotreDame_De_Paris.txt 8
gleaming	NotreDame_De_Paris.txt 3
gleams	NotreDame_De_Paris.txt 4
glide	NotreDame_De_Paris.txt 3
glided	NotreDame_De_Paris.txt 2
gliding	NotreDame_De_Paris.txt 1
glimpse	NotreDame_De_Paris.txt 8
glistened	NotreDame_De_Paris.txt 1
glittered	NotreDame_De_Paris.txt 6
glittering	NotreDame_De_Paris.txt 6
globe	NotreDame_De_Paris.txt 1
globes	NotreDame_De_Paris.txt 1
gloom	NotreDame_De_Paris.txt 24
gloomiest	NotreDame_De_Paris.txt 1
gloomy	NotreDame_De_Paris.txt 44
gloriette	NotreDame_De_Paris.txt 1
glorification	NotreDame_De_Paris.txt 1
glorious	NotreDame_De_Paris.txt 1
glory	NotreDame_De_Paris.txt 6
glossa	NotreDame_De_Paris.txt 1
glossy	NotreDame_De_Paris.txt 2
glove	NotreDame_De_Paris.txt 1
glowed	NotreDame_De_Paris.txt 1
gloweth	NotreDame_De_Paris.txt 1
glowing	NotreDame_De_Paris.txt 3
glows	NotreDame_De_Paris.txt 1
glued	NotreDame_De_Paris.txt 2
gnash	NotreDame_De_Paris.txt 2
gnashed	NotreDame_De_Paris.txt 5
gnashing	NotreDame_De_Paris.txt 4
gnat	NotreDame_De_Paris.txt 3
gnawed	NotreDame_De_Paris.txt 3
gnawing	NotreDame_De_Paris.txt 1
gnier	NotreDame_De_Paris.txt 2
gnome	NotreDame_De_Paris.txt 4
gnomes	NotreDame_De_Paris.txt 1
go	NotreDame_De_Paris.txt 93
goad	NotreDame_De_Paris.txt 1
goals	NotreDame_De_Paris.txt 1
goat	NotreDame_De_Paris.txt 110
goats	NotreDame_De_Paris.txt 2
gobelins	NotreDame_De_Paris.txt 1
goblet	NotreDame_De_Paris.txt 5
god	NotreDame_De_Paris.txt 115
goddess	NotreDame_De_Paris.txt 1
godfather	NotreDame_De_Paris.txt 1
godin	NotreDame_De_Paris.txt 1
godmother	NotreDame_De_Paris.txt 5
gods	NotreDame_De_Paris.txt 2
goes	NotreDame_De_Paris.txt 8
goguelu	NotreDame_De_Paris.txt 1
going	NotreDame_De_Paris.txt 61
golconda	NotreDame_De_Paris.txt 1
gold	NotreDame_De_Paris.txt 50
golden	NotreDame_De_Paris.txt 28
goldsmith	NotreDame_De_Paris.txt 3
goldsmiths	NotreDame_De_Paris.txt 1
gond	NotreDame_De_Paris.txt 1
gondelaurier	NotreDame_De_Paris.txt 22
gone	NotreDame_De_Paris.txt 12
gonesse	NotreDame_De_Paris.txt 1
good	NotreDame_De_Paris.txt 252
goodly	NotreDame_De_Paris.txt 9
goods	NotreDame_De_Paris.txt 2
goodwives	NotreDame_De_Paris.txt 2
goody	NotreDame_De_Paris.txt 2
gorge	NotreDame_De_Paris.txt 2
gorged	NotreDame_De_Paris.txt 1
gorgerette	NotreDame_De_Paris.txt 2
gorget	NotreDame_De_Paris.txt 3
gorgon	NotreDame_De_Paris.txt 1
gorgons	NotreDame_De_Paris.txt 1
gosling	NotreDame_De_Paris.txt 1
gossip	NotreDame_De_Paris.txt 42
gossiping	NotreDame_De_Paris.txt 1
gossips	NotreDame_De_Paris.txt 3
got	NotreDame_De_Paris.txt 10
gothic	NotreDame_De_Paris.txt 42
goton	NotreDame_De_Paris.txt 1
goujon	NotreDame_De_Paris.txt 1
gourd	NotreDame_De_Paris.txt 1
gout	NotreDame_De_Paris.txt 1
govern	NotreDame_De_Paris.txt 1
governor	NotreDame_De_Paris.txt 5
gown	NotreDame_De_Paris.txt 7
gowns	NotreDame_De_Paris.txt 1
goy	NotreDame_De_Paris.txt 1
goya	NotreDame_De_Paris.txt 1
gr	NotreDame_De_Paris.txt 62
grace	NotreDame_De_Paris.txt 18
graceful	NotreDame_De_Paris.txt 17
gracefully	NotreDame_De_Paris.txt 12
gracious	NotreDame_De_Paris.txt 5
graciously	NotreDame_De_Paris.txt 1
gradation	NotreDame_De_Paris.txt 1
graded	NotreDame_De_Paris.txt 1
grades	NotreDame_De_Paris.txt 1
gradual	NotreDame_De_Paris.txt 1
gradually	NotreDame_De_Paris.txt 15
graduated	NotreDame_De_Paris.txt 1
graft	NotreDame_De_Paris.txt 2
grafting	NotreDame_De_Paris.txt 1
grain	NotreDame_De_Paris.txt 4
grains	NotreDame_De_Paris.txt 1
grammarian	NotreDame_De_Paris.txt 1
gran	NotreDame_De_Paris.txt 1
granary	NotreDame_De_Paris.txt 1
grand	NotreDame_De_Paris.txt 83
grande	NotreDame_De_Paris.txt 1
grandeur	NotreDame_De_Paris.txt 8
grandfather	NotreDame_De_Paris.txt 2
grandiose	NotreDame_De_Paris.txt 1
grandmother	NotreDame_De_Paris.txt 2
grandmothers	NotreDame_De_Paris.txt 1
grandson	NotreDame_De_Paris.txt 1
grange	NotreDame_De_Paris.txt 1
granite	NotreDame_De_Paris.txt 8
grant	NotreDame_De_Paris.txt 2
granted	NotreDame_De_Paris.txt 10
grapes	NotreDame_De_Paris.txt 2
gras	NotreDame_De_Paris.txt 1
grasp	NotreDame_De_Paris.txt 2
grasped	NotreDame_De_Paris.txt 8
grasping	NotreDame_De_Paris.txt 6
grasps	NotreDame_De_Paris.txt 1
grass	NotreDame_De_Paris.txt 4
grasshopper	NotreDame_De_Paris.txt 2
grate	NotreDame_De_Paris.txt 1
grated	NotreDame_De_Paris.txt 2
grateful	NotreDame_De_Paris.txt 1
gratefully	NotreDame_De_Paris.txt 1
gratian	NotreDame_De_Paris.txt 3
gratified	NotreDame_De_Paris.txt 3
gratifying	NotreDame_De_Paris.txt 1
grating	NotreDame_De_Paris.txt 11
gratings	NotreDame_De_Paris.txt 3
gratitude	NotreDame_De_Paris.txt 6
grave	NotreDame_De_Paris.txt 28
graved	NotreDame_De_Paris.txt 1
gravely	NotreDame_De_Paris.txt 12
graven	NotreDame_De_Paris.txt 1
graville	NotreDame_De_Paris.txt 1
gravity	NotreDame_De_Paris.txt 6
gray	NotreDame_De_Paris.txt 23
grayhounds	NotreDame_De_Paris.txt 1
grazed	NotreDame_De_Paris.txt 1
grease	NotreDame_De_Paris.txt 6
greasy	NotreDame_De_Paris.txt 1
great	NotreDame_De_Paris.txt 259
greater	NotreDame_De_Paris.txt 12
greatest	NotreDame_De_Paris.txt 5
greatly	NotreDame_De_Paris.txt 24
greatness	NotreDame_De_Paris.txt 1
greco	NotreDame_De_Paris.txt 2
greece	NotreDame_De_Paris.txt 5
greedy	NotreDame_De_Paris.txt 3
greek	NotreDame_De_Paris.txt 30
green	NotreDame_De_Paris.txt 16
greener	NotreDame_De_Paris.txt 1
greenish	NotreDame_De_Paris.txt 2
greenly	NotreDame_De_Paris.txt 1
greensward	NotreDame_De_Paris.txt 1
greeted	NotreDame_De_Paris.txt 3
greeting	NotreDame_De_Paris.txt 2
gregory	NotreDame_De_Paris.txt 5
grenadiers	NotreDame_De_Paris.txt 1
grenier	NotreDame_De_Paris.txt 2
greve	NotreDame_De_Paris.txt 1
grew	NotreDame_De_Paris.txt 17
gridiron	NotreDame_De_Paris.txt 1
grief	NotreDame_De_Paris.txt 16
grieved	NotreDame_De_Paris.txt 1
grieves	NotreDame_De_Paris.txt 1
grievous	NotreDame_De_Paris.txt 1
griffins	NotreDame_De_Paris.txt 1
grimace	NotreDame_De_Paris.txt 23
grimaces	NotreDame_De_Paris.txt 6
grimacing	NotreDame_De_Paris.txt 2
grimy	NotreDame_De_Paris.txt 1
grin	NotreDame_De_Paris.txt 3
grind	NotreDame_De_Paris.txt 1
gringoire	NotreDame_De_Paris.txt 336
grinning	NotreDame_De_Paris.txt 3
grip	NotreDame_De_Paris.txt 2
grisis	NotreDame_De_Paris.txt 2
gristles	NotreDame_De_Paris.txt 1
groan	NotreDame_De_Paris.txt 2
groaned	NotreDame_De_Paris.txt 1
groaning	NotreDame_De_Paris.txt 2
groans	NotreDame_De_Paris.txt 4
grocer	NotreDame_De_Paris.txt 1
groecum	NotreDame_De_Paris.txt 1
groom	NotreDame_De_Paris.txt 4
grooved	NotreDame_De_Paris.txt 2
groped	NotreDame_De_Paris.txt 3
groping	NotreDame_De_Paris.txt 2
gros	NotreDame_De_Paris.txt 1
gross	NotreDame_De_Paris.txt 3
grossi	NotreDame_De_Paris.txt 1
grotesque	NotreDame_De_Paris.txt 9
grotesquely	NotreDame_De_Paris.txt 1
grotto	NotreDame_De_Paris.txt 2
grouille	NotreDame_De_Paris.txt 4
ground	NotreDame_De_Paris.txt 43
grounds	NotreDame_De_Paris.txt 3
groundwork	NotreDame_De_Paris.txt 1
group	NotreDame_De_Paris.txt 26
grouped	NotreDame_De_Paris.txt 5
grouping	NotreDame_De_Paris.txt 2
groups	NotreDame_De_Paris.txt 12
grow	NotreDame_De_Paris.txt 9
growing	NotreDame_De_Paris.txt 14
growl	NotreDame_De_Paris.txt 2
growled	NotreDame_De_Paris.txt 4
growling	NotreDame_De_Paris.txt 1
grown	NotreDame_De_Paris.txt 18
grows	NotreDame_De_Paris.txt 7
growth	NotreDame_De_Paris.txt 1
grudge	NotreDame_De_Paris.txt 5
gruff	NotreDame_De_Paris.txt 1
grumble	NotreDame_De_Paris.txt 4
grumbled	NotreDame_De_Paris.txt 6
grumbling	NotreDame_De_Paris.txt 2
gruyer	NotreDame_De_Paris.txt 2
guard	NotreDame_De_Paris.txt 20
guarded	NotreDame_De_Paris.txt 5
guardian	NotreDame_De_Paris.txt 8
guardians	NotreDame_De_Paris.txt 1
guardianship	NotreDame_De_Paris.txt 1
guards	NotreDame_De_Paris.txt 1
gudule	NotreDame_De_Paris.txt 22
guebrs	NotreDame_De_Paris.txt 1
guery	NotreDame_De_Paris.txt 1
guests	NotreDame_De_Paris.txt 3
gueule	NotreDame_De_Paris.txt 4
gueux	NotreDame_De_Paris.txt 1
guichard	NotreDame_De_Paris.txt 1
guidance	NotreDame_De_Paris.txt 1
guillaume	NotreDame_De_Paris.txt 44
guillemette	NotreDame_De_Paris.txt 4
guillotine	NotreDame_De_Paris.txt 2
guilty	NotreDame_De_Paris.txt 2
guimpe	NotreDame_De_Paris.txt 1
guise	NotreDame_De_Paris.txt 1
gules	NotreDame_De_Paris.txt 1
gulf	NotreDame_De_Paris.txt 2
gums	NotreDame_De_Paris.txt 2
gurdy	NotreDame_De_Paris.txt 1
gurgites	NotreDame_De_Paris.txt 1
gush	NotreDame_De_Paris.txt 2
gushed	NotreDame_De_Paris.txt 1
gushing	NotreDame_De_Paris.txt 1
gust	NotreDame_De_Paris.txt 2
gustavus	NotreDame_De_Paris.txt 1
gusts	NotreDame_De_Paris.txt 3
gutenberg	NotreDame_De_Paris.txt 97
gutenburg	NotreDame_De_Paris.txt 1
guts	NotreDame_De_Paris.txt 3
gutter	NotreDame_De_Paris.txt 8
gutters	NotreDame_De_Paris.txt 8
guttural	NotreDame_De_Paris.txt 2
guy	NotreDame_De_Paris.txt 1
guybertant	NotreDame_De_Paris.txt 3
guyenne	NotreDame_De_Paris.txt 1
guyon	NotreDame_De_Paris.txt 2
gypsies	NotreDame_De_Paris.txt 23
gypsy	NotreDame_De_Paris.txt 200
gyrations	NotreDame_De_Paris.txt 1
