g	Miserables.txt 13
gabbling	Miserables.txt 1
gable	Miserables.txt 8
gabon	Miserables.txt 1
gabriel	Miserables.txt 1
gag	Miserables.txt 1
gagged	Miserables.txt 1
gagny	Miserables.txt 6
gahisto	Miserables.txt 2
gail	Miserables.txt 1
gaillon	Miserables.txt 2
gails	Miserables.txt 1
gaiment	Miserables.txt 1
gain	Miserables.txt 14
gained	Miserables.txt 14
gaining	Miserables.txt 6
gains	Miserables.txt 4
gait	Miserables.txt 4
gaite	Miserables.txt 1
gaiters	Miserables.txt 3
gaiztoa	Miserables.txt 1
gala	Miserables.txt 1
galatea	Miserables.txt 1
gale	Miserables.txt 6
gales	Miserables.txt 3
galileo	Miserables.txt 1
galiote	Miserables.txt 2
gallais	Miserables.txt 1
galland	Miserables.txt 1
gallant	Miserables.txt 8
gallantry	Miserables.txt 4
gallega	Miserables.txt 1
galleries	Miserables.txt 10
gallery	Miserables.txt 19
galley	Miserables.txt 26
galleys	Miserables.txt 114
gallic	Miserables.txt 5
gallican	Miserables.txt 1
gallicized	Miserables.txt 1
galloons	Miserables.txt 2
gallop	Miserables.txt 16
galloped	Miserables.txt 3
galloping	Miserables.txt 2
gallops	Miserables.txt 2
gallows	Miserables.txt 3
galvanic	Miserables.txt 2
gamacho	Miserables.txt 1
gamble	Miserables.txt 1
gambled	Miserables.txt 2
gambler	Miserables.txt 4
gamblers	Miserables.txt 1
game	Miserables.txt 20
games	Miserables.txt 5
gamin	Miserables.txt 64
gaminerie	Miserables.txt 1
gaming	Miserables.txt 2
gamins	Miserables.txt 5
gand	Miserables.txt 1
gang	Miserables.txt 9
gangrene	Miserables.txt 1
gans	Miserables.txt 3
gap	Miserables.txt 5
gaped	Miserables.txt 1
gaping	Miserables.txt 6
gaps	Miserables.txt 3
garat	Miserables.txt 1
garb	Miserables.txt 1
garden	Miserables.txt 238
gardener	Miserables.txt 34
gardeners	Miserables.txt 7
gardening	Miserables.txt 4
gardens	Miserables.txt 26
gare	Miserables.txt 1
gargoyles	Miserables.txt 1
garibaldi	Miserables.txt 3
garlanded	Miserables.txt 3
garlands	Miserables.txt 2
garlic	Miserables.txt 1
garment	Miserables.txt 10
garments	Miserables.txt 24
garnier	Miserables.txt 1
garnish	Miserables.txt 1
garnished	Miserables.txt 4
garniture	Miserables.txt 1
garraud	Miserables.txt 1
garret	Miserables.txt 35
garrets	Miserables.txt 2
garrison	Miserables.txt 10
garroter	Miserables.txt 1
garter	Miserables.txt 9
gas	Miserables.txt 7
gascon	Miserables.txt 1
gashes	Miserables.txt 1
gaspard	Miserables.txt 2
gassendi	Miserables.txt 2
gaster	Miserables.txt 2
gastronomical	Miserables.txt 1
gat	Miserables.txt 1
gatch	Miserables.txt 1
gate	Miserables.txt 72
gates	Miserables.txt 19
gather	Miserables.txt 5
gathered	Miserables.txt 14
gathering	Miserables.txt 1
gathers	Miserables.txt 2
gato	Miserables.txt 1
gaucher	Miserables.txt 1
gaul	Miserables.txt 3
gauls	Miserables.txt 2
gaunt	Miserables.txt 3
gauntness	Miserables.txt 2
gauthier	Miserables.txt 1
gauvain	Miserables.txt 1
gauze	Miserables.txt 1
gave	Miserables.txt 136
gavest	Miserables.txt 1
gavotte	Miserables.txt 1
gavroche	Miserables.txt 321
gay	Miserables.txt 39
gaye	Miserables.txt 1
gayest	Miserables.txt 1
gayeties	Miserables.txt 5
gayety	Miserables.txt 31
gayly	Miserables.txt 12
gaze	Miserables.txt 87
gazed	Miserables.txt 120
gazes	Miserables.txt 12
gazette	Miserables.txt 1
gazettes	Miserables.txt 1
gazing	Miserables.txt 52
gbnewby	Miserables.txt 1
gear	Miserables.txt 1
gearing	Miserables.txt 6
geborand	Miserables.txt 3
ged	Miserables.txt 1
gedeon	Miserables.txt 1
geese	Miserables.txt 2
gehenna	Miserables.txt 1
gelenhausen	Miserables.txt 1
gellius	Miserables.txt 1
gemoniae	Miserables.txt 2
genappe	Miserables.txt 19
gendarme	Miserables.txt 18
gendarmerie	Miserables.txt 2
gendarmes	Miserables.txt 26
general	Miserables.txt 107
generale	Miserables.txt 1
generalissimo	Miserables.txt 3
generally	Miserables.txt 24
generals	Miserables.txt 15
generalship	Miserables.txt 1
generation	Miserables.txt 3
generations	Miserables.txt 6
generic	Miserables.txt 1
generosities	Miserables.txt 1
generosity	Miserables.txt 6
generous	Miserables.txt 25
geneses	Miserables.txt 1
genesis	Miserables.txt 3
genevieve	Miserables.txt 9
genflot	Miserables.txt 5
genga	Miserables.txt 1
genial	Miserables.txt 1
genii	Miserables.txt 1
genius	Miserables.txt 32
geniuses	Miserables.txt 10
genlis	Miserables.txt 5
gennevilliers	Miserables.txt 1
genoa	Miserables.txt 5
genoese	Miserables.txt 1
genrot	Miserables.txt 9
genteel	Miserables.txt 1
gentilles	Miserables.txt 1
gentilly	Miserables.txt 2
gentle	Miserables.txt 69
gentleman	Miserables.txt 73
gentlemen	Miserables.txt 33
gentleness	Miserables.txt 14
gentlest	Miserables.txt 1
gentlewomen	Miserables.txt 1
gently	Miserables.txt 53
genuflection	Miserables.txt 1
genuine	Miserables.txt 14
geoffrey	Miserables.txt 1
geoffroy	Miserables.txt 1
geographical	Miserables.txt 1
geography	Miserables.txt 1
geological	Miserables.txt 1
geologists	Miserables.txt 2
geology	Miserables.txt 1
geometrical	Miserables.txt 8
geometrician	Miserables.txt 1
geometry	Miserables.txt 4
george	Miserables.txt 1
georges	Miserables.txt 8
georgics	Miserables.txt 2
gerard	Miserables.txt 3
geraud	Miserables.txt 1
gerbaud	Miserables.txt 3
gerbe	Miserables.txt 1
gericault	Miserables.txt 1
germ	Miserables.txt 3
germain	Miserables.txt 15
german	Miserables.txt 20
germanic	Miserables.txt 2
germans	Miserables.txt 3
germany	Miserables.txt 16
germinate	Miserables.txt 3
germinating	Miserables.txt 1
germination	Miserables.txt 2
germoniae	Miserables.txt 1
germs	Miserables.txt 2
geronte	Miserables.txt 2
gertrude	Miserables.txt 1
gervais	Miserables.txt 29
gesmas	Miserables.txt 5
gestas	Miserables.txt 2
gestation	Miserables.txt 1
gesticulated	Miserables.txt 2
gesture	Miserables.txt 38
gestures	Miserables.txt 8
get	Miserables.txt 223
gets	Miserables.txt 12
getting	Miserables.txt 47
gewgaw	Miserables.txt 1
gewgaws	Miserables.txt 1
gex	Miserables.txt 1
ghastly	Miserables.txt 1
ghent	Miserables.txt 3
ghetto	Miserables.txt 1
ghi	Miserables.txt 3
ghost	Miserables.txt 2
ghosts	Miserables.txt 3
ghoul	Miserables.txt 2
ghouls	Miserables.txt 1
gialluta	Miserables.txt 1
giant	Miserables.txt 13
giantess	Miserables.txt 3
giants	Miserables.txt 9
gib	Miserables.txt 1
gibbet	Miserables.txt 8
gibbets	Miserables.txt 2
gibbosities	Miserables.txt 1
gibelotte	Miserables.txt 12
gibou	Miserables.txt 1
giddiness	Miserables.txt 7
giddy	Miserables.txt 3
gift	Miserables.txt 6
gifted	Miserables.txt 1
gifts	Miserables.txt 3
gigantic	Miserables.txt 20
gigotmuche	Miserables.txt 1
gil	Miserables.txt 1
gilbert	Miserables.txt 1
gilded	Miserables.txt 19
gilding	Miserables.txt 5
gillenorman	Miserables.txt 1
gillenormand	Miserables.txt 236
gillenormands	Miserables.txt 2
gilles	Miserables.txt 1
gilliflowers	Miserables.txt 1
gills	Miserables.txt 2
gillyflowers	Miserables.txt 1
gilt	Miserables.txt 7
gimlet	Miserables.txt 2
gin	Miserables.txt 1
gindre	Miserables.txt 1
gingerbread	Miserables.txt 1
giraffe	Miserables.txt 1
girandoles	Miserables.txt 1
girdle	Miserables.txt 6
girdles	Miserables.txt 1
girin	Miserables.txt 1
girl	Miserables.txt 225
girlhood	Miserables.txt 1
girls	Miserables.txt 100
girondists	Miserables.txt 1
gisors	Miserables.txt 1
gisquet	Miserables.txt 5
give	Miserables.txt 196
given	Miserables.txt 127
giver	Miserables.txt 1
gives	Miserables.txt 36
giving	Miserables.txt 45
glaces	Miserables.txt 2
glacial	Miserables.txt 10
glacier	Miserables.txt 2
glaciere	Miserables.txt 6
glacis	Miserables.txt 1
glad	Miserables.txt 8
glade	Miserables.txt 4
gladiator	Miserables.txt 3
gladly	Miserables.txt 8
glance	Miserables.txt 161
glanced	Miserables.txt 26
glances	Miserables.txt 22
glancing	Miserables.txt 4
glandeve	Miserables.txt 1
glare	Miserables.txt 5
glared	Miserables.txt 2
glares	Miserables.txt 1
glaris	Miserables.txt 1
glass	Miserables.txt 87
glasses	Miserables.txt 18
glassware	Miserables.txt 1
glassy	Miserables.txt 5
glazed	Miserables.txt 5
glazing	Miserables.txt 1
gleam	Miserables.txt 32
gleamed	Miserables.txt 7
gleamest	Miserables.txt 1
gleaming	Miserables.txt 2
gleams	Miserables.txt 18
gleaned	Miserables.txt 1
glide	Miserables.txt 2
glided	Miserables.txt 8
glides	Miserables.txt 1
gliding	Miserables.txt 6
glimmer	Miserables.txt 2
glimpse	Miserables.txt 48
glimpses	Miserables.txt 12
glistened	Miserables.txt 1
glistening	Miserables.txt 1
glitter	Miserables.txt 1
glittered	Miserables.txt 4
glittering	Miserables.txt 7
gloaming	Miserables.txt 1
gloating	Miserables.txt 1
globe	Miserables.txt 11
globes	Miserables.txt 1
gloire	Miserables.txt 2
gloom	Miserables.txt 63
gloomily	Miserables.txt 2
gloomy	Miserables.txt 104
glories	Miserables.txt 1
glorieux	Miserables.txt 2
glorification	Miserables.txt 2
glorified	Miserables.txt 1
glorify	Miserables.txt 1
glorifying	Miserables.txt 3
glorious	Miserables.txt 4
gloriously	Miserables.txt 1
glory	Miserables.txt 46
gloss	Miserables.txt 1
glove	Miserables.txt 1
gloved	Miserables.txt 1
gloves	Miserables.txt 9
glow	Miserables.txt 18
glowing	Miserables.txt 11
glows	Miserables.txt 1
glowworm	Miserables.txt 1
glued	Miserables.txt 4
glum	Miserables.txt 1
glut	Miserables.txt 1
glutton	Miserables.txt 1
gluttony	Miserables.txt 3
gnarled	Miserables.txt 1
gnash	Miserables.txt 1
gnashes	Miserables.txt 1
gnashing	Miserables.txt 2
gnat	Miserables.txt 2
gnats	Miserables.txt 1
gnaw	Miserables.txt 4
gnawed	Miserables.txt 3
gnawing	Miserables.txt 5
gnaws	Miserables.txt 2
gnon	Miserables.txt 1
go	Miserables.txt 455
goal	Miserables.txt 15
goals	Miserables.txt 1
goat	Miserables.txt 7
goats	Miserables.txt 1
gobble	Miserables.txt 1
gobbled	Miserables.txt 1
gobelins	Miserables.txt 8
goblet	Miserables.txt 4
goblin	Miserables.txt 2
goblins	Miserables.txt 2
god	Miserables.txt 359
goddess	Miserables.txt 6
goddesses	Miserables.txt 1
gods	Miserables.txt 11
godsend	Miserables.txt 3
goes	Miserables.txt 56
goeth	Miserables.txt 1
goethe	Miserables.txt 1
goff	Miserables.txt 1
goffeur	Miserables.txt 1
goguettes	Miserables.txt 1
going	Miserables.txt 296
goings	Miserables.txt 3
gold	Miserables.txt 60
golden	Miserables.txt 18
goldfinch	Miserables.txt 1
goldsmith	Miserables.txt 1
goliath	Miserables.txt 2
gomicourt	Miserables.txt 1
gonaguet	Miserables.txt 1
gondolas	Miserables.txt 1
gondren	Miserables.txt 2
gone	Miserables.txt 102
gonesse	Miserables.txt 1
goo	Miserables.txt 1
good	Miserables.txt 801
goodman	Miserables.txt 24
goodmen	Miserables.txt 1
goodness	Miserables.txt 27
goods	Miserables.txt 7
goodwives	Miserables.txt 2
goody	Miserables.txt 2
goose	Miserables.txt 5
gooseberry	Miserables.txt 1
gorbeau	Miserables.txt 30
gordon	Miserables.txt 2
gored	Miserables.txt 1
gorge	Miserables.txt 5
gorges	Miserables.txt 3
gorget	Miserables.txt 1
gorgon	Miserables.txt 1
gormandize	Miserables.txt 1
gormandizer	Miserables.txt 1
gospel	Miserables.txt 4
gosselies	Miserables.txt 1
gossip	Miserables.txt 8
gossiped	Miserables.txt 2
gossiping	Miserables.txt 1
gossips	Miserables.txt 6
got	Miserables.txt 71
gothic	Miserables.txt 5
goujon	Miserables.txt 1
gourd	Miserables.txt 1
gourdes	Miserables.txt 1
gourgaud	Miserables.txt 1
gournay	Miserables.txt 2
gourney	Miserables.txt 1
gousset	Miserables.txt 1
gouty	Miserables.txt 5
gouvion	Miserables.txt 1
govern	Miserables.txt 2
governed	Miserables.txt 4
governing	Miserables.txt 4
government	Miserables.txt 56
governmentalism	Miserables.txt 1
governmentalist	Miserables.txt 1
governments	Miserables.txt 2
governors	Miserables.txt 1
governs	Miserables.txt 3
gown	Miserables.txt 40
gowns	Miserables.txt 4
gozzi	Miserables.txt 1
gracchi	Miserables.txt 1
gracchos	Miserables.txt 1
gracchus	Miserables.txt 2
grace	Miserables.txt 42
graceful	Miserables.txt 18
gracefully	Miserables.txt 1
graces	Miserables.txt 6
gracieuse	Miserables.txt 1
gracious	Miserables.txt 8
graciously	Miserables.txt 2
grade	Miserables.txt 2
gradually	Miserables.txt 43
graduate	Miserables.txt 1
graduated	Miserables.txt 1
graeculus	Miserables.txt 1
graft	Miserables.txt 2
grafted	Miserables.txt 2
grafting	Miserables.txt 2
grafts	Miserables.txt 1
grain	Miserables.txt 12
grains	Miserables.txt 4
grammar	Miserables.txt 4
grammarian	Miserables.txt 1
grammars	Miserables.txt 1
gramont	Miserables.txt 2
granary	Miserables.txt 3
grand	Miserables.txt 147
grandchild	Miserables.txt 1
grandchildren	Miserables.txt 1
grande	Miserables.txt 3
grander	Miserables.txt 6
grandest	Miserables.txt 2
grandeur	Miserables.txt 26
grandeurs	Miserables.txt 5
grandfather	Miserables.txt 135
grandfathers	Miserables.txt 1
grandiose	Miserables.txt 6
grandioseness	Miserables.txt 1
grandly	Miserables.txt 1
grandmother	Miserables.txt 3
grandmothers	Miserables.txt 3
grandnephew	Miserables.txt 6
grandpapa	Miserables.txt 1
grands	Miserables.txt 1
grandsire	Miserables.txt 1
grandsires	Miserables.txt 1
grandson	Miserables.txt 20
granduncle	Miserables.txt 1
grange	Miserables.txt 2
granite	Miserables.txt 16
granmont	Miserables.txt 1
grant	Miserables.txt 14
grantaire	Miserables.txt 85
granted	Miserables.txt 15
granting	Miserables.txt 2
grants	Miserables.txt 3
grape	Miserables.txt 47
grapes	Miserables.txt 6
grappling	Miserables.txt 1
gras	Miserables.txt 5
grase	Miserables.txt 1
grasp	Miserables.txt 25
grasped	Miserables.txt 37
grasping	Miserables.txt 6
grasps	Miserables.txt 1
grass	Miserables.txt 53
grasse	Miserables.txt 4
grasses	Miserables.txt 3
grasshoppers	Miserables.txt 1
grassy	Miserables.txt 1
grated	Miserables.txt 21
grateful	Miserables.txt 7
gratefully	Miserables.txt 1
gratia	Miserables.txt 1
gratified	Miserables.txt 1
grating	Miserables.txt 54
gratings	Miserables.txt 11
gratis	Miserables.txt 5
gratitude	Miserables.txt 19
gratuitous	Miserables.txt 4
gratuitously	Miserables.txt 4
gratuity	Miserables.txt 1
grave	Miserables.txt 173
gravely	Miserables.txt 14
graven	Miserables.txt 1
graves	Miserables.txt 6
gravest	Miserables.txt 3
gravilliers	Miserables.txt 1
graving	Miserables.txt 1
gravitate	Miserables.txt 1
gravitated	Miserables.txt 1
gravitates	Miserables.txt 1
gravitation	Miserables.txt 1
gravitations	Miserables.txt 1
gravity	Miserables.txt 20
gray	Miserables.txt 50
grayish	Miserables.txt 2
grays	Miserables.txt 3
graze	Miserables.txt 1
grazed	Miserables.txt 2
grease	Miserables.txt 1
greased	Miserables.txt 1
greasing	Miserables.txt 1
greasy	Miserables.txt 1
great	Miserables.txt 512
greatcoats	Miserables.txt 1
greater	Miserables.txt 29
greatest	Miserables.txt 17
greatly	Miserables.txt 50
greatness	Miserables.txt 7
greatnesses	Miserables.txt 1
grecian	Miserables.txt 1
greece	Miserables.txt 13
greedy	Miserables.txt 5
greek	Miserables.txt 14
greeks	Miserables.txt 2
green	Miserables.txt 66
greenhorn	Miserables.txt 4
greenhorns	Miserables.txt 1
greenhouse	Miserables.txt 1
greenies	Miserables.txt 1
greenish	Miserables.txt 1
greens	Miserables.txt 1
greeted	Miserables.txt 2
greeting	Miserables.txt 1
gregoire	Miserables.txt 2
gregorian	Miserables.txt 1
gregory	Miserables.txt 3
grelotte	Miserables.txt 1
grenades	Miserables.txt 1
grenadier	Miserables.txt 6
grenadiers	Miserables.txt 9
grenelle	Miserables.txt 5
grenetat	Miserables.txt 2
grenier	Miserables.txt 3
grenoble	Miserables.txt 4
gres	Miserables.txt 3
greuze	Miserables.txt 2
greve	Miserables.txt 10
grew	Miserables.txt 53
gribeauval	Miserables.txt 2
gribier	Miserables.txt 10
grief	Miserables.txt 24
griefs	Miserables.txt 5
grievance	Miserables.txt 1
grievances	Miserables.txt 2
grieve	Miserables.txt 1
grieved	Miserables.txt 4
griffin	Miserables.txt 3
griffs	Miserables.txt 1
grilles	Miserables.txt 1
grim	Miserables.txt 1
grimace	Miserables.txt 12
grimaced	Miserables.txt 1
grimacer	Miserables.txt 2
grimaces	Miserables.txt 5
grimod	Miserables.txt 2
grin	Miserables.txt 3
grind	Miserables.txt 1
grinder	Miserables.txt 3
grinders	Miserables.txt 1
grinding	Miserables.txt 4
grinned	Miserables.txt 2
grinning	Miserables.txt 1
grins	Miserables.txt 3
grip	Miserables.txt 3
grips	Miserables.txt 1
gris	Miserables.txt 1
griserait	Miserables.txt 1
grisette	Miserables.txt 8
grisettes	Miserables.txt 4
grives	Miserables.txt 1
grkztntgzyal	Miserables.txt 1
groan	Miserables.txt 3
groaning	Miserables.txt 3
groanings	Miserables.txt 1
groans	Miserables.txt 6
grocer	Miserables.txt 3
groenendael	Miserables.txt 1
groentendael	Miserables.txt 1
groom	Miserables.txt 1
grooms	Miserables.txt 1
groove	Miserables.txt 2
grooves	Miserables.txt 1
groped	Miserables.txt 6
gropes	Miserables.txt 1
groping	Miserables.txt 6
gropingly	Miserables.txt 2
gropings	Miserables.txt 3
gros	Miserables.txt 4
gross	Miserables.txt 7
grosse	Miserables.txt 1
grossness	Miserables.txt 2
grotesque	Miserables.txt 3
grotesquenesses	Miserables.txt 1
grotte	Miserables.txt 1
grotto	Miserables.txt 5
grottos	Miserables.txt 1
grouchy	Miserables.txt 6
ground	Miserables.txt 140
grounded	Miserables.txt 2
groundfloor	Miserables.txt 1
grounds	Miserables.txt 1
groundswell	Miserables.txt 1
group	Miserables.txt 51
grouped	Miserables.txt 9
groups	Miserables.txt 25
grove	Miserables.txt 4
grow	Miserables.txt 46
growing	Miserables.txt 34
growl	Miserables.txt 4
growled	Miserables.txt 6
growler	Miserables.txt 1
growling	Miserables.txt 2
grown	Miserables.txt 39
grows	Miserables.txt 17
growth	Miserables.txt 15
growths	Miserables.txt 2
grub	Miserables.txt 3
grucheray	Miserables.txt 1
grudge	Miserables.txt 1
gruff	Miserables.txt 2
gruffly	Miserables.txt 1
grumble	Miserables.txt 3
grumbled	Miserables.txt 17
grumblers	Miserables.txt 1
grumbling	Miserables.txt 4
grumblingly	Miserables.txt 1
grurin	Miserables.txt 3
guano	Miserables.txt 2
guarantee	Miserables.txt 4
guarantees	Miserables.txt 4
guard	Miserables.txt 120
guarded	Miserables.txt 20
guardian	Miserables.txt 8
guarding	Miserables.txt 7
guards	Miserables.txt 38
guardsman	Miserables.txt 8
guardsmen	Miserables.txt 11
gue	Miserables.txt 1
guedouze	Miserables.txt 1
guelemer	Miserables.txt 22
guemenee	Miserables.txt 1
guenn	Miserables.txt 1
guerilleros	Miserables.txt 1
guerin	Miserables.txt 1
guerre	Miserables.txt 2
guess	Miserables.txt 6
guessed	Miserables.txt 6
guest	Miserables.txt 5
guests	Miserables.txt 6
gueulemer	Miserables.txt 9
gueux	Miserables.txt 2
guibourg	Miserables.txt 1
guicherat	Miserables.txt 1
guide	Miserables.txt 26
guided	Miserables.txt 5
guides	Miserables.txt 2
guiding	Miserables.txt 1
guidonis	Miserables.txt 2
guignon	Miserables.txt 1
guillaume	Miserables.txt 7
guilleminot	Miserables.txt 2
guillery	Miserables.txt 1
guillons	Miserables.txt 1
guillot	Miserables.txt 1
guillotine	Miserables.txt 15
guillotined	Miserables.txt 1
guilt	Miserables.txt 2
guilty	Miserables.txt 19
guimard	Miserables.txt 2
guimardinette	Miserables.txt 1
guimardini	Miserables.txt 1
guimpe	Miserables.txt 8
guinea	Miserables.txt 1
guipure	Miserables.txt 2
guise	Miserables.txt 8
guitar	Miserables.txt 1
gula	Miserables.txt 1
gulax	Miserables.txt 1
gulf	Miserables.txt 34
gulfs	Miserables.txt 9
gull	Miserables.txt 1
gullet	Miserables.txt 1
gullets	Miserables.txt 1
gullies	Miserables.txt 2
gulnare	Miserables.txt 1
gulped	Miserables.txt 1
gum	Miserables.txt 2
gums	Miserables.txt 3
gun	Miserables.txt 78
gunners	Miserables.txt 1
gunpowder	Miserables.txt 1
guns	Miserables.txt 44
gunshot	Miserables.txt 1
gunsmith	Miserables.txt 1
gunzberg	Miserables.txt 1
gurdy	Miserables.txt 2
gush	Miserables.txt 2
gushing	Miserables.txt 1
gust	Miserables.txt 7
gustave	Miserables.txt 1
gusts	Miserables.txt 8
gut	Miserables.txt 5
gutenberg	Miserables.txt 93
gutter	Miserables.txt 17
gutters	Miserables.txt 4
guttural	Miserables.txt 2
guy	Miserables.txt 3
guyon	Miserables.txt 2
guyot	Miserables.txt 1
gymnast	Miserables.txt 1
gymnastics	Miserables.txt 1
gymnastoras	Miserables.txt 1
gyrations	Miserables.txt 1
