d	NotreDame_De_Paris.txt 52
dactyl	NotreDame_De_Paris.txt 1
dados	NotreDame_De_Paris.txt 1
daedalus	NotreDame_De_Paris.txt 4
daemonum	NotreDame_De_Paris.txt 1
dagger	NotreDame_De_Paris.txt 11
daggers	NotreDame_De_Paris.txt 5
dagobert	NotreDame_De_Paris.txt 1
dahuille	NotreDame_De_Paris.txt 1
daily	NotreDame_De_Paris.txt 1
daim	NotreDame_De_Paris.txt 6
dainties	NotreDame_De_Paris.txt 1
daintiness	NotreDame_De_Paris.txt 2
dainty	NotreDame_De_Paris.txt 3
dais	NotreDame_De_Paris.txt 4
daisies	NotreDame_De_Paris.txt 1
daisy	NotreDame_De_Paris.txt 3
daiz	NotreDame_De_Paris.txt 1
dalmatics	NotreDame_De_Paris.txt 1
damage	NotreDame_De_Paris.txt 3
damaged	NotreDame_De_Paris.txt 1
damages	NotreDame_De_Paris.txt 5
damascened	NotreDame_De_Paris.txt 1
damask	NotreDame_De_Paris.txt 5
dame	NotreDame_De_Paris.txt 177
dames	NotreDame_De_Paris.txt 5
dammed	NotreDame_De_Paris.txt 1
damn	NotreDame_De_Paris.txt 1
damnable	NotreDame_De_Paris.txt 1
damnation	NotreDame_De_Paris.txt 5
damned	NotreDame_De_Paris.txt 8
damoiselle	NotreDame_De_Paris.txt 6
damoiselles	NotreDame_De_Paris.txt 2
damp	NotreDame_De_Paris.txt 2
dampmartin	NotreDame_De_Paris.txt 1
dampness	NotreDame_De_Paris.txt 2
damsel	NotreDame_De_Paris.txt 6
damsels	NotreDame_De_Paris.txt 9
dance	NotreDame_De_Paris.txt 15
danced	NotreDame_De_Paris.txt 5
dancer	NotreDame_De_Paris.txt 29
dances	NotreDame_De_Paris.txt 4
dancing	NotreDame_De_Paris.txt 14
dand	NotreDame_De_Paris.txt 1
danger	NotreDame_De_Paris.txt 5
dangers	NotreDame_De_Paris.txt 2
dangling	NotreDame_De_Paris.txt 2
dans	NotreDame_De_Paris.txt 1
dante	NotreDame_De_Paris.txt 5
dapifero	NotreDame_De_Paris.txt 1
dappled	NotreDame_De_Paris.txt 1
dare	NotreDame_De_Paris.txt 7
dared	NotreDame_De_Paris.txt 18
dares	NotreDame_De_Paris.txt 1
daring	NotreDame_De_Paris.txt 5
dark	NotreDame_De_Paris.txt 44
darkened	NotreDame_De_Paris.txt 1
darkest	NotreDame_De_Paris.txt 2
darkly	NotreDame_De_Paris.txt 1
darkness	NotreDame_De_Paris.txt 23
dart	NotreDame_De_Paris.txt 3
darted	NotreDame_De_Paris.txt 8
darting	NotreDame_De_Paris.txt 1
dash	NotreDame_De_Paris.txt 5
dashed	NotreDame_De_Paris.txt 8
dashes	NotreDame_De_Paris.txt 3
dashing	NotreDame_De_Paris.txt 1
data	NotreDame_De_Paris.txt 1
date	NotreDame_De_Paris.txt 10
dated	NotreDame_De_Paris.txt 2
dates	NotreDame_De_Paris.txt 1
dating	NotreDame_De_Paris.txt 2
datum	NotreDame_De_Paris.txt 1
daub	NotreDame_De_Paris.txt 1
daubed	NotreDame_De_Paris.txt 1
dauby	NotreDame_De_Paris.txt 1
daughter	NotreDame_De_Paris.txt 83
daughters	NotreDame_De_Paris.txt 2
daumesnil	NotreDame_De_Paris.txt 1
dauphin	NotreDame_De_Paris.txt 13
dauphine	NotreDame_De_Paris.txt 2
dauphiness	NotreDame_De_Paris.txt 2
dauphiny	NotreDame_De_Paris.txt 1
dauvet	NotreDame_De_Paris.txt 1
dawn	NotreDame_De_Paris.txt 3
dawning	NotreDame_De_Paris.txt 1
day	NotreDame_De_Paris.txt 249
daybreak	NotreDame_De_Paris.txt 4
daylight	NotreDame_De_Paris.txt 10
days	NotreDame_De_Paris.txt 45
dazed	NotreDame_De_Paris.txt 4
dazzled	NotreDame_De_Paris.txt 6
dazzlement	NotreDame_De_Paris.txt 1
dazzles	NotreDame_De_Paris.txt 1
dazzling	NotreDame_De_Paris.txt 15
de	NotreDame_De_Paris.txt 409
dea	NotreDame_De_Paris.txt 1
deacon	NotreDame_De_Paris.txt 2
deacons	NotreDame_De_Paris.txt 1
dead	NotreDame_De_Paris.txt 61
deaf	NotreDame_De_Paris.txt 76
deafen	NotreDame_De_Paris.txt 2
deafened	NotreDame_De_Paris.txt 1
deafening	NotreDame_De_Paris.txt 5
deafness	NotreDame_De_Paris.txt 6
deal	NotreDame_De_Paris.txt 21
dealer	NotreDame_De_Paris.txt 1
dealing	NotreDame_De_Paris.txt 1
dealings	NotreDame_De_Paris.txt 2
dealt	NotreDame_De_Paris.txt 7
deaneries	NotreDame_De_Paris.txt 1
deans	NotreDame_De_Paris.txt 1
dear	NotreDame_De_Paris.txt 41
dearly	NotreDame_De_Paris.txt 3
death	NotreDame_De_Paris.txt 65
deathblow	NotreDame_De_Paris.txt 1
debacchantis	NotreDame_De_Paris.txt 1
debacchatio	NotreDame_De_Paris.txt 1
debarcation	NotreDame_De_Paris.txt 1
debarring	NotreDame_De_Paris.txt 1
debasements	NotreDame_De_Paris.txt 1
debated	NotreDame_De_Paris.txt 1
debates	NotreDame_De_Paris.txt 1
debauch	NotreDame_De_Paris.txt 1
debauchees	NotreDame_De_Paris.txt 2
debauchery	NotreDame_De_Paris.txt 4
debet	NotreDame_De_Paris.txt 1
debou	NotreDame_De_Paris.txt 2
debouch	NotreDame_De_Paris.txt 1
debouched	NotreDame_De_Paris.txt 3
debt	NotreDame_De_Paris.txt 1
debtor	NotreDame_De_Paris.txt 1
debts	NotreDame_De_Paris.txt 1
decadence	NotreDame_De_Paris.txt 4
decantantur	NotreDame_De_Paris.txt 1
decapitate	NotreDame_De_Paris.txt 1
decay	NotreDame_De_Paris.txt 1
decayed	NotreDame_De_Paris.txt 1
decaying	NotreDame_De_Paris.txt 1
deceased	NotreDame_De_Paris.txt 1
deceive	NotreDame_De_Paris.txt 2
deceived	NotreDame_De_Paris.txt 3
december	NotreDame_De_Paris.txt 1
decent	NotreDame_De_Paris.txt 2
dechiraverunt	NotreDame_De_Paris.txt 1
decide	NotreDame_De_Paris.txt 3
decided	NotreDame_De_Paris.txt 6
decidedly	NotreDame_De_Paris.txt 5
decipher	NotreDame_De_Paris.txt 2
deciphering	NotreDame_De_Paris.txt 1
decision	NotreDame_De_Paris.txt 1
decisions	NotreDame_De_Paris.txt 1
decisive	NotreDame_De_Paris.txt 2
decked	NotreDame_De_Paris.txt 5
declaiming	NotreDame_De_Paris.txt 1
declaration	NotreDame_De_Paris.txt 3
declare	NotreDame_De_Paris.txt 1
declared	NotreDame_De_Paris.txt 2
declaremus	NotreDame_De_Paris.txt 1
declares	NotreDame_De_Paris.txt 1
declaring	NotreDame_De_Paris.txt 1
decline	NotreDame_De_Paris.txt 1
declining	NotreDame_De_Paris.txt 2
decorations	NotreDame_De_Paris.txt 1
decorously	NotreDame_De_Paris.txt 1
decree	NotreDame_De_Paris.txt 8
decrepit	NotreDame_De_Paris.txt 5
decretal	NotreDame_De_Paris.txt 1
decretalists	NotreDame_De_Paris.txt 1
decretals	NotreDame_De_Paris.txt 6
decretists	NotreDame_De_Paris.txt 1
deduced	NotreDame_De_Paris.txt 1
deductible	NotreDame_De_Paris.txt 1
deed	NotreDame_De_Paris.txt 5
deeds	NotreDame_De_Paris.txt 8
deem	NotreDame_De_Paris.txt 1
deemed	NotreDame_De_Paris.txt 1
deep	NotreDame_De_Paris.txt 28
deepen	NotreDame_De_Paris.txt 1
deeper	NotreDame_De_Paris.txt 9
deepest	NotreDame_De_Paris.txt 2
deeply	NotreDame_De_Paris.txt 15
deer	NotreDame_De_Paris.txt 3
defacing	NotreDame_De_Paris.txt 1
default	NotreDame_De_Paris.txt 1
defect	NotreDame_De_Paris.txt 6
defective	NotreDame_De_Paris.txt 4
defects	NotreDame_De_Paris.txt 2
defence	NotreDame_De_Paris.txt 3
defend	NotreDame_De_Paris.txt 3
defendant	NotreDame_De_Paris.txt 1
defended	NotreDame_De_Paris.txt 3
defending	NotreDame_De_Paris.txt 6
defensive	NotreDame_De_Paris.txt 2
defer	NotreDame_De_Paris.txt 1
defiance	NotreDame_De_Paris.txt 3
defiled	NotreDame_De_Paris.txt 1
defiling	NotreDame_De_Paris.txt 1
defined	NotreDame_De_Paris.txt 2
definite	NotreDame_De_Paris.txt 2
definiteness	NotreDame_De_Paris.txt 1
definitive	NotreDame_De_Paris.txt 3
deformed	NotreDame_De_Paris.txt 8
deformity	NotreDame_De_Paris.txt 10
defuit	NotreDame_De_Paris.txt 1
defunct	NotreDame_De_Paris.txt 1
degradations	NotreDame_De_Paris.txt 1
degree	NotreDame_De_Paris.txt 15
degrees	NotreDame_De_Paris.txt 6
deign	NotreDame_De_Paris.txt 1
deigned	NotreDame_De_Paris.txt 2
deigning	NotreDame_De_Paris.txt 1
dejection	NotreDame_De_Paris.txt 1
del	NotreDame_De_Paris.txt 1
deletions	NotreDame_De_Paris.txt 1
delicacies	NotreDame_De_Paris.txt 1
delicacy	NotreDame_De_Paris.txt 3
delicate	NotreDame_De_Paris.txt 24
delicately	NotreDame_De_Paris.txt 2
delicious	NotreDame_De_Paris.txt 1
delight	NotreDame_De_Paris.txt 5
delighted	NotreDame_De_Paris.txt 7
delightfully	NotreDame_De_Paris.txt 1
delinquencies	NotreDame_De_Paris.txt 1
delirious	NotreDame_De_Paris.txt 1
delirium	NotreDame_De_Paris.txt 3
deliriums	NotreDame_De_Paris.txt 1
deliver	NotreDame_De_Paris.txt 5
delivered	NotreDame_De_Paris.txt 8
deliverer	NotreDame_De_Paris.txt 1
delivering	NotreDame_De_Paris.txt 1
delorme	NotreDame_De_Paris.txt 1
deluding	NotreDame_De_Paris.txt 1
deluge	NotreDame_De_Paris.txt 2
demand	NotreDame_De_Paris.txt 3
demanded	NotreDame_De_Paris.txt 15
demanding	NotreDame_De_Paris.txt 1
demands	NotreDame_De_Paris.txt 2
demerits	NotreDame_De_Paris.txt 2
demi	NotreDame_De_Paris.txt 4
democracy	NotreDame_De_Paris.txt 1
demoiselle	NotreDame_De_Paris.txt 4
demoiselles	NotreDame_De_Paris.txt 1
demolish	NotreDame_De_Paris.txt 2
demolished	NotreDame_De_Paris.txt 4
demolishers	NotreDame_De_Paris.txt 1
demolishes	NotreDame_De_Paris.txt 1
demolishing	NotreDame_De_Paris.txt 1
demolition	NotreDame_De_Paris.txt 3
demolitions	NotreDame_De_Paris.txt 1
demon	NotreDame_De_Paris.txt 28
demoniac	NotreDame_De_Paris.txt 1
demons	NotreDame_De_Paris.txt 4
demonstrata	NotreDame_De_Paris.txt 1
demonstrated	NotreDame_De_Paris.txt 2
demonstrates	NotreDame_De_Paris.txt 1
demonstrating	NotreDame_De_Paris.txt 1
demonstrator	NotreDame_De_Paris.txt 1
den	NotreDame_De_Paris.txt 7
denarios	NotreDame_De_Paris.txt 1
denial	NotreDame_De_Paris.txt 2
denied	NotreDame_De_Paris.txt 2
deniers	NotreDame_De_Paris.txt 14
denis	NotreDame_De_Paris.txt 17
denounce	NotreDame_De_Paris.txt 1
denounced	NotreDame_De_Paris.txt 3
denouncing	NotreDame_De_Paris.txt 1
dense	NotreDame_De_Paris.txt 9
dentated	NotreDame_De_Paris.txt 1
denticulation	NotreDame_De_Paris.txt 1
denticulations	NotreDame_De_Paris.txt 1
dentro	NotreDame_De_Paris.txt 2
denuded	NotreDame_De_Paris.txt 1
denunciator	NotreDame_De_Paris.txt 1
deny	NotreDame_De_Paris.txt 8
denying	NotreDame_De_Paris.txt 2
depart	NotreDame_De_Paris.txt 3
departed	NotreDame_De_Paris.txt 7
departing	NotreDame_De_Paris.txt 2
departure	NotreDame_De_Paris.txt 6
depend	NotreDame_De_Paris.txt 1
depended	NotreDame_De_Paris.txt 2
dependency	NotreDame_De_Paris.txt 1
dependent	NotreDame_De_Paris.txt 1
depends	NotreDame_De_Paris.txt 3
depicted	NotreDame_De_Paris.txt 3
depicting	NotreDame_De_Paris.txt 1
depleted	NotreDame_De_Paris.txt 1
deplorable	NotreDame_De_Paris.txt 2
deposit	NotreDame_De_Paris.txt 2
deposited	NotreDame_De_Paris.txt 9
depositing	NotreDame_De_Paris.txt 1
deposition	NotreDame_De_Paris.txt 2
deposits	NotreDame_De_Paris.txt 1
depraved	NotreDame_De_Paris.txt 2
depressed	NotreDame_De_Paris.txt 1
depression	NotreDame_De_Paris.txt 2
deprived	NotreDame_De_Paris.txt 5
depth	NotreDame_De_Paris.txt 1
depths	NotreDame_De_Paris.txt 17
der	NotreDame_De_Paris.txt 1
derision	NotreDame_De_Paris.txt 5
derisive	NotreDame_De_Paris.txt 3
derivative	NotreDame_De_Paris.txt 3
derive	NotreDame_De_Paris.txt 1
derived	NotreDame_De_Paris.txt 5
derniers	NotreDame_De_Paris.txt 1
des	NotreDame_De_Paris.txt 60
descend	NotreDame_De_Paris.txt 12
descended	NotreDame_De_Paris.txt 24
descending	NotreDame_De_Paris.txt 7
descent	NotreDame_De_Paris.txt 2
descents	NotreDame_De_Paris.txt 1
describe	NotreDame_De_Paris.txt 4
described	NotreDame_De_Paris.txt 7
describing	NotreDame_De_Paris.txt 1
descried	NotreDame_De_Paris.txt 3
description	NotreDame_De_Paris.txt 3
desert	NotreDame_De_Paris.txt 4
deserted	NotreDame_De_Paris.txt 26
desertion	NotreDame_De_Paris.txt 1
deserts	NotreDame_De_Paris.txt 1
deserve	NotreDame_De_Paris.txt 3
deserved	NotreDame_De_Paris.txt 1
deserves	NotreDame_De_Paris.txt 3
deserving	NotreDame_De_Paris.txt 1
design	NotreDame_De_Paris.txt 1
designate	NotreDame_De_Paris.txt 1
designated	NotreDame_De_Paris.txt 2
designations	NotreDame_De_Paris.txt 1
designs	NotreDame_De_Paris.txt 2
desire	NotreDame_De_Paris.txt 13
desired	NotreDame_De_Paris.txt 6
desires	NotreDame_De_Paris.txt 4
desirous	NotreDame_De_Paris.txt 4
desks	NotreDame_De_Paris.txt 1
desmeared	NotreDame_De_Paris.txt 1
desolate	NotreDame_De_Paris.txt 1
despair	NotreDame_De_Paris.txt 34
despairing	NotreDame_De_Paris.txt 2
despatch	NotreDame_De_Paris.txt 1
despatched	NotreDame_De_Paris.txt 2
despatches	NotreDame_De_Paris.txt 2
desperate	NotreDame_De_Paris.txt 8
desperately	NotreDame_De_Paris.txt 1
desperation	NotreDame_De_Paris.txt 1
despise	NotreDame_De_Paris.txt 4
despised	NotreDame_De_Paris.txt 3
despite	NotreDame_De_Paris.txt 2
despoiled	NotreDame_De_Paris.txt 2
despreaux	NotreDame_De_Paris.txt 1
dessert	NotreDame_De_Paris.txt 1
dessus	NotreDame_De_Paris.txt 1
destination	NotreDame_De_Paris.txt 1
destined	NotreDame_De_Paris.txt 6
destinies	NotreDame_De_Paris.txt 2
destiny	NotreDame_De_Paris.txt 7
destitute	NotreDame_De_Paris.txt 1
destroy	NotreDame_De_Paris.txt 6
destroyed	NotreDame_De_Paris.txt 9
destroying	NotreDame_De_Paris.txt 2
destruction	NotreDame_De_Paris.txt 2
detach	NotreDame_De_Paris.txt 3
detached	NotreDame_De_Paris.txt 8
detaching	NotreDame_De_Paris.txt 3
detail	NotreDame_De_Paris.txt 4
details	NotreDame_De_Paris.txt 8
detained	NotreDame_De_Paris.txt 3
determinances	NotreDame_De_Paris.txt 1
determine	NotreDame_De_Paris.txt 2
determined	NotreDame_De_Paris.txt 5
detestable	NotreDame_De_Paris.txt 1
detesting	NotreDame_De_Paris.txt 1
detests	NotreDame_De_Paris.txt 1
dethrone	NotreDame_De_Paris.txt 1
dethroned	NotreDame_De_Paris.txt 3
dethroning	NotreDame_De_Paris.txt 1
detonation	NotreDame_De_Paris.txt 2
detract	NotreDame_De_Paris.txt 1
deuce	NotreDame_De_Paris.txt 8
deum	NotreDame_De_Paris.txt 4
deus	NotreDame_De_Paris.txt 4
devant	NotreDame_De_Paris.txt 1
devastate	NotreDame_De_Paris.txt 1
devastated	NotreDame_De_Paris.txt 1
develop	NotreDame_De_Paris.txt 4
developed	NotreDame_De_Paris.txt 9
developing	NotreDame_De_Paris.txt 1
development	NotreDame_De_Paris.txt 2
developments	NotreDame_De_Paris.txt 1
develops	NotreDame_De_Paris.txt 2
deviations	NotreDame_De_Paris.txt 2
device	NotreDame_De_Paris.txt 4
devil	NotreDame_De_Paris.txt 72
devilish	NotreDame_De_Paris.txt 2
devils	NotreDame_De_Paris.txt 2
devise	NotreDame_De_Paris.txt 1
devised	NotreDame_De_Paris.txt 2
devoid	NotreDame_De_Paris.txt 2
devoted	NotreDame_De_Paris.txt 2
devotees	NotreDame_De_Paris.txt 1
devotion	NotreDame_De_Paris.txt 7
devour	NotreDame_De_Paris.txt 5
devoured	NotreDame_De_Paris.txt 16
devourer	NotreDame_De_Paris.txt 1
devouring	NotreDame_De_Paris.txt 4
devours	NotreDame_De_Paris.txt 3
devout	NotreDame_De_Paris.txt 8
devoutly	NotreDame_De_Paris.txt 5
devoutness	NotreDame_De_Paris.txt 2
dew	NotreDame_De_Paris.txt 1
dexeubolos	NotreDame_De_Paris.txt 1
dexterity	NotreDame_De_Paris.txt 2
diable	NotreDame_De_Paris.txt 1
diabolical	NotreDame_De_Paris.txt 2
diabolically	NotreDame_De_Paris.txt 1
diacre	NotreDame_De_Paris.txt 1
diadem	NotreDame_De_Paris.txt 1
diagnoses	NotreDame_De_Paris.txt 1
dialects	NotreDame_De_Paris.txt 1
dialogue	NotreDame_De_Paris.txt 3
dialogues	NotreDame_De_Paris.txt 1
dialogus	NotreDame_De_Paris.txt 1
diameter	NotreDame_De_Paris.txt 1
diametrically	NotreDame_De_Paris.txt 1
diamond	NotreDame_De_Paris.txt 2
diamonds	NotreDame_De_Paris.txt 2
diana	NotreDame_De_Paris.txt 2
diane	NotreDame_De_Paris.txt 8
diaphanous	NotreDame_De_Paris.txt 1
diavolus	NotreDame_De_Paris.txt 1
dice	NotreDame_De_Paris.txt 6
dicite	NotreDame_De_Paris.txt 1
dictate	NotreDame_De_Paris.txt 1
dictated	NotreDame_De_Paris.txt 1
dictates	NotreDame_De_Paris.txt 1
dictation	NotreDame_De_Paris.txt 3
dicto	NotreDame_De_Paris.txt 1
did	NotreDame_De_Paris.txt 225
didascalon	NotreDame_De_Paris.txt 1
didymus	NotreDame_De_Paris.txt 2
die	NotreDame_De_Paris.txt 35
died	NotreDame_De_Paris.txt 19
dien	NotreDame_De_Paris.txt 1
dieppe	NotreDame_De_Paris.txt 1
dies	NotreDame_De_Paris.txt 2
dieu	NotreDame_De_Paris.txt 52
difference	NotreDame_De_Paris.txt 8
differences	NotreDame_De_Paris.txt 2
different	NotreDame_De_Paris.txt 15
differently	NotreDame_De_Paris.txt 2
differing	NotreDame_De_Paris.txt 1
difficult	NotreDame_De_Paris.txt 15
difficulty	NotreDame_De_Paris.txt 12
difforme	NotreDame_De_Paris.txt 1
diffuse	NotreDame_De_Paris.txt 1
diffused	NotreDame_De_Paris.txt 2
digested	NotreDame_De_Paris.txt 2
digging	NotreDame_De_Paris.txt 2
dignified	NotreDame_De_Paris.txt 2
dignitaries	NotreDame_De_Paris.txt 3
dignitas	NotreDame_De_Paris.txt 1
dignities	NotreDame_De_Paris.txt 1
dignity	NotreDame_De_Paris.txt 5
dike	NotreDame_De_Paris.txt 1
dikes	NotreDame_De_Paris.txt 1
dilapidated	NotreDame_De_Paris.txt 2
dilapidation	NotreDame_De_Paris.txt 2
dilapitated	NotreDame_De_Paris.txt 1
dilated	NotreDame_De_Paris.txt 2
dilating	NotreDame_De_Paris.txt 1
dilemma	NotreDame_De_Paris.txt 2
dilemmas	NotreDame_De_Paris.txt 1
diligence	NotreDame_De_Paris.txt 1
diligent	NotreDame_De_Paris.txt 1
dim	NotreDame_De_Paris.txt 2
dimidiam	NotreDame_De_Paris.txt 1
dimidio	NotreDame_De_Paris.txt 1
diminished	NotreDame_De_Paris.txt 1
dimly	NotreDame_De_Paris.txt 5
din	NotreDame_De_Paris.txt 1
dinary	NotreDame_De_Paris.txt 1
dingy	NotreDame_De_Paris.txt 2
dinner	NotreDame_De_Paris.txt 1
dint	NotreDame_De_Paris.txt 2
diogenes	NotreDame_De_Paris.txt 2
dip	NotreDame_De_Paris.txt 1
diplomat	NotreDame_De_Paris.txt 1
dipped	NotreDame_De_Paris.txt 1
dipper	NotreDame_De_Paris.txt 1
dips	NotreDame_De_Paris.txt 1
dire	NotreDame_De_Paris.txt 1
direct	NotreDame_De_Paris.txt 5
directed	NotreDame_De_Paris.txt 14
directing	NotreDame_De_Paris.txt 3
direction	NotreDame_De_Paris.txt 25
directions	NotreDame_De_Paris.txt 4
directly	NotreDame_De_Paris.txt 7
director	NotreDame_De_Paris.txt 1
dirty	NotreDame_De_Paris.txt 7
disagreeable	NotreDame_De_Paris.txt 6
disappear	NotreDame_De_Paris.txt 13
disappearance	NotreDame_De_Paris.txt 2
disappeared	NotreDame_De_Paris.txt 41
disappearing	NotreDame_De_Paris.txt 1
disappears	NotreDame_De_Paris.txt 2
disappointed	NotreDame_De_Paris.txt 1
disappointment	NotreDame_De_Paris.txt 2
disarmed	NotreDame_De_Paris.txt 1
disarrange	NotreDame_De_Paris.txt 1
disarranged	NotreDame_De_Paris.txt 2
disarray	NotreDame_De_Paris.txt 2
disaster	NotreDame_De_Paris.txt 1
discerned	NotreDame_De_Paris.txt 2
discernment	NotreDame_De_Paris.txt 1
discharge	NotreDame_De_Paris.txt 7
discharged	NotreDame_De_Paris.txt 3
discharges	NotreDame_De_Paris.txt 1
discharging	NotreDame_De_Paris.txt 1
disciple	NotreDame_De_Paris.txt 2
disciplina	NotreDame_De_Paris.txt 1
discipline	NotreDame_De_Paris.txt 7
disciplined	NotreDame_De_Paris.txt 2
discipulorum	NotreDame_De_Paris.txt 1
disclaim	NotreDame_De_Paris.txt 1
disclaimer	NotreDame_De_Paris.txt 3
disclaimers	NotreDame_De_Paris.txt 1
discomfited	NotreDame_De_Paris.txt 2
discomfiture	NotreDame_De_Paris.txt 1
discomfort	NotreDame_De_Paris.txt 1
disconcerted	NotreDame_De_Paris.txt 2
discontent	NotreDame_De_Paris.txt 3
discontinue	NotreDame_De_Paris.txt 2
discord	NotreDame_De_Paris.txt 1
discouraged	NotreDame_De_Paris.txt 4
discouragement	NotreDame_De_Paris.txt 2
discover	NotreDame_De_Paris.txt 5
discovered	NotreDame_De_Paris.txt 5
discoveries	NotreDame_De_Paris.txt 1
discovering	NotreDame_De_Paris.txt 1
discovers	NotreDame_De_Paris.txt 1
discovery	NotreDame_De_Paris.txt 1
discreet	NotreDame_De_Paris.txt 4
discretion	NotreDame_De_Paris.txt 1
discussing	NotreDame_De_Paris.txt 1
disdain	NotreDame_De_Paris.txt 12
disdained	NotreDame_De_Paris.txt 1
disdainful	NotreDame_De_Paris.txt 3
disdainfully	NotreDame_De_Paris.txt 1
disease	NotreDame_De_Paris.txt 1
disembark	NotreDame_De_Paris.txt 1
disembowelled	NotreDame_De_Paris.txt 2
disenchant	NotreDame_De_Paris.txt 1
disenchanted	NotreDame_De_Paris.txt 1
disengage	NotreDame_De_Paris.txt 1
disengaged	NotreDame_De_Paris.txt 1
disentangled	NotreDame_De_Paris.txt 2
disfigure	NotreDame_De_Paris.txt 4
disfigured	NotreDame_De_Paris.txt 2
disfrocked	NotreDame_De_Paris.txt 1
disgorged	NotreDame_De_Paris.txt 1
disgrace	NotreDame_De_Paris.txt 2
disguise	NotreDame_De_Paris.txt 1
disgust	NotreDame_De_Paris.txt 4
disgusted	NotreDame_De_Paris.txt 1
dish	NotreDame_De_Paris.txt 3
disheartened	NotreDame_De_Paris.txt 1
dishes	NotreDame_De_Paris.txt 1
dishevelled	NotreDame_De_Paris.txt 6
dishonorable	NotreDame_De_Paris.txt 1
dishonored	NotreDame_De_Paris.txt 2
disinclined	NotreDame_De_Paris.txt 1
disk	NotreDame_De_Paris.txt 2
disks	NotreDame_De_Paris.txt 1
dislocated	NotreDame_De_Paris.txt 2
dislocation	NotreDame_De_Paris.txt 1
dislodge	NotreDame_De_Paris.txt 1
dislodging	NotreDame_De_Paris.txt 1
disloyalty	NotreDame_De_Paris.txt 1
dismantle	NotreDame_De_Paris.txt 1
dismantled	NotreDame_De_Paris.txt 1
dismay	NotreDame_De_Paris.txt 1
dismayed	NotreDame_De_Paris.txt 1
dismembered	NotreDame_De_Paris.txt 1
dismemberment	NotreDame_De_Paris.txt 1
dismissed	NotreDame_De_Paris.txt 1
dismissing	NotreDame_De_Paris.txt 1
dismounted	NotreDame_De_Paris.txt 1
disome	NotreDame_De_Paris.txt 1
disorder	NotreDame_De_Paris.txt 8
disordered	NotreDame_De_Paris.txt 3
disorderly	NotreDame_De_Paris.txt 3
disorganized	NotreDame_De_Paris.txt 1
dispelled	NotreDame_De_Paris.txt 1
dispensation	NotreDame_De_Paris.txt 1
dispense	NotreDame_De_Paris.txt 1
dispensed	NotreDame_De_Paris.txt 2
dispersed	NotreDame_De_Paris.txt 2
displaced	NotreDame_De_Paris.txt 1
display	NotreDame_De_Paris.txt 3
displayed	NotreDame_De_Paris.txt 2
displaying	NotreDame_De_Paris.txt 7
displease	NotreDame_De_Paris.txt 1
displeased	NotreDame_De_Paris.txt 4
displeases	NotreDame_De_Paris.txt 4
displeasing	NotreDame_De_Paris.txt 2
displeasure	NotreDame_De_Paris.txt 6
disporting	NotreDame_De_Paris.txt 1
disposed	NotreDame_De_Paris.txt 3
disposition	NotreDame_De_Paris.txt 3
disproportionate	NotreDame_De_Paris.txt 1
disputations	NotreDame_De_Paris.txt 1
dispute	NotreDame_De_Paris.txt 1
disputed	NotreDame_De_Paris.txt 1
disputes	NotreDame_De_Paris.txt 1
disputing	NotreDame_De_Paris.txt 3
disquiet	NotreDame_De_Paris.txt 1
disrespect	NotreDame_De_Paris.txt 1
dissembling	NotreDame_De_Paris.txt 1
disseminated	NotreDame_De_Paris.txt 1
dissidiorum	NotreDame_De_Paris.txt 1
dissimilar	NotreDame_De_Paris.txt 1
dissimulate	NotreDame_De_Paris.txt 1
dissipate	NotreDame_De_Paris.txt 2
dissipated	NotreDame_De_Paris.txt 3
dissipating	NotreDame_De_Paris.txt 1
dissolute	NotreDame_De_Paris.txt 1
distaff	NotreDame_De_Paris.txt 2
distaffs	NotreDame_De_Paris.txt 2
distance	NotreDame_De_Paris.txt 14
distant	NotreDame_De_Paris.txt 10
distiches	NotreDame_De_Paris.txt 1
distinct	NotreDame_De_Paris.txt 9
distinction	NotreDame_De_Paris.txt 2
distinctive	NotreDame_De_Paris.txt 1
distinctly	NotreDame_De_Paris.txt 6
distinctness	NotreDame_De_Paris.txt 1
distinguish	NotreDame_De_Paris.txt 17
distinguished	NotreDame_De_Paris.txt 13
distinguishes	NotreDame_De_Paris.txt 1
distinguishing	NotreDame_De_Paris.txt 1
distort	NotreDame_De_Paris.txt 1
distorted	NotreDame_De_Paris.txt 2
distracted	NotreDame_De_Paris.txt 5
distractedly	NotreDame_De_Paris.txt 1
distraction	NotreDame_De_Paris.txt 1
distress	NotreDame_De_Paris.txt 6
distressed	NotreDame_De_Paris.txt 1
distresses	NotreDame_De_Paris.txt 1
distressing	NotreDame_De_Paris.txt 1
distribute	NotreDame_De_Paris.txt 6
distributed	NotreDame_De_Paris.txt 5
distributing	NotreDame_De_Paris.txt 7
distribution	NotreDame_De_Paris.txt 8
distributor	NotreDame_De_Paris.txt 1
distrust	NotreDame_De_Paris.txt 2
distrusted	NotreDame_De_Paris.txt 1
distrustful	NotreDame_De_Paris.txt 2
distrusts	NotreDame_De_Paris.txt 1
disturb	NotreDame_De_Paris.txt 3
disturbance	NotreDame_De_Paris.txt 2
disturbances	NotreDame_De_Paris.txt 1
disturbed	NotreDame_De_Paris.txt 12
disturbing	NotreDame_De_Paris.txt 2
disturbs	NotreDame_De_Paris.txt 2
ditty	NotreDame_De_Paris.txt 5
divergent	NotreDame_De_Paris.txt 1
divers	NotreDame_De_Paris.txt 2
diversa	NotreDame_De_Paris.txt 1
diverse	NotreDame_De_Paris.txt 1
diversion	NotreDame_De_Paris.txt 5
diversity	NotreDame_De_Paris.txt 2
diverted	NotreDame_De_Paris.txt 4
diverting	NotreDame_De_Paris.txt 3
divide	NotreDame_De_Paris.txt 1
divided	NotreDame_De_Paris.txt 8
divine	NotreDame_De_Paris.txt 12
divined	NotreDame_De_Paris.txt 4
divinely	NotreDame_De_Paris.txt 1
divinities	NotreDame_De_Paris.txt 1
divinity	NotreDame_De_Paris.txt 2
divisions	NotreDame_De_Paris.txt 1
divorce	NotreDame_De_Paris.txt 1
dizziness	NotreDame_De_Paris.txt 1
djali	NotreDame_De_Paris.txt 36
do	NotreDame_De_Paris.txt 324
docile	NotreDame_De_Paris.txt 3
docility	NotreDame_De_Paris.txt 1
docteur	NotreDame_De_Paris.txt 1
doctor	NotreDame_De_Paris.txt 17
doctors	NotreDame_De_Paris.txt 5
doctorum	NotreDame_De_Paris.txt 1
doctrina	NotreDame_De_Paris.txt 1
doctrines	NotreDame_De_Paris.txt 1
document	NotreDame_De_Paris.txt 1
documents	NotreDame_De_Paris.txt 6
does	NotreDame_De_Paris.txt 71
doeskin	NotreDame_De_Paris.txt 1
doesn	NotreDame_De_Paris.txt 1
dog	NotreDame_De_Paris.txt 26
doge	NotreDame_De_Paris.txt 2
dogma	NotreDame_De_Paris.txt 3
dogmatic	NotreDame_De_Paris.txt 1
dogs	NotreDame_De_Paris.txt 13
doing	NotreDame_De_Paris.txt 18
doleful	NotreDame_De_Paris.txt 2
doll	NotreDame_De_Paris.txt 2
dolmen	NotreDame_De_Paris.txt 1
dolorous	NotreDame_De_Paris.txt 1
dolphin	NotreDame_De_Paris.txt 4
dolt	NotreDame_De_Paris.txt 2
dolts	NotreDame_De_Paris.txt 1
dom	NotreDame_De_Paris.txt 66
domain	NotreDame_De_Paris.txt 8
domaine	NotreDame_De_Paris.txt 1
domains	NotreDame_De_Paris.txt 1
dome	NotreDame_De_Paris.txt 7
domes	NotreDame_De_Paris.txt 1
domestic	NotreDame_De_Paris.txt 5
domestics	NotreDame_De_Paris.txt 1
dominant	NotreDame_De_Paris.txt 1
dominated	NotreDame_De_Paris.txt 4
dominating	NotreDame_De_Paris.txt 2
domince	NotreDame_De_Paris.txt 1
domine	NotreDame_De_Paris.txt 2
dominique	NotreDame_De_Paris.txt 1
dominoe	NotreDame_De_Paris.txt 2
dominum	NotreDame_De_Paris.txt 3
dominus	NotreDame_De_Paris.txt 1
domne	NotreDame_De_Paris.txt 1
domni	NotreDame_De_Paris.txt 1
domum	NotreDame_De_Paris.txt 1
domus	NotreDame_De_Paris.txt 1
don	NotreDame_De_Paris.txt 34
donate	NotreDame_De_Paris.txt 4
donation	NotreDame_De_Paris.txt 1
donations	NotreDame_De_Paris.txt 15
done	NotreDame_De_Paris.txt 60
donjon	NotreDame_De_Paris.txt 11
donned	NotreDame_De_Paris.txt 2
donning	NotreDame_De_Paris.txt 1
donors	NotreDame_De_Paris.txt 1
door	NotreDame_De_Paris.txt 166
doors	NotreDame_De_Paris.txt 24
doorway	NotreDame_De_Paris.txt 1
dora	NotreDame_De_Paris.txt 1
doriolle	NotreDame_De_Paris.txt 1
dormans	NotreDame_De_Paris.txt 2
dormer	NotreDame_De_Paris.txt 3
dormitory	NotreDame_De_Paris.txt 1
dos	NotreDame_De_Paris.txt 1
dost	NotreDame_De_Paris.txt 3
dotage	NotreDame_De_Paris.txt 1
doth	NotreDame_De_Paris.txt 8
dotted	NotreDame_De_Paris.txt 1
double	NotreDame_De_Paris.txt 29
doubled	NotreDame_De_Paris.txt 6
doublet	NotreDame_De_Paris.txt 18
doublets	NotreDame_De_Paris.txt 4
doubling	NotreDame_De_Paris.txt 1
doubly	NotreDame_De_Paris.txt 3
doubt	NotreDame_De_Paris.txt 57
doubted	NotreDame_De_Paris.txt 5
doubtful	NotreDame_De_Paris.txt 2
doubting	NotreDame_De_Paris.txt 1
doubts	NotreDame_De_Paris.txt 2
doulx	NotreDame_De_Paris.txt 1
dove	NotreDame_De_Paris.txt 2
doves	NotreDame_De_Paris.txt 1
dowager	NotreDame_De_Paris.txt 1
down	NotreDame_De_Paris.txt 115
downcast	NotreDame_De_Paris.txt 1
downloading	NotreDame_De_Paris.txt 1
downward	NotreDame_De_Paris.txt 3
downwards	NotreDame_De_Paris.txt 2
dowry	NotreDame_De_Paris.txt 1
dozen	NotreDame_De_Paris.txt 3
dozing	NotreDame_De_Paris.txt 1
dr	NotreDame_De_Paris.txt 4
drag	NotreDame_De_Paris.txt 12
dragged	NotreDame_De_Paris.txt 16
dragging	NotreDame_De_Paris.txt 10
dragon	NotreDame_De_Paris.txt 4
dragons	NotreDame_De_Paris.txt 2
drags	NotreDame_De_Paris.txt 1
drain	NotreDame_De_Paris.txt 1
drains	NotreDame_De_Paris.txt 1
dram	NotreDame_De_Paris.txt 8
drama	NotreDame_De_Paris.txt 5
dramas	NotreDame_De_Paris.txt 1
dramatic	NotreDame_De_Paris.txt 6
drank	NotreDame_De_Paris.txt 4
draped	NotreDame_De_Paris.txt 4
draperie	NotreDame_De_Paris.txt 1
draperies	NotreDame_De_Paris.txt 3
drapery	NotreDame_De_Paris.txt 3
draught	NotreDame_De_Paris.txt 2
draughts	NotreDame_De_Paris.txt 1
draw	NotreDame_De_Paris.txt 14
drawbridge	NotreDame_De_Paris.txt 4
drawer	NotreDame_De_Paris.txt 3
drawing	NotreDame_De_Paris.txt 9
drawl	NotreDame_De_Paris.txt 1
drawled	NotreDame_De_Paris.txt 1
drawling	NotreDame_De_Paris.txt 1
drawn	NotreDame_De_Paris.txt 15
draws	NotreDame_De_Paris.txt 3
dread	NotreDame_De_Paris.txt 2
dreaded	NotreDame_De_Paris.txt 1
dreadful	NotreDame_De_Paris.txt 1
dream	NotreDame_De_Paris.txt 14
dreamed	NotreDame_De_Paris.txt 7
dreamer	NotreDame_De_Paris.txt 1
dreamily	NotreDame_De_Paris.txt 4
dreaming	NotreDame_De_Paris.txt 8
dreams	NotreDame_De_Paris.txt 10
dreamy	NotreDame_De_Paris.txt 6
dregs	NotreDame_De_Paris.txt 1
drenched	NotreDame_De_Paris.txt 4
dress	NotreDame_De_Paris.txt 8
dressed	NotreDame_De_Paris.txt 19
dresser	NotreDame_De_Paris.txt 2
dressing	NotreDame_De_Paris.txt 8
dreux	NotreDame_De_Paris.txt 1
drew	NotreDame_De_Paris.txt 24
dried	NotreDame_De_Paris.txt 2
drift	NotreDame_De_Paris.txt 1
drifted	NotreDame_De_Paris.txt 1
drifts	NotreDame_De_Paris.txt 1
drink	NotreDame_De_Paris.txt 18
drinker	NotreDame_De_Paris.txt 2
drinkers	NotreDame_De_Paris.txt 5
drinking	NotreDame_De_Paris.txt 9
drip	NotreDame_De_Paris.txt 1
dripped	NotreDame_De_Paris.txt 1
dripping	NotreDame_De_Paris.txt 6
drive	NotreDame_De_Paris.txt 2
driven	NotreDame_De_Paris.txt 6
driving	NotreDame_De_Paris.txt 6
droll	NotreDame_De_Paris.txt 4
drone	NotreDame_De_Paris.txt 1
droned	NotreDame_De_Paris.txt 2
drones	NotreDame_De_Paris.txt 1
droop	NotreDame_De_Paris.txt 2
drooped	NotreDame_De_Paris.txt 2
drooping	NotreDame_De_Paris.txt 6
drop	NotreDame_De_Paris.txt 24
dropped	NotreDame_De_Paris.txt 17
dropping	NotreDame_De_Paris.txt 1
drops	NotreDame_De_Paris.txt 7
dropsy	NotreDame_De_Paris.txt 1
drove	NotreDame_De_Paris.txt 2
drown	NotreDame_De_Paris.txt 2
drowned	NotreDame_De_Paris.txt 9
drownings	NotreDame_De_Paris.txt 1
drugs	NotreDame_De_Paris.txt 1
drum	NotreDame_De_Paris.txt 2
drums	NotreDame_De_Paris.txt 2
drunk	NotreDame_De_Paris.txt 7
drunken	NotreDame_De_Paris.txt 5
dry	NotreDame_De_Paris.txt 17
dryly	NotreDame_De_Paris.txt 3
dryness	NotreDame_De_Paris.txt 1
du	NotreDame_De_Paris.txt 55
dubarry	NotreDame_De_Paris.txt 1
dubartas	NotreDame_De_Paris.txt 1
dubbed	NotreDame_De_Paris.txt 1
duc	NotreDame_De_Paris.txt 3
duchesse	NotreDame_De_Paris.txt 1
duchesses	NotreDame_De_Paris.txt 1
duchy	NotreDame_De_Paris.txt 1
ducum	NotreDame_De_Paris.txt 1
due	NotreDame_De_Paris.txt 1
duels	NotreDame_De_Paris.txt 1
dues	NotreDame_De_Paris.txt 1
duet	NotreDame_De_Paris.txt 2
dug	NotreDame_De_Paris.txt 1
duke	NotreDame_De_Paris.txt 33
dull	NotreDame_De_Paris.txt 9
dulled	NotreDame_De_Paris.txt 1
dumb	NotreDame_De_Paris.txt 7
dumbfounded	NotreDame_De_Paris.txt 4
dung	NotreDame_De_Paris.txt 2
dungeon	NotreDame_De_Paris.txt 7
dunghill	NotreDame_De_Paris.txt 1
durable	NotreDame_De_Paris.txt 6
duration	NotreDame_De_Paris.txt 1
duri	NotreDame_De_Paris.txt 1
during	NotreDame_De_Paris.txt 47
dusky	NotreDame_De_Paris.txt 1
dust	NotreDame_De_Paris.txt 8
dusted	NotreDame_De_Paris.txt 1
dusty	NotreDame_De_Paris.txt 1
duty	NotreDame_De_Paris.txt 6
dwarf	NotreDame_De_Paris.txt 2
dwell	NotreDame_De_Paris.txt 2
dwelling	NotreDame_De_Paris.txt 4
dwellings	NotreDame_De_Paris.txt 2
dwells	NotreDame_De_Paris.txt 1
dwelt	NotreDame_De_Paris.txt 1
dy	NotreDame_De_Paris.txt 2
dye	NotreDame_De_Paris.txt 1
dyer	NotreDame_De_Paris.txt 1
dying	NotreDame_De_Paris.txt 16
dymaerzelle	NotreDame_De_Paris.txt 1
