wachau	Miserables.txt 1
wad	Miserables.txt 1
wadded	Miserables.txt 5
wadding	Miserables.txt 2
wading	Miserables.txt 1
wafer	Miserables.txt 2
wafers	Miserables.txt 3
wafted	Miserables.txt 1
wag	Miserables.txt 2
wage	Miserables.txt 1
wager	Miserables.txt 3
wages	Miserables.txt 7
waging	Miserables.txt 1
wagon	Miserables.txt 19
wagoner	Miserables.txt 1
wagoners	Miserables.txt 3
wagons	Miserables.txt 13
wagram	Miserables.txt 3
wagramme	Miserables.txt 1
wags	Miserables.txt 1
wagtail	Miserables.txt 1
wagtails	Miserables.txt 1
waif	Miserables.txt 1
waifs	Miserables.txt 1
wail	Miserables.txt 1
wailing	Miserables.txt 1
wails	Miserables.txt 1
wainscot	Miserables.txt 1
wainscoted	Miserables.txt 2
wainscoting	Miserables.txt 1
waist	Miserables.txt 17
waistcoat	Miserables.txt 29
waistcoats	Miserables.txt 2
waisted	Miserables.txt 1
waists	Miserables.txt 1
wait	Miserables.txt 55
waited	Miserables.txt 33
waiter	Miserables.txt 7
waiting	Miserables.txt 68
waits	Miserables.txt 1
wake	Miserables.txt 7
waked	Miserables.txt 7
waken	Miserables.txt 1
wakes	Miserables.txt 3
waking	Miserables.txt 15
walk	Miserables.txt 72
walked	Miserables.txt 83
walker	Miserables.txt 1
walking	Miserables.txt 67
walks	Miserables.txt 20
wall	Miserables.txt 288
walled	Miserables.txt 14
wallow	Miserables.txt 1
wallowed	Miserables.txt 1
wallows	Miserables.txt 2
walls	Miserables.txt 101
walnut	Miserables.txt 1
walter	Miserables.txt 1
wan	Miserables.txt 13
wand	Miserables.txt 2
wander	Miserables.txt 3
wandered	Miserables.txt 7
wanderer	Miserables.txt 1
wandering	Miserables.txt 8
wanders	Miserables.txt 1
wane	Miserables.txt 1
want	Miserables.txt 131
wanted	Miserables.txt 30
wanting	Miserables.txt 8
wanton	Miserables.txt 4
wantonly	Miserables.txt 2
wants	Miserables.txt 17
war	Miserables.txt 136
warble	Miserables.txt 1
warbled	Miserables.txt 1
warbler	Miserables.txt 2
warblers	Miserables.txt 1
warbling	Miserables.txt 1
ward	Miserables.txt 2
warden	Miserables.txt 14
wardrobe	Miserables.txt 3
wards	Miserables.txt 1
ware	Miserables.txt 3
warehouses	Miserables.txt 1
wares	Miserables.txt 1
warlike	Miserables.txt 2
warm	Miserables.txt 40
warmed	Miserables.txt 12
warming	Miserables.txt 4
warmly	Miserables.txt 5
warmth	Miserables.txt 8
warn	Miserables.txt 14
warned	Miserables.txt 18
warning	Miserables.txt 15
warnings	Miserables.txt 1
warns	Miserables.txt 2
warped	Miserables.txt 1
warrant	Miserables.txt 2
warranties	Miserables.txt 3
warranty	Miserables.txt 2
warren	Miserables.txt 1
warrior	Miserables.txt 6
warriors	Miserables.txt 1
wars	Miserables.txt 16
warsaw	Miserables.txt 3
wart	Miserables.txt 4
warts	Miserables.txt 4
was	Miserables.txt 8621
wash	Miserables.txt 11
washed	Miserables.txt 11
washer	Miserables.txt 2
washerwoman	Miserables.txt 1
washerwomen	Miserables.txt 2
washes	Miserables.txt 1
washing	Miserables.txt 9
washington	Miserables.txt 6
wasn	Miserables.txt 4
wasp	Miserables.txt 1
wasps	Miserables.txt 2
waste	Miserables.txt 27
wasted	Miserables.txt 11
wastefulness	Miserables.txt 1
wastes	Miserables.txt 6
wasting	Miserables.txt 8
watch	Miserables.txt 80
watchdog	Miserables.txt 1
watched	Miserables.txt 31
watcher	Miserables.txt 4
watchers	Miserables.txt 1
watches	Miserables.txt 5
watchfulness	Miserables.txt 1
watching	Miserables.txt 33
watchmaker	Miserables.txt 2
watchman	Miserables.txt 1
watchmen	Miserables.txt 1
watchwords	Miserables.txt 1
water	Miserables.txt 204
watered	Miserables.txt 9
watering	Miserables.txt 7
waterloo	Miserables.txt 111
waters	Miserables.txt 10
watershed	Miserables.txt 1
waterside	Miserables.txt 1
waterspout	Miserables.txt 1
waterworks	Miserables.txt 1
wathier	Miserables.txt 2
watteau	Miserables.txt 3
wattles	Miserables.txt 1
wave	Miserables.txt 6
waved	Miserables.txt 3
waver	Miserables.txt 4
wavered	Miserables.txt 6
wavering	Miserables.txt 3
wavers	Miserables.txt 1
waves	Miserables.txt 16
waving	Miserables.txt 4
wavre	Miserables.txt 2
wax	Miserables.txt 16
waxed	Miserables.txt 6
waxen	Miserables.txt 2
waxing	Miserables.txt 1
way	Miserables.txt 424
wayfarer	Miserables.txt 10
ways	Miserables.txt 26
wayside	Miserables.txt 1
we	Miserables.txt 1316
weak	Miserables.txt 19
weakened	Miserables.txt 6
weakening	Miserables.txt 1
weaker	Miserables.txt 1
weakly	Miserables.txt 2
weakness	Miserables.txt 9
weaknesses	Miserables.txt 2
wealth	Miserables.txt 13
wealthy	Miserables.txt 21
weapon	Miserables.txt 10
weapons	Miserables.txt 7
wear	Miserables.txt 29
wearer	Miserables.txt 1
wearers	Miserables.txt 1
wearied	Miserables.txt 2
weariness	Miserables.txt 4
wearing	Miserables.txt 27
wearisome	Miserables.txt 1
wears	Miserables.txt 6
weary	Miserables.txt 22
weather	Miserables.txt 24
weathervane	Miserables.txt 1
weave	Miserables.txt 2
weaver	Miserables.txt 2
weaving	Miserables.txt 1
web	Miserables.txt 13
weber	Miserables.txt 1
webs	Miserables.txt 5
wed	Miserables.txt 4
wedded	Miserables.txt 10
wedding	Miserables.txt 46
weddings	Miserables.txt 1
wednesday	Miserables.txt 3
weeding	Miserables.txt 2
weeds	Miserables.txt 7
week	Miserables.txt 38
weekly	Miserables.txt 2
weeks	Miserables.txt 23
weep	Miserables.txt 28
weeping	Miserables.txt 19
weeps	Miserables.txt 3
weevils	Miserables.txt 1
weigh	Miserables.txt 2
weighed	Miserables.txt 15
weighing	Miserables.txt 4
weighs	Miserables.txt 7
weight	Miserables.txt 22
weights	Miserables.txt 3
weimar	Miserables.txt 1
welcome	Miserables.txt 21
welcomed	Miserables.txt 2
welded	Miserables.txt 2
welding	Miserables.txt 1
well	Miserables.txt 643
welled	Miserables.txt 3
wellington	Miserables.txt 67
wells	Miserables.txt 4
weltingen	Miserables.txt 1
wench	Miserables.txt 4
wenches	Miserables.txt 1
went	Miserables.txt 412
wentest	Miserables.txt 1
wept	Miserables.txt 25
were	Miserables.txt 1824
weren	Miserables.txt 2
werewolf	Miserables.txt 1
wert	Miserables.txt 9
werther	Miserables.txt 1
west	Miserables.txt 10
western	Miserables.txt 1
wet	Miserables.txt 23
wets	Miserables.txt 1
wetting	Miserables.txt 2
whack	Miserables.txt 1
whale	Miserables.txt 1
what	Miserables.txt 1857
whatever	Miserables.txt 71
whatsoever	Miserables.txt 4
wheat	Miserables.txt 13
wheedling	Miserables.txt 1
wheel	Miserables.txt 29
wheelbarrows	Miserables.txt 1
wheeled	Miserables.txt 19
wheels	Miserables.txt 37
wheelwright	Miserables.txt 16
whelps	Miserables.txt 1
when	Miserables.txt 1366
whence	Miserables.txt 76
whenever	Miserables.txt 18
where	Miserables.txt 620
whereabouts	Miserables.txt 2
whereas	Miserables.txt 1
wherein	Miserables.txt 11
whereon	Miserables.txt 3
wherever	Miserables.txt 12
wherewith	Miserables.txt 2
wherewithal	Miserables.txt 2
whet	Miserables.txt 2
whether	Miserables.txt 114
whetted	Miserables.txt 1
which	Miserables.txt 5149
whiffle	Miserables.txt 3
while	Miserables.txt 284
whim	Miserables.txt 2
whimsical	Miserables.txt 1
whining	Miserables.txt 3
whip	Miserables.txt 15
whipped	Miserables.txt 5
whippers	Miserables.txt 1
whipping	Miserables.txt 1
whips	Miserables.txt 4
whirl	Miserables.txt 4
whirled	Miserables.txt 3
whirling	Miserables.txt 3
whirlpools	Miserables.txt 1
whirls	Miserables.txt 2
whirlwind	Miserables.txt 18
whirlwinds	Miserables.txt 3
whiskers	Miserables.txt 5
whisper	Miserables.txt 12
whispered	Miserables.txt 17
whispering	Miserables.txt 10
whisperings	Miserables.txt 1
whispers	Miserables.txt 8
whist	Miserables.txt 3
whistle	Miserables.txt 3
whistled	Miserables.txt 5
whistles	Miserables.txt 1
whistling	Miserables.txt 6
whit	Miserables.txt 1
white	Miserables.txt 245
whiten	Miserables.txt 1
whitened	Miserables.txt 2
whiteness	Miserables.txt 19
whitening	Miserables.txt 2
whiter	Miserables.txt 1
whitest	Miserables.txt 1
whitewash	Miserables.txt 1
whitewashed	Miserables.txt 5
whither	Miserables.txt 44
whiting	Miserables.txt 3
whitish	Miserables.txt 12
who	Miserables.txt 2558
whoever	Miserables.txt 21
whole	Miserables.txt 344
wholesale	Miserables.txt 5
wholesome	Miserables.txt 3
wholesomeness	Miserables.txt 1
wholly	Miserables.txt 37
whom	Miserables.txt 358
whomsoever	Miserables.txt 2
whose	Miserables.txt 192
why	Miserables.txt 263
wick	Miserables.txt 3
wicked	Miserables.txt 26
wicker	Miserables.txt 3
wicket	Miserables.txt 9
wickets	Miserables.txt 1
wide	Miserables.txt 38
widely	Miserables.txt 4
widened	Miserables.txt 1
widening	Miserables.txt 3
wider	Miserables.txt 1
widespread	Miserables.txt 1
widest	Miserables.txt 2
widow	Miserables.txt 16
widowed	Miserables.txt 4
widower	Miserables.txt 3
widowers	Miserables.txt 1
widowhood	Miserables.txt 4
widows	Miserables.txt 3
width	Miserables.txt 3
wielded	Miserables.txt 1
wife	Miserables.txt 98
wig	Miserables.txt 7
wigmaker	Miserables.txt 1
wigs	Miserables.txt 4
wigwam	Miserables.txt 1
wild	Miserables.txt 72
wilda	Miserables.txt 1
wildest	Miserables.txt 2
wildly	Miserables.txt 6
wildness	Miserables.txt 3
will	Miserables.txt 1232
willed	Miserables.txt 5
william	Miserables.txt 3
willing	Miserables.txt 16
willingly	Miserables.txt 8
willingness	Miserables.txt 1
willow	Miserables.txt 3
willows	Miserables.txt 2
wills	Miserables.txt 9
wilt	Miserables.txt 6
win	Miserables.txt 7
wincke	Miserables.txt 1
wind	Miserables.txt 88
winded	Miserables.txt 1
windfall	Miserables.txt 1
windfalls	Miserables.txt 3
winding	Miserables.txt 15
windings	Miserables.txt 1
window	Miserables.txt 182
windows	Miserables.txt 85
windowsills	Miserables.txt 1
winds	Miserables.txt 12
windsor	Miserables.txt 1
wine	Miserables.txt 146
winedocks	Miserables.txt 1
wines	Miserables.txt 2
wineshops	Miserables.txt 1
wing	Miserables.txt 28
winged	Miserables.txt 7
wings	Miserables.txt 42
wink	Miserables.txt 2
winked	Miserables.txt 5
winking	Miserables.txt 1
winks	Miserables.txt 1
winner	Miserables.txt 3
winning	Miserables.txt 3
wins	Miserables.txt 4
winter	Miserables.txt 73
winters	Miserables.txt 1
wintry	Miserables.txt 3
wion	Miserables.txt 1
wipe	Miserables.txt 5
wiped	Miserables.txt 4
wiping	Miserables.txt 3
wire	Miserables.txt 6
wisdom	Miserables.txt 24
wise	Miserables.txt 33
wisely	Miserables.txt 4
wisest	Miserables.txt 2
wish	Miserables.txt 99
wished	Miserables.txt 45
wishes	Miserables.txt 11
wishing	Miserables.txt 5
wisp	Miserables.txt 2
wisps	Miserables.txt 1
wit	Miserables.txt 23
witches	Miserables.txt 1
with	Miserables.txt 4528
withal	Miserables.txt 2
withdraw	Miserables.txt 13
withdrawing	Miserables.txt 10
withdrawn	Miserables.txt 7
withdraws	Miserables.txt 1
withdrew	Miserables.txt 12
withered	Miserables.txt 2
withering	Miserables.txt 3
withheld	Miserables.txt 3
within	Miserables.txt 154
without	Miserables.txt 699
withstood	Miserables.txt 1
witness	Miserables.txt 23
witnessed	Miserables.txt 13
witnesses	Miserables.txt 16
witnessing	Miserables.txt 2
wits	Miserables.txt 4
witticisms	Miserables.txt 1
witty	Miserables.txt 7
wives	Miserables.txt 10
woe	Miserables.txt 16
woes	Miserables.txt 2
woke	Miserables.txt 15
wolf	Miserables.txt 30
wolves	Miserables.txt 7
woman	Miserables.txt 435
womanhood	Miserables.txt 1
women	Miserables.txt 162
won	Miserables.txt 50
wonder	Miserables.txt 2
wonderful	Miserables.txt 20
wonderfully	Miserables.txt 5
wondering	Miserables.txt 1
wonderment	Miserables.txt 1
wonders	Miserables.txt 1
wont	Miserables.txt 11
wood	Miserables.txt 64
wooded	Miserables.txt 1
wooden	Miserables.txt 50
woodpeckers	Miserables.txt 2
woods	Miserables.txt 15
woodwork	Miserables.txt 6
wool	Miserables.txt 5
woollen	Miserables.txt 26
word	Miserables.txt 297
words	Miserables.txt 260
wore	Miserables.txt 71
work	Miserables.txt 250
worked	Miserables.txt 19
worker	Miserables.txt 4
workers	Miserables.txt 5
working	Miserables.txt 25
workingman	Miserables.txt 16
workingmen	Miserables.txt 4
workings	Miserables.txt 1
workman	Miserables.txt 16
workmanship	Miserables.txt 1
workmen	Miserables.txt 17
workpeople	Miserables.txt 1
workroom	Miserables.txt 6
workrooms	Miserables.txt 1
works	Miserables.txt 58
workshop	Miserables.txt 2
workshops	Miserables.txt 5
workwoman	Miserables.txt 3
workwomen	Miserables.txt 1
world	Miserables.txt 201
worldlings	Miserables.txt 1
worlds	Miserables.txt 2
worm	Miserables.txt 10
worms	Miserables.txt 3
worn	Miserables.txt 38
worry	Miserables.txt 2
worrying	Miserables.txt 1
worse	Miserables.txt 39
worship	Miserables.txt 6
worst	Miserables.txt 10
worsted	Miserables.txt 3
worth	Miserables.txt 38
worthy	Miserables.txt 67
would	Miserables.txt 1053
wouldn	Miserables.txt 6
wound	Miserables.txt 35
wounded	Miserables.txt 67
wounds	Miserables.txt 31
wove	Miserables.txt 2
woven	Miserables.txt 1
wows	Miserables.txt 1
wrap	Miserables.txt 2
wrapped	Miserables.txt 13
wrapper	Miserables.txt 1
wrapping	Miserables.txt 1
wrath	Miserables.txt 63
wraths	Miserables.txt 2
wreaking	Miserables.txt 1
wreath	Miserables.txt 3
wreathing	Miserables.txt 1
wreaths	Miserables.txt 1
wrecked	Miserables.txt 1
wrecks	Miserables.txt 1
wrenched	Miserables.txt 5
wrestler	Miserables.txt 1
wrestlers	Miserables.txt 1
wretch	Miserables.txt 49
wretched	Miserables.txt 37
wretchedness	Miserables.txt 35
wretches	Miserables.txt 15
wriggle	Miserables.txt 1
wring	Miserables.txt 4
wringing	Miserables.txt 4
wrings	Miserables.txt 1
wrinkle	Miserables.txt 6
wrinkled	Miserables.txt 15
wrinkles	Miserables.txt 11
wrinkling	Miserables.txt 1
wrist	Miserables.txt 5
wrists	Miserables.txt 3
writ	Miserables.txt 1
write	Miserables.txt 44
writer	Miserables.txt 13
writers	Miserables.txt 3
writes	Miserables.txt 6
writhe	Miserables.txt 4
writhed	Miserables.txt 3
writhes	Miserables.txt 1
writhing	Miserables.txt 2
writing	Miserables.txt 35
writings	Miserables.txt 3
written	Miserables.txt 70
wrong	Miserables.txt 66
wronged	Miserables.txt 1
wrongfully	Miserables.txt 2
wronging	Miserables.txt 1
wrongly	Miserables.txt 6
wrongs	Miserables.txt 4
wrote	Miserables.txt 52
wroth	Miserables.txt 1
wrought	Miserables.txt 4
wrung	Miserables.txt 3
wurmser	Miserables.txt 5
www	Miserables.txt 6
wynter	Miserables.txt 1
