a	NotreDame_De_Paris.txt 4774
aback	NotreDame_De_Paris.txt 1
abandon	NotreDame_De_Paris.txt 3
abandoned	NotreDame_De_Paris.txt 13
abandoning	NotreDame_De_Paris.txt 1
abandonment	NotreDame_De_Paris.txt 4
abandons	NotreDame_De_Paris.txt 1
abashed	NotreDame_De_Paris.txt 2
abb	NotreDame_De_Paris.txt 10
abbas	NotreDame_De_Paris.txt 3
abbatial	NotreDame_De_Paris.txt 1
abbe	NotreDame_De_Paris.txt 1
abbey	NotreDame_De_Paris.txt 19
abbeys	NotreDame_De_Paris.txt 4
abbot	NotreDame_De_Paris.txt 2
abbots	NotreDame_De_Paris.txt 2
abcesses	NotreDame_De_Paris.txt 1
abdication	NotreDame_De_Paris.txt 1
abduct	NotreDame_De_Paris.txt 1
abducted	NotreDame_De_Paris.txt 1
abducting	NotreDame_De_Paris.txt 1
abductor	NotreDame_De_Paris.txt 1
aberrations	NotreDame_De_Paris.txt 1
abeyance	NotreDame_De_Paris.txt 1
abhorred	NotreDame_De_Paris.txt 1
abide	NotreDame_De_Paris.txt 1
ability	NotreDame_De_Paris.txt 2
abject	NotreDame_De_Paris.txt 1
able	NotreDame_De_Paris.txt 21
abode	NotreDame_De_Paris.txt 1
aboie	NotreDame_De_Paris.txt 4
abominable	NotreDame_De_Paris.txt 4
abomination	NotreDame_De_Paris.txt 2
abortion	NotreDame_De_Paris.txt 1
abounded	NotreDame_De_Paris.txt 1
about	NotreDame_De_Paris.txt 182
above	NotreDame_De_Paris.txt 100
abraham	NotreDame_De_Paris.txt 2
abreast	NotreDame_De_Paris.txt 2
abri	NotreDame_De_Paris.txt 1
abroad	NotreDame_De_Paris.txt 2
abrogated	NotreDame_De_Paris.txt 2
abrupt	NotreDame_De_Paris.txt 8
abruptly	NotreDame_De_Paris.txt 30
absence	NotreDame_De_Paris.txt 5
absences	NotreDame_De_Paris.txt 1
absent	NotreDame_De_Paris.txt 3
absolute	NotreDame_De_Paris.txt 2
absolutely	NotreDame_De_Paris.txt 7
absorbed	NotreDame_De_Paris.txt 13
absorbing	NotreDame_De_Paris.txt 1
absorbs	NotreDame_De_Paris.txt 1
absorption	NotreDame_De_Paris.txt 1
abstain	NotreDame_De_Paris.txt 1
abstained	NotreDame_De_Paris.txt 1
abstracted	NotreDame_De_Paris.txt 1
abstraction	NotreDame_De_Paris.txt 1
absurd	NotreDame_De_Paris.txt 3
absurdities	NotreDame_De_Paris.txt 1
absurdus	NotreDame_De_Paris.txt 1
abuse	NotreDame_De_Paris.txt 3
abused	NotreDame_De_Paris.txt 1
abyss	NotreDame_De_Paris.txt 14
abysses	NotreDame_De_Paris.txt 2
academies	NotreDame_De_Paris.txt 2
academy	NotreDame_De_Paris.txt 1
acanthus	NotreDame_De_Paris.txt 3
accelerated	NotreDame_De_Paris.txt 1
accent	NotreDame_De_Paris.txt 15
accented	NotreDame_De_Paris.txt 1
accents	NotreDame_De_Paris.txt 4
accentuated	NotreDame_De_Paris.txt 1
accentuation	NotreDame_De_Paris.txt 1
accept	NotreDame_De_Paris.txt 2
accepted	NotreDame_De_Paris.txt 3
accepting	NotreDame_De_Paris.txt 1
access	NotreDame_De_Paris.txt 11
accessed	NotreDame_De_Paris.txt 1
accessible	NotreDame_De_Paris.txt 1
accident	NotreDame_De_Paris.txt 3
accidentally	NotreDame_De_Paris.txt 1
accidents	NotreDame_De_Paris.txt 2
acclaimed	NotreDame_De_Paris.txt 1
acclamation	NotreDame_De_Paris.txt 6
acclamations	NotreDame_De_Paris.txt 5
accompanied	NotreDame_De_Paris.txt 11
accompaniment	NotreDame_De_Paris.txt 2
accompaniments	NotreDame_De_Paris.txt 1
accomplices	NotreDame_De_Paris.txt 2
accomplish	NotreDame_De_Paris.txt 2
accomplished	NotreDame_De_Paris.txt 4
accomplishments	NotreDame_De_Paris.txt 1
accordance	NotreDame_De_Paris.txt 12
accorded	NotreDame_De_Paris.txt 1
according	NotreDame_De_Paris.txt 29
accordingly	NotreDame_De_Paris.txt 13
accost	NotreDame_De_Paris.txt 1
accosted	NotreDame_De_Paris.txt 4
accosting	NotreDame_De_Paris.txt 2
account	NotreDame_De_Paris.txt 16
accounted	NotreDame_De_Paris.txt 1
accounts	NotreDame_De_Paris.txt 8
accoutred	NotreDame_De_Paris.txt 3
accoutrement	NotreDame_De_Paris.txt 2
accoutrements	NotreDame_De_Paris.txt 1
accumulate	NotreDame_De_Paris.txt 1
accumulated	NotreDame_De_Paris.txt 2
accumulates	NotreDame_De_Paris.txt 1
accursed	NotreDame_De_Paris.txt 18
accused	NotreDame_De_Paris.txt 20
accustom	NotreDame_De_Paris.txt 2
accustomed	NotreDame_De_Paris.txt 7
achaia	NotreDame_De_Paris.txt 1
acknowledged	NotreDame_De_Paris.txt 1
acle	NotreDame_De_Paris.txt 1
acolyte	NotreDame_De_Paris.txt 1
acolytes	NotreDame_De_Paris.txt 1
acquaintance	NotreDame_De_Paris.txt 3
acquainted	NotreDame_De_Paris.txt 4
acquire	NotreDame_De_Paris.txt 1
acquired	NotreDame_De_Paris.txt 4
acquiring	NotreDame_De_Paris.txt 1
acrid	NotreDame_De_Paris.txt 1
across	NotreDame_De_Paris.txt 26
act	NotreDame_De_Paris.txt 8
acte	NotreDame_De_Paris.txt 1
acted	NotreDame_De_Paris.txt 2
acting	NotreDame_De_Paris.txt 1
action	NotreDame_De_Paris.txt 3
actions	NotreDame_De_Paris.txt 1
active	NotreDame_De_Paris.txt 3
activity	NotreDame_De_Paris.txt 3
actor	NotreDame_De_Paris.txt 1
actors	NotreDame_De_Paris.txt 6
acts	NotreDame_De_Paris.txt 2
actual	NotreDame_De_Paris.txt 3
actually	NotreDame_De_Paris.txt 5
acute	NotreDame_De_Paris.txt 4
acutely	NotreDame_De_Paris.txt 1
ad	NotreDame_De_Paris.txt 6
adam	NotreDame_De_Paris.txt 3
adapted	NotreDame_De_Paris.txt 3
add	NotreDame_De_Paris.txt 20
added	NotreDame_De_Paris.txt 56
adders	NotreDame_De_Paris.txt 1
addicted	NotreDame_De_Paris.txt 1
adding	NotreDame_De_Paris.txt 1
addition	NotreDame_De_Paris.txt 5
additional	NotreDame_De_Paris.txt 4
additions	NotreDame_De_Paris.txt 1
address	NotreDame_De_Paris.txt 5
addressed	NotreDame_De_Paris.txt 20
addresses	NotreDame_De_Paris.txt 1
addressing	NotreDame_De_Paris.txt 11
adds	NotreDame_De_Paris.txt 1
ade	NotreDame_De_Paris.txt 27
ades	NotreDame_De_Paris.txt 11
adhered	NotreDame_De_Paris.txt 1
adheres	NotreDame_De_Paris.txt 1
adieu	NotreDame_De_Paris.txt 1
adjacent	NotreDame_De_Paris.txt 2
adjoining	NotreDame_De_Paris.txt 3
adjoins	NotreDame_De_Paris.txt 1
adjudge	NotreDame_De_Paris.txt 1
adjudged	NotreDame_De_Paris.txt 1
adjust	NotreDame_De_Paris.txt 1
adjusted	NotreDame_De_Paris.txt 4
adjusting	NotreDame_De_Paris.txt 3
admetus	NotreDame_De_Paris.txt 1
administered	NotreDame_De_Paris.txt 1
administering	NotreDame_De_Paris.txt 1
admirable	NotreDame_De_Paris.txt 16
admirably	NotreDame_De_Paris.txt 2
admiral	NotreDame_De_Paris.txt 2
admiration	NotreDame_De_Paris.txt 9
admire	NotreDame_De_Paris.txt 10
admired	NotreDame_De_Paris.txt 5
admirer	NotreDame_De_Paris.txt 1
admires	NotreDame_De_Paris.txt 1
admiring	NotreDame_De_Paris.txt 3
admit	NotreDame_De_Paris.txt 6
admits	NotreDame_De_Paris.txt 1
admitted	NotreDame_De_Paris.txt 3
adolphus	NotreDame_De_Paris.txt 1
adopt	NotreDame_De_Paris.txt 3
adopted	NotreDame_De_Paris.txt 6
adoption	NotreDame_De_Paris.txt 1
adorable	NotreDame_De_Paris.txt 3
adorably	NotreDame_De_Paris.txt 1
adoration	NotreDame_De_Paris.txt 1
adore	NotreDame_De_Paris.txt 3
adored	NotreDame_De_Paris.txt 4
adorn	NotreDame_De_Paris.txt 1
adorned	NotreDame_De_Paris.txt 1
adr	NotreDame_De_Paris.txt 2
adroit	NotreDame_De_Paris.txt 1
adroitly	NotreDame_De_Paris.txt 1
adroitness	NotreDame_De_Paris.txt 1
adrune	NotreDame_De_Paris.txt 1
adultery	NotreDame_De_Paris.txt 1
advance	NotreDame_De_Paris.txt 10
advanced	NotreDame_De_Paris.txt 15
advances	NotreDame_De_Paris.txt 1
advancing	NotreDame_De_Paris.txt 6
advantage	NotreDame_De_Paris.txt 8
advantages	NotreDame_De_Paris.txt 2
advent	NotreDame_De_Paris.txt 1
adventure	NotreDame_De_Paris.txt 11
adventures	NotreDame_De_Paris.txt 2
adventurous	NotreDame_De_Paris.txt 2
adversary	NotreDame_De_Paris.txt 2
adversits	NotreDame_De_Paris.txt 1
adversity	NotreDame_De_Paris.txt 1
advice	NotreDame_De_Paris.txt 4
advise	NotreDame_De_Paris.txt 1
advised	NotreDame_De_Paris.txt 1
advocate	NotreDame_De_Paris.txt 12
advorsum	NotreDame_De_Paris.txt 1
advoyer	NotreDame_De_Paris.txt 1
aerial	NotreDame_De_Paris.txt 7
aeriel	NotreDame_De_Paris.txt 1
aeschylus	NotreDame_De_Paris.txt 2
aesculapius	NotreDame_De_Paris.txt 1
aesopus	NotreDame_De_Paris.txt 1
aesthetic	NotreDame_De_Paris.txt 1
aetna	NotreDame_De_Paris.txt 1
afar	NotreDame_De_Paris.txt 10
affair	NotreDame_De_Paris.txt 18
affairs	NotreDame_De_Paris.txt 4
affect	NotreDame_De_Paris.txt 1
affectation	NotreDame_De_Paris.txt 1
affectations	NotreDame_De_Paris.txt 1
affected	NotreDame_De_Paris.txt 4
affectedly	NotreDame_De_Paris.txt 1
affecting	NotreDame_De_Paris.txt 1
affection	NotreDame_De_Paris.txt 3
affections	NotreDame_De_Paris.txt 3
affinities	NotreDame_De_Paris.txt 2
affinity	NotreDame_De_Paris.txt 1
affirm	NotreDame_De_Paris.txt 5
affirmative	NotreDame_De_Paris.txt 1
affirmatively	NotreDame_De_Paris.txt 1
affirmed	NotreDame_De_Paris.txt 3
affirms	NotreDame_De_Paris.txt 1
affixed	NotreDame_De_Paris.txt 3
afflicted	NotreDame_De_Paris.txt 3
afforded	NotreDame_De_Paris.txt 6
affray	NotreDame_De_Paris.txt 3
affright	NotreDame_De_Paris.txt 8
affront	NotreDame_De_Paris.txt 1
aflame	NotreDame_De_Paris.txt 2
afraid	NotreDame_De_Paris.txt 17
afresh	NotreDame_De_Paris.txt 3
african	NotreDame_De_Paris.txt 3
after	NotreDame_De_Paris.txt 169
afternoon	NotreDame_De_Paris.txt 1
afterwards	NotreDame_De_Paris.txt 11
again	NotreDame_De_Paris.txt 137
against	NotreDame_De_Paris.txt 147
agamemnon	NotreDame_De_Paris.txt 1
age	NotreDame_De_Paris.txt 40
aged	NotreDame_De_Paris.txt 10
agent	NotreDame_De_Paris.txt 2
ages	NotreDame_De_Paris.txt 31
agglomerating	NotreDame_De_Paris.txt 1
agglomeration	NotreDame_De_Paris.txt 1
aggrandizement	NotreDame_De_Paris.txt 1
aggrandizes	NotreDame_De_Paris.txt 1
aggravated	NotreDame_De_Paris.txt 1
aggregate	NotreDame_De_Paris.txt 1
aggregation	NotreDame_De_Paris.txt 1
aggressions	NotreDame_De_Paris.txt 1
agile	NotreDame_De_Paris.txt 4
agility	NotreDame_De_Paris.txt 3
agitated	NotreDame_De_Paris.txt 4
agitation	NotreDame_De_Paris.txt 9
agnes	NotreDame_De_Paris.txt 18
ago	NotreDame_De_Paris.txt 24
agonized	NotreDame_De_Paris.txt 2
agonizing	NotreDame_De_Paris.txt 1
agony	NotreDame_De_Paris.txt 3
agree	NotreDame_De_Paris.txt 15
agreeable	NotreDame_De_Paris.txt 6
agreed	NotreDame_De_Paris.txt 5
agreement	NotreDame_De_Paris.txt 18
aground	NotreDame_De_Paris.txt 2
ah	NotreDame_De_Paris.txt 58
ai	NotreDame_De_Paris.txt 1
aid	NotreDame_De_Paris.txt 11
aided	NotreDame_De_Paris.txt 3
aides	NotreDame_De_Paris.txt 1
aiding	NotreDame_De_Paris.txt 2
aids	NotreDame_De_Paris.txt 1
aiglet	NotreDame_De_Paris.txt 1
aigrette	NotreDame_De_Paris.txt 1
ailing	NotreDame_De_Paris.txt 5
ailly	NotreDame_De_Paris.txt 2
aim	NotreDame_De_Paris.txt 1
aime	NotreDame_De_Paris.txt 1
aiming	NotreDame_De_Paris.txt 1
aims	NotreDame_De_Paris.txt 2
air	NotreDame_De_Paris.txt 127
airy	NotreDame_De_Paris.txt 1
aisle	NotreDame_De_Paris.txt 1
aisles	NotreDame_De_Paris.txt 5
ajar	NotreDame_De_Paris.txt 1
ajax	NotreDame_De_Paris.txt 1
ak	NotreDame_De_Paris.txt 1
al	NotreDame_De_Paris.txt 2
alacrity	NotreDame_De_Paris.txt 1
alapas	NotreDame_De_Paris.txt 1
alarabes	NotreDame_De_Paris.txt 1
alarm	NotreDame_De_Paris.txt 13
alarmed	NotreDame_De_Paris.txt 7
alarming	NotreDame_De_Paris.txt 3
alarms	NotreDame_De_Paris.txt 1
alas	NotreDame_De_Paris.txt 53
alaudet	NotreDame_De_Paris.txt 1
alb	NotreDame_De_Paris.txt 2
albania	NotreDame_De_Paris.txt 1
albert	NotreDame_De_Paris.txt 1
alchemical	NotreDame_De_Paris.txt 1
alchemist	NotreDame_De_Paris.txt 1
alchemists	NotreDame_De_Paris.txt 5
alchemy	NotreDame_De_Paris.txt 6
alderman	NotreDame_De_Paris.txt 4
aldermen	NotreDame_De_Paris.txt 8
ale	NotreDame_De_Paris.txt 1
aleator	NotreDame_De_Paris.txt 1
alembic	NotreDame_De_Paris.txt 1
alembics	NotreDame_De_Paris.txt 3
alen	NotreDame_De_Paris.txt 1
alert	NotreDame_De_Paris.txt 3
alexander	NotreDame_De_Paris.txt 3
alexandria	NotreDame_De_Paris.txt 2
alexandrine	NotreDame_De_Paris.txt 2
algebra	NotreDame_De_Paris.txt 1
algiers	NotreDame_De_Paris.txt 3
alhambra	NotreDame_De_Paris.txt 1
alight	NotreDame_De_Paris.txt 4
alighted	NotreDame_De_Paris.txt 1
alighting	NotreDame_De_Paris.txt 1
alike	NotreDame_De_Paris.txt 1
aliments	NotreDame_De_Paris.txt 1
aliquamdam	NotreDame_De_Paris.txt 1
aliquoe	NotreDame_De_Paris.txt 1
aliquoties	NotreDame_De_Paris.txt 1
alive	NotreDame_De_Paris.txt 23
alixandre	NotreDame_De_Paris.txt 1
all	NotreDame_De_Paris.txt 924
allegorical	NotreDame_De_Paris.txt 2
allegories	NotreDame_De_Paris.txt 1
allegory	NotreDame_De_Paris.txt 2
alley	NotreDame_De_Paris.txt 2
alleys	NotreDame_De_Paris.txt 3
allied	NotreDame_De_Paris.txt 1
allotted	NotreDame_De_Paris.txt 1
allow	NotreDame_De_Paris.txt 13
allowed	NotreDame_De_Paris.txt 44
allowing	NotreDame_De_Paris.txt 6
allows	NotreDame_De_Paris.txt 2
alluding	NotreDame_De_Paris.txt 1
allusion	NotreDame_De_Paris.txt 1
allusions	NotreDame_De_Paris.txt 2
alluvium	NotreDame_De_Paris.txt 1
almost	NotreDame_De_Paris.txt 59
alms	NotreDame_De_Paris.txt 9
aloft	NotreDame_De_Paris.txt 2
aloise	NotreDame_De_Paris.txt 10
alone	NotreDame_De_Paris.txt 67
along	NotreDame_De_Paris.txt 55
aloof	NotreDame_De_Paris.txt 1
aloud	NotreDame_De_Paris.txt 12
alphabet	NotreDame_De_Paris.txt 6
alphabets	NotreDame_De_Paris.txt 1
alphonse	NotreDame_De_Paris.txt 1
alps	NotreDame_De_Paris.txt 1
already	NotreDame_De_Paris.txt 98
also	NotreDame_De_Paris.txt 128
altam	NotreDame_De_Paris.txt 1
altar	NotreDame_De_Paris.txt 11
altare	NotreDame_De_Paris.txt 1
altars	NotreDame_De_Paris.txt 2
alteration	NotreDame_De_Paris.txt 1
altercation	NotreDame_De_Paris.txt 1
altered	NotreDame_De_Paris.txt 3
alternate	NotreDame_De_Paris.txt 1
alternately	NotreDame_De_Paris.txt 4
alternating	NotreDame_De_Paris.txt 1
alternative	NotreDame_De_Paris.txt 1
alternatively	NotreDame_De_Paris.txt 1
alternatives	NotreDame_De_Paris.txt 1
although	NotreDame_De_Paris.txt 24
altitudes	NotreDame_De_Paris.txt 1
altogether	NotreDame_De_Paris.txt 2
always	NotreDame_De_Paris.txt 95
am	NotreDame_De_Paris.txt 162
amalgamate	NotreDame_De_Paris.txt 2
amalgamated	NotreDame_De_Paris.txt 4
amanyon	NotreDame_De_Paris.txt 1
amass	NotreDame_De_Paris.txt 1
amasses	NotreDame_De_Paris.txt 1
amazed	NotreDame_De_Paris.txt 7
amazement	NotreDame_De_Paris.txt 12
amazing	NotreDame_De_Paris.txt 1
ambassador	NotreDame_De_Paris.txt 4
ambassadors	NotreDame_De_Paris.txt 13
ambiguous	NotreDame_De_Paris.txt 1
ambitious	NotreDame_De_Paris.txt 1
amboise	NotreDame_De_Paris.txt 1
ambroise	NotreDame_De_Paris.txt 2
amelotte	NotreDame_De_Paris.txt 6
amen	NotreDame_De_Paris.txt 4
amendationem	NotreDame_De_Paris.txt 1
amended	NotreDame_De_Paris.txt 1
amending	NotreDame_De_Paris.txt 1
america	NotreDame_De_Paris.txt 2
amiable	NotreDame_De_Paris.txt 5
amiably	NotreDame_De_Paris.txt 1
amice	NotreDame_De_Paris.txt 1
amices	NotreDame_De_Paris.txt 1
amid	NotreDame_De_Paris.txt 31
amidst	NotreDame_De_Paris.txt 1
amiens	NotreDame_De_Paris.txt 1
among	NotreDame_De_Paris.txt 85
amorous	NotreDame_De_Paris.txt 7
amorously	NotreDame_De_Paris.txt 1
amount	NotreDame_De_Paris.txt 4
amounts	NotreDame_De_Paris.txt 1
amour	NotreDame_De_Paris.txt 3
amphibious	NotreDame_De_Paris.txt 1
amphitheatre	NotreDame_De_Paris.txt 1
amphorae	NotreDame_De_Paris.txt 1
ample	NotreDame_De_Paris.txt 4
amputated	NotreDame_De_Paris.txt 1
amputations	NotreDame_De_Paris.txt 1
amulet	NotreDame_De_Paris.txt 10
amulets	NotreDame_De_Paris.txt 1
amuse	NotreDame_De_Paris.txt 4
amused	NotreDame_De_Paris.txt 5
amusement	NotreDame_De_Paris.txt 3
amuses	NotreDame_De_Paris.txt 1
amusing	NotreDame_De_Paris.txt 5
amusingly	NotreDame_De_Paris.txt 1
an	NotreDame_De_Paris.txt 551
anachronism	NotreDame_De_Paris.txt 1
analogous	NotreDame_De_Paris.txt 1
analyze	NotreDame_De_Paris.txt 1
analyzing	NotreDame_De_Paris.txt 1
anapaest	NotreDame_De_Paris.txt 1
anarchical	NotreDame_De_Paris.txt 1
anarkh	NotreDame_De_Paris.txt 5
anaxagoras	NotreDame_De_Paris.txt 1
anceps	NotreDame_De_Paris.txt 1
ancestor	NotreDame_De_Paris.txt 2
anchored	NotreDame_De_Paris.txt 1
ancient	NotreDame_De_Paris.txt 70
and	NotreDame_De_Paris.txt 4916
andalusian	NotreDame_De_Paris.txt 1
andalusians	NotreDame_De_Paris.txt 1
andiron	NotreDame_De_Paris.txt 1
andirons	NotreDame_De_Paris.txt 2
andr	NotreDame_De_Paris.txt 3
andry	NotreDame_De_Paris.txt 17
anent	NotreDame_De_Paris.txt 1
anew	NotreDame_De_Paris.txt 3
angel	NotreDame_De_Paris.txt 11
angelic	NotreDame_De_Paris.txt 1
angelo	NotreDame_De_Paris.txt 5
angelorum	NotreDame_De_Paris.txt 1
angels	NotreDame_De_Paris.txt 5
angelus	NotreDame_De_Paris.txt 2
anger	NotreDame_De_Paris.txt 5
angers	NotreDame_De_Paris.txt 2
angle	NotreDame_De_Paris.txt 17
angles	NotreDame_De_Paris.txt 12
angoul	NotreDame_De_Paris.txt 2
angrily	NotreDame_De_Paris.txt 7
angry	NotreDame_De_Paris.txt 8
anguish	NotreDame_De_Paris.txt 14
angular	NotreDame_De_Paris.txt 5
anhelans	NotreDame_De_Paris.txt 1
ani	NotreDame_De_Paris.txt 2
anima	NotreDame_De_Paris.txt 2
animal	NotreDame_De_Paris.txt 10
animals	NotreDame_De_Paris.txt 12
animam	NotreDame_De_Paris.txt 1
animated	NotreDame_De_Paris.txt 5
animation	NotreDame_De_Paris.txt 1
animosity	NotreDame_De_Paris.txt 1
ankles	NotreDame_De_Paris.txt 2
annalists	NotreDame_De_Paris.txt 1
annotating	NotreDame_De_Paris.txt 1
announce	NotreDame_De_Paris.txt 6
announced	NotreDame_De_Paris.txt 9
announces	NotreDame_De_Paris.txt 1
annoyance	NotreDame_De_Paris.txt 2
annoyed	NotreDame_De_Paris.txt 2
annoying	NotreDame_De_Paris.txt 3
annual	NotreDame_De_Paris.txt 1
annunciation	NotreDame_De_Paris.txt 2
anointed	NotreDame_De_Paris.txt 1
another	NotreDame_De_Paris.txt 104
anse	NotreDame_De_Paris.txt 1
answer	NotreDame_De_Paris.txt 6
answered	NotreDame_De_Paris.txt 4
answering	NotreDame_De_Paris.txt 1
answers	NotreDame_De_Paris.txt 2
ant	NotreDame_De_Paris.txt 4
ante	NotreDame_De_Paris.txt 3
antediluvian	NotreDame_De_Paris.txt 1
antennae	NotreDame_De_Paris.txt 2
anterior	NotreDame_De_Paris.txt 3
anthem	NotreDame_De_Paris.txt 1
anthill	NotreDame_De_Paris.txt 1
antichrist	NotreDame_De_Paris.txt 2
antiquarian	NotreDame_De_Paris.txt 1
antiquary	NotreDame_De_Paris.txt 1
antiquated	NotreDame_De_Paris.txt 1
antique	NotreDame_De_Paris.txt 2
antiquity	NotreDame_De_Paris.txt 3
antlers	NotreDame_De_Paris.txt 1
antoine	NotreDame_De_Paris.txt 16
antonius	NotreDame_De_Paris.txt 1
antwerp	NotreDame_De_Paris.txt 1
anvil	NotreDame_De_Paris.txt 1
anxiety	NotreDame_De_Paris.txt 8
anxious	NotreDame_De_Paris.txt 2
any	NotreDame_De_Paris.txt 153
anybody	NotreDame_De_Paris.txt 2
anyone	NotreDame_De_Paris.txt 5
anything	NotreDame_De_Paris.txt 48
anywhere	NotreDame_De_Paris.txt 4
apart	NotreDame_De_Paris.txt 1
apartment	NotreDame_De_Paris.txt 8
apartments	NotreDame_De_Paris.txt 2
apathetic	NotreDame_De_Paris.txt 1
ape	NotreDame_De_Paris.txt 2
aperture	NotreDame_De_Paris.txt 5
apertures	NotreDame_De_Paris.txt 1
apes	NotreDame_De_Paris.txt 1
apex	NotreDame_De_Paris.txt 1
api	NotreDame_De_Paris.txt 1
apiece	NotreDame_De_Paris.txt 3
apocalypse	NotreDame_De_Paris.txt 1
apollo	NotreDame_De_Paris.txt 2
apology	NotreDame_De_Paris.txt 4
apoplectic	NotreDame_De_Paris.txt 1
apostatare	NotreDame_De_Paris.txt 1
apostate	NotreDame_De_Paris.txt 4
apostrophe	NotreDame_De_Paris.txt 1
apostrophes	NotreDame_De_Paris.txt 1
apostrophized	NotreDame_De_Paris.txt 1
apothecary	NotreDame_De_Paris.txt 1
appalling	NotreDame_De_Paris.txt 1
appanaged	NotreDame_De_Paris.txt 1
apparatus	NotreDame_De_Paris.txt 5
apparent	NotreDame_De_Paris.txt 6
apparently	NotreDame_De_Paris.txt 2
apparition	NotreDame_De_Paris.txt 7
appeal	NotreDame_De_Paris.txt 2
appeals	NotreDame_De_Paris.txt 2
appear	NotreDame_De_Paris.txt 24
appearance	NotreDame_De_Paris.txt 18
appearances	NotreDame_De_Paris.txt 1
appeared	NotreDame_De_Paris.txt 60
appearing	NotreDame_De_Paris.txt 4
appears	NotreDame_De_Paris.txt 15
appease	NotreDame_De_Paris.txt 2
appeased	NotreDame_De_Paris.txt 2
appertaining	NotreDame_De_Paris.txt 2
appetite	NotreDame_De_Paris.txt 5
appetizing	NotreDame_De_Paris.txt 1
applaud	NotreDame_De_Paris.txt 1
applauded	NotreDame_De_Paris.txt 11
applause	NotreDame_De_Paris.txt 11
apple	NotreDame_De_Paris.txt 12
apples	NotreDame_De_Paris.txt 3
applicable	NotreDame_De_Paris.txt 4
application	NotreDame_De_Paris.txt 2
applied	NotreDame_De_Paris.txt 2
apply	NotreDame_De_Paris.txt 5
applying	NotreDame_De_Paris.txt 1
appointed	NotreDame_De_Paris.txt 2
appointment	NotreDame_De_Paris.txt 4
appointments	NotreDame_De_Paris.txt 1
appreciate	NotreDame_De_Paris.txt 1
appreciated	NotreDame_De_Paris.txt 1
apprehend	NotreDame_De_Paris.txt 1
apprehended	NotreDame_De_Paris.txt 1
apprentice	NotreDame_De_Paris.txt 1
approach	NotreDame_De_Paris.txt 19
approached	NotreDame_De_Paris.txt 42
approaches	NotreDame_De_Paris.txt 1
approaching	NotreDame_De_Paris.txt 8
approbation	NotreDame_De_Paris.txt 1
appropriate	NotreDame_De_Paris.txt 1
approved	NotreDame_De_Paris.txt 1
apricot	NotreDame_De_Paris.txt 1
april	NotreDame_De_Paris.txt 6
aprons	NotreDame_De_Paris.txt 1
apropos	NotreDame_De_Paris.txt 1
apse	NotreDame_De_Paris.txt 9
apses	NotreDame_De_Paris.txt 1
aquin	NotreDame_De_Paris.txt 1
aquoe	NotreDame_De_Paris.txt 1
arabesques	NotreDame_De_Paris.txt 8
arabian	NotreDame_De_Paris.txt 2
arabs	NotreDame_De_Paris.txt 1
arbitrary	NotreDame_De_Paris.txt 1
arbitrio	NotreDame_De_Paris.txt 1
arc	NotreDame_De_Paris.txt 1
arcade	NotreDame_De_Paris.txt 1
arcades	NotreDame_De_Paris.txt 3
arch	NotreDame_De_Paris.txt 24
archangel	NotreDame_De_Paris.txt 2
archbishop	NotreDame_De_Paris.txt 5
archbishops	NotreDame_De_Paris.txt 1
archdeacon	NotreDame_De_Paris.txt 209
archduke	NotreDame_De_Paris.txt 4
arched	NotreDame_De_Paris.txt 6
archer	NotreDame_De_Paris.txt 8
archers	NotreDame_De_Paris.txt 17
arches	NotreDame_De_Paris.txt 22
archiepiscopal	NotreDame_De_Paris.txt 2
archipelagos	NotreDame_De_Paris.txt 1
architect	NotreDame_De_Paris.txt 13
architects	NotreDame_De_Paris.txt 9
architectural	NotreDame_De_Paris.txt 10
architecture	NotreDame_De_Paris.txt 99
architectures	NotreDame_De_Paris.txt 5
architrave	NotreDame_De_Paris.txt 1
archive	NotreDame_De_Paris.txt 13
arcs	NotreDame_De_Paris.txt 3
ardent	NotreDame_De_Paris.txt 5
ardently	NotreDame_De_Paris.txt 2
ardents	NotreDame_De_Paris.txt 1
ardor	NotreDame_De_Paris.txt 3
are	NotreDame_De_Paris.txt 532
area	NotreDame_De_Paris.txt 1
argot	NotreDame_De_Paris.txt 9
argotier	NotreDame_De_Paris.txt 1
argotiers	NotreDame_De_Paris.txt 1
ariadne	NotreDame_De_Paris.txt 1
arise	NotreDame_De_Paris.txt 2
arisen	NotreDame_De_Paris.txt 1
arising	NotreDame_De_Paris.txt 1
aristoteles	NotreDame_De_Paris.txt 1
aristotle	NotreDame_De_Paris.txt 3
ark	NotreDame_De_Paris.txt 1
arm	NotreDame_De_Paris.txt 73
armchair	NotreDame_De_Paris.txt 3
armed	NotreDame_De_Paris.txt 17
armenia	NotreDame_De_Paris.txt 1
armenian	NotreDame_De_Paris.txt 1
armies	NotreDame_De_Paris.txt 1
arming	NotreDame_De_Paris.txt 2
armor	NotreDame_De_Paris.txt 9
armorial	NotreDame_De_Paris.txt 12
armpit	NotreDame_De_Paris.txt 1
arms	NotreDame_De_Paris.txt 71
army	NotreDame_De_Paris.txt 4
arnoul	NotreDame_De_Paris.txt 1
arose	NotreDame_De_Paris.txt 7
around	NotreDame_De_Paris.txt 84
arouse	NotreDame_De_Paris.txt 1
aroused	NotreDame_De_Paris.txt 10
arpeggios	NotreDame_De_Paris.txt 1
arquebus	NotreDame_De_Paris.txt 1
arquebuses	NotreDame_De_Paris.txt 4
arrange	NotreDame_De_Paris.txt 3
arranged	NotreDame_De_Paris.txt 14
arrangement	NotreDame_De_Paris.txt 2
arrangements	NotreDame_De_Paris.txt 1
arranging	NotreDame_De_Paris.txt 1
arrant	NotreDame_De_Paris.txt 1
arras	NotreDame_De_Paris.txt 4
array	NotreDame_De_Paris.txt 3
arrayed	NotreDame_De_Paris.txt 1
arrest	NotreDame_De_Paris.txt 1
arrested	NotreDame_De_Paris.txt 3
arricidie	NotreDame_De_Paris.txt 1
arrival	NotreDame_De_Paris.txt 11
arrivals	NotreDame_De_Paris.txt 1
arrive	NotreDame_De_Paris.txt 8
arrived	NotreDame_De_Paris.txt 33
arrives	NotreDame_De_Paris.txt 3
arriving	NotreDame_De_Paris.txt 10
arrogance	NotreDame_De_Paris.txt 1
arrogant	NotreDame_De_Paris.txt 1
arrow	NotreDame_De_Paris.txt 5
arrows	NotreDame_De_Paris.txt 2
arsenac	NotreDame_De_Paris.txt 1
arsenal	NotreDame_De_Paris.txt 1
arsenals	NotreDame_De_Paris.txt 1
arsenic	NotreDame_De_Paris.txt 2
art	NotreDame_De_Paris.txt 75
arterial	NotreDame_De_Paris.txt 1
arteries	NotreDame_De_Paris.txt 2
artful	NotreDame_De_Paris.txt 1
article	NotreDame_De_Paris.txt 1
articles	NotreDame_De_Paris.txt 2
articulate	NotreDame_De_Paris.txt 4
articulated	NotreDame_De_Paris.txt 1
articulating	NotreDame_De_Paris.txt 1
artilleries	NotreDame_De_Paris.txt 1
artillery	NotreDame_De_Paris.txt 6
artisan	NotreDame_De_Paris.txt 1
artisans	NotreDame_De_Paris.txt 1
artist	NotreDame_De_Paris.txt 11
artistic	NotreDame_De_Paris.txt 3
artistically	NotreDame_De_Paris.txt 2
artists	NotreDame_De_Paris.txt 2
arts	NotreDame_De_Paris.txt 14
as	NotreDame_De_Paris.txt 869
ascanio	NotreDame_De_Paris.txt 1
ascend	NotreDame_De_Paris.txt 11
ascended	NotreDame_De_Paris.txt 14
ascendency	NotreDame_De_Paris.txt 1
ascending	NotreDame_De_Paris.txt 9
ascends	NotreDame_De_Paris.txt 2
ascent	NotreDame_De_Paris.txt 5
ascertaining	NotreDame_De_Paris.txt 1
ascii	NotreDame_De_Paris.txt 2
ashamed	NotreDame_De_Paris.txt 2
ashes	NotreDame_De_Paris.txt 11
ashy	NotreDame_De_Paris.txt 2
asian	NotreDame_De_Paris.txt 1
aside	NotreDame_De_Paris.txt 19
asinus	NotreDame_De_Paris.txt 1
ask	NotreDame_De_Paris.txt 24
askance	NotreDame_De_Paris.txt 1
asked	NotreDame_De_Paris.txt 30
askew	NotreDame_De_Paris.txt 1
asking	NotreDame_De_Paris.txt 7
asks	NotreDame_De_Paris.txt 1
asleep	NotreDame_De_Paris.txt 10
aspect	NotreDame_De_Paris.txt 13
aspects	NotreDame_De_Paris.txt 4
asphyxiated	NotreDame_De_Paris.txt 1
asps	NotreDame_De_Paris.txt 1
ass	NotreDame_De_Paris.txt 4
assailant	NotreDame_De_Paris.txt 1
assailants	NotreDame_De_Paris.txt 7
assailed	NotreDame_De_Paris.txt 5
assassin	NotreDame_De_Paris.txt 7
assassinated	NotreDame_De_Paris.txt 4
assassination	NotreDame_De_Paris.txt 1
assassins	NotreDame_De_Paris.txt 2
assault	NotreDame_De_Paris.txt 10
assembled	NotreDame_De_Paris.txt 4
assemblies	NotreDame_De_Paris.txt 1
assembly	NotreDame_De_Paris.txt 7
assent	NotreDame_De_Paris.txt 1
assented	NotreDame_De_Paris.txt 1
assert	NotreDame_De_Paris.txt 2
asserted	NotreDame_De_Paris.txt 1
asses	NotreDame_De_Paris.txt 2
assessed	NotreDame_De_Paris.txt 1
assiduous	NotreDame_De_Paris.txt 1
assimilates	NotreDame_De_Paris.txt 1
assist	NotreDame_De_Paris.txt 2
assistance	NotreDame_De_Paris.txt 3
assistant	NotreDame_De_Paris.txt 2
assistants	NotreDame_De_Paris.txt 7
assisted	NotreDame_De_Paris.txt 2
associated	NotreDame_De_Paris.txt 8
assommeur	NotreDame_De_Paris.txt 1
assume	NotreDame_De_Paris.txt 6
assumed	NotreDame_De_Paris.txt 19
assumes	NotreDame_De_Paris.txt 1
assuming	NotreDame_De_Paris.txt 4
assurance	NotreDame_De_Paris.txt 2
assure	NotreDame_De_Paris.txt 9
assured	NotreDame_De_Paris.txt 3
assuredly	NotreDame_De_Paris.txt 12
ast	NotreDame_De_Paris.txt 3
astolphus	NotreDame_De_Paris.txt 1
astonish	NotreDame_De_Paris.txt 2
astonished	NotreDame_De_Paris.txt 12
astonishment	NotreDame_De_Paris.txt 9
astound	NotreDame_De_Paris.txt 1
astounded	NotreDame_De_Paris.txt 3
astray	NotreDame_De_Paris.txt 1
astride	NotreDame_De_Paris.txt 3
astrologer	NotreDame_De_Paris.txt 1
astrologers	NotreDame_De_Paris.txt 1
astrologies	NotreDame_De_Paris.txt 1
astrology	NotreDame_De_Paris.txt 7
asturias	NotreDame_De_Paris.txt 1
asunder	NotreDame_De_Paris.txt 2
asylum	NotreDame_De_Paris.txt 14
at	NotreDame_De_Paris.txt 1345
ate	NotreDame_De_Paris.txt 5
athens	NotreDame_De_Paris.txt 1
athletic	NotreDame_De_Paris.txt 1
athwart	NotreDame_De_Paris.txt 3
atmosphere	NotreDame_De_Paris.txt 2
atoms	NotreDame_De_Paris.txt 2
atque	NotreDame_De_Paris.txt 1
atra	NotreDame_De_Paris.txt 1
atrocious	NotreDame_De_Paris.txt 1
atrophied	NotreDame_De_Paris.txt 1
attach	NotreDame_De_Paris.txt 2
attached	NotreDame_De_Paris.txt 13
attaches	NotreDame_De_Paris.txt 2
attachment	NotreDame_De_Paris.txt 2
attack	NotreDame_De_Paris.txt 8
attacked	NotreDame_De_Paris.txt 5
attacking	NotreDame_De_Paris.txt 5
attacks	NotreDame_De_Paris.txt 1
attain	NotreDame_De_Paris.txt 2
attained	NotreDame_De_Paris.txt 4
attains	NotreDame_De_Paris.txt 1
attempt	NotreDame_De_Paris.txt 7
attempted	NotreDame_De_Paris.txt 4
attempts	NotreDame_De_Paris.txt 1
attend	NotreDame_De_Paris.txt 2
attended	NotreDame_De_Paris.txt 2
attending	NotreDame_De_Paris.txt 1
attention	NotreDame_De_Paris.txt 40
attentions	NotreDame_De_Paris.txt 1
attentive	NotreDame_De_Paris.txt 6
attentively	NotreDame_De_Paris.txt 6
attic	NotreDame_De_Paris.txt 5
attics	NotreDame_De_Paris.txt 2
attire	NotreDame_De_Paris.txt 2
attired	NotreDame_De_Paris.txt 3
attitude	NotreDame_De_Paris.txt 22
attitudes	NotreDame_De_Paris.txt 5
attorneys	NotreDame_De_Paris.txt 1
attract	NotreDame_De_Paris.txt 3
attracted	NotreDame_De_Paris.txt 7
attracting	NotreDame_De_Paris.txt 1
attributes	NotreDame_De_Paris.txt 1
au	NotreDame_De_Paris.txt 11
aubergeon	NotreDame_De_Paris.txt 1
aubervilliers	NotreDame_De_Paris.txt 1
aubriot	NotreDame_De_Paris.txt 1
aubry	NotreDame_De_Paris.txt 1
auctioneer	NotreDame_De_Paris.txt 1
audacious	NotreDame_De_Paris.txt 5
audaciously	NotreDame_De_Paris.txt 3
audacity	NotreDame_De_Paris.txt 4
aude	NotreDame_De_Paris.txt 1
audemer	NotreDame_De_Paris.txt 1
audible	NotreDame_De_Paris.txt 8
audience	NotreDame_De_Paris.txt 28
audit	NotreDame_De_Paris.txt 1
auditor	NotreDame_De_Paris.txt 11
auditores	NotreDame_De_Paris.txt 1
auditors	NotreDame_De_Paris.txt 2
augment	NotreDame_De_Paris.txt 1
augmentation	NotreDame_De_Paris.txt 1
augmented	NotreDame_De_Paris.txt 2
august	NotreDame_De_Paris.txt 8
augustin	NotreDame_De_Paris.txt 1
augustine	NotreDame_De_Paris.txt 1
augustines	NotreDame_De_Paris.txt 1
augustins	NotreDame_De_Paris.txt 1
augustus	NotreDame_De_Paris.txt 12
aunt	NotreDame_De_Paris.txt 2
austere	NotreDame_De_Paris.txt 4
austerity	NotreDame_De_Paris.txt 3
austria	NotreDame_De_Paris.txt 8
aut	NotreDame_De_Paris.txt 1
author	NotreDame_De_Paris.txt 22
authority	NotreDame_De_Paris.txt 4
authors	NotreDame_De_Paris.txt 1
autun	NotreDame_De_Paris.txt 3
aux	NotreDame_De_Paris.txt 30
auxerre	NotreDame_De_Paris.txt 1
auxerrois	NotreDame_De_Paris.txt 2
available	NotreDame_De_Paris.txt 2
avails	NotreDame_De_Paris.txt 1
avaritiam	NotreDame_De_Paris.txt 1
avayveia	NotreDame_De_Paris.txt 1
avayxoqpayia	NotreDame_De_Paris.txt 1
ave	NotreDame_De_Paris.txt 3
avenging	NotreDame_De_Paris.txt 1
avenues	NotreDame_De_Paris.txt 1
averro	NotreDame_De_Paris.txt 4
aves	NotreDame_De_Paris.txt 1
aviaries	NotreDame_De_Paris.txt 1
aviary	NotreDame_De_Paris.txt 1
avidity	NotreDame_De_Paris.txt 1
avoid	NotreDame_De_Paris.txt 2
avoided	NotreDame_De_Paris.txt 2
avow	NotreDame_De_Paris.txt 1
avowed	NotreDame_De_Paris.txt 1
avril	NotreDame_De_Paris.txt 1
avrillot	NotreDame_De_Paris.txt 1
await	NotreDame_De_Paris.txt 2
awaiting	NotreDame_De_Paris.txt 4
awake	NotreDame_De_Paris.txt 7
awaken	NotreDame_De_Paris.txt 6
awakened	NotreDame_De_Paris.txt 9
awakening	NotreDame_De_Paris.txt 3
awakens	NotreDame_De_Paris.txt 2
awaking	NotreDame_De_Paris.txt 2
aware	NotreDame_De_Paris.txt 9
away	NotreDame_De_Paris.txt 106
awkward	NotreDame_De_Paris.txt 10
awkwardly	NotreDame_De_Paris.txt 4
awkwardness	NotreDame_De_Paris.txt 1
awoke	NotreDame_De_Paris.txt 3
axe	NotreDame_De_Paris.txt 2
axes	NotreDame_De_Paris.txt 2
axle	NotreDame_De_Paris.txt 2
ay	NotreDame_De_Paris.txt 1
aymoire	NotreDame_De_Paris.txt 1
azure	NotreDame_De_Paris.txt 4
azurini	NotreDame_De_Paris.txt 1
