n	Miserables.txt 17
nabbed	Miserables.txt 5
nabbing	Miserables.txt 1
nadir	Miserables.txt 1
nag	Miserables.txt 1
nahenry	Miserables.txt 1
naiad	Miserables.txt 1
naigeon	Miserables.txt 2
nail	Miserables.txt 40
nailed	Miserables.txt 25
nailing	Miserables.txt 4
nails	Miserables.txt 29
nain	Miserables.txt 1
naive	Miserables.txt 2
naively	Miserables.txt 1
naked	Miserables.txt 26
nakedness	Miserables.txt 5
name	Miserables.txt 432
named	Miserables.txt 65
nameless	Miserables.txt 2
names	Miserables.txt 73
naming	Miserables.txt 1
namur	Miserables.txt 1
nankeen	Miserables.txt 1
nankin	Miserables.txt 2
nanterre	Miserables.txt 4
nantes	Miserables.txt 2
nap	Miserables.txt 1
naparte	Miserables.txt 1
nape	Miserables.txt 6
napery	Miserables.txt 1
napkin	Miserables.txt 1
napkins	Miserables.txt 1
naples	Miserables.txt 5
napoleon	Miserables.txt 143
napoleons	Miserables.txt 8
narcissus	Miserables.txt 1
narcotic	Miserables.txt 2
nargaud	Miserables.txt 1
narquois	Miserables.txt 1
narrate	Miserables.txt 4
narrated	Miserables.txt 6
narrates	Miserables.txt 1
narrating	Miserables.txt 4
narrations	Miserables.txt 1
narrative	Miserables.txt 1
narrator	Miserables.txt 4
narrow	Miserables.txt 58
narrowed	Miserables.txt 2
narrower	Miserables.txt 4
narrowly	Miserables.txt 1
narses	Miserables.txt 1
nasal	Miserables.txt 3
nasica	Miserables.txt 1
nassau	Miserables.txt 4
nassaus	Miserables.txt 2
nasty	Miserables.txt 1
natal	Miserables.txt 1
nation	Miserables.txt 47
national	Miserables.txt 59
nationalities	Miserables.txt 1
nationality	Miserables.txt 1
nations	Miserables.txt 29
native	Miserables.txt 9
nativity	Miserables.txt 1
natoire	Miserables.txt 1
natural	Miserables.txt 48
naturalist	Miserables.txt 1
naturalists	Miserables.txt 1
naturalize	Miserables.txt 1
naturalized	Miserables.txt 1
naturally	Miserables.txt 15
naturalness	Miserables.txt 1
nature	Miserables.txt 143
natured	Miserables.txt 4
naturedly	Miserables.txt 1
natures	Miserables.txt 18
naughty	Miserables.txt 4
naval	Miserables.txt 3
navarre	Miserables.txt 1
navet	Miserables.txt 3
navigating	Miserables.txt 1
navigation	Miserables.txt 2
naviguer	Miserables.txt 1
navy	Miserables.txt 2
nazareth	Miserables.txt 2
ne	Miserables.txt 8
near	Miserables.txt 268
nearer	Miserables.txt 19
nearest	Miserables.txt 10
nearing	Miserables.txt 1
nearly	Miserables.txt 102
neat	Miserables.txt 11
neath	Miserables.txt 1
neatherd	Miserables.txt 1
neatly	Miserables.txt 5
nebula	Miserables.txt 1
nebulous	Miserables.txt 1
necessaries	Miserables.txt 1
necessarily	Miserables.txt 12
necessary	Miserables.txt 127
necessitating	Miserables.txt 1
necessities	Miserables.txt 6
necessitous	Miserables.txt 2
necessity	Miserables.txt 39
neck	Miserables.txt 72
necked	Miserables.txt 6
necker	Miserables.txt 1
necklace	Miserables.txt 3
necklet	Miserables.txt 4
necklets	Miserables.txt 3
necks	Miserables.txt 5
neckties	Miserables.txt 1
nectar	Miserables.txt 1
nee	Miserables.txt 1
need	Miserables.txt 100
needed	Miserables.txt 23
needham	Miserables.txt 2
needle	Miserables.txt 7
needles	Miserables.txt 4
needlework	Miserables.txt 1
needs	Miserables.txt 27
needy	Miserables.txt 1
nefas	Miserables.txt 1
negation	Miserables.txt 1
negative	Miserables.txt 3
neglect	Miserables.txt 1
neglected	Miserables.txt 9
neglecting	Miserables.txt 1
neglects	Miserables.txt 2
negligence	Miserables.txt 1
negligent	Miserables.txt 1
negotiations	Miserables.txt 1
negro	Miserables.txt 4
negroes	Miserables.txt 1
neiges	Miserables.txt 1
neighbor	Miserables.txt 34
neighborhood	Miserables.txt 43
neighboring	Miserables.txt 25
neighborliness	Miserables.txt 1
neighbors	Miserables.txt 21
neighing	Miserables.txt 1
neither	Miserables.txt 130
nemo	Miserables.txt 1
nemorin	Miserables.txt 2
neologism	Miserables.txt 1
nephew	Miserables.txt 6
neptune	Miserables.txt 1
nereids	Miserables.txt 1
neri	Miserables.txt 2
nero	Miserables.txt 7
neros	Miserables.txt 1
nerval	Miserables.txt 1
nerved	Miserables.txt 1
nerves	Miserables.txt 1
nervous	Miserables.txt 3
nest	Miserables.txt 19
nesting	Miserables.txt 1
nestle	Miserables.txt 1
nestled	Miserables.txt 2
nestling	Miserables.txt 1
nestor	Miserables.txt 1
nests	Miserables.txt 7
net	Miserables.txt 12
nets	Miserables.txt 3
netting	Miserables.txt 4
nettle	Miserables.txt 9
nettles	Miserables.txt 10
netto	Miserables.txt 1
network	Miserables.txt 9
networks	Miserables.txt 1
neuf	Miserables.txt 7
neufchateau	Miserables.txt 2
neuilly	Miserables.txt 5
neustadt	Miserables.txt 1
neuter	Miserables.txt 1
neutral	Miserables.txt 3
neutrality	Miserables.txt 1
neutralized	Miserables.txt 1
neuve	Miserables.txt 6
never	Miserables.txt 402
nevers	Miserables.txt 2
nevertheless	Miserables.txt 149
new	Miserables.txt 163
newborn	Miserables.txt 1
newby	Miserables.txt 1
newcomer	Miserables.txt 8
newly	Miserables.txt 4
news	Miserables.txt 12
newsletter	Miserables.txt 1
newspaper	Miserables.txt 6
newspapers	Miserables.txt 23
newton	Miserables.txt 2
next	Miserables.txt 50
ney	Miserables.txt 14
nez	Miserables.txt 4
niagara	Miserables.txt 1
nibble	Miserables.txt 1
nibbled	Miserables.txt 1
nibbling	Miserables.txt 3
nicaise	Miserables.txt 1
nice	Miserables.txt 16
nicely	Miserables.txt 3
niche	Miserables.txt 8
niches	Miserables.txt 1
nicholas	Miserables.txt 3
nicholases	Miserables.txt 1
nick	Miserables.txt 1
nicked	Miserables.txt 1
nickname	Miserables.txt 8
nicknamed	Miserables.txt 3
nicknames	Miserables.txt 1
nicolas	Miserables.txt 3
nicolette	Miserables.txt 34
nid	Miserables.txt 1
nie	Miserables.txt 1
niece	Miserables.txt 3
night	Miserables.txt 447
nightcap	Miserables.txt 1
nightcaps	Miserables.txt 1
nightfall	Miserables.txt 29
nightingale	Miserables.txt 3
nightingales	Miserables.txt 2
nightmare	Miserables.txt 6
nightmares	Miserables.txt 1
nights	Miserables.txt 21
nightstand	Miserables.txt 2
nihilism	Miserables.txt 3
nihilist	Miserables.txt 1
nihilque	Miserables.txt 1
nil	Miserables.txt 1
nile	Miserables.txt 3
nimble	Miserables.txt 2
nimbleness	Miserables.txt 1
nimbly	Miserables.txt 1
nimbus	Miserables.txt 1
nimois	Miserables.txt 1
nine	Miserables.txt 54
ninepins	Miserables.txt 1
nineteen	Miserables.txt 22
nineteenth	Miserables.txt 23
ninety	Miserables.txt 15
nineveh	Miserables.txt 4
nini	Miserables.txt 2
ninnies	Miserables.txt 2
ninny	Miserables.txt 6
ninth	Miserables.txt 4
ninthly	Miserables.txt 1
nipped	Miserables.txt 2
nisi	Miserables.txt 1
nisibi	Miserables.txt 1
nisus	Miserables.txt 1
nitrate	Miserables.txt 1
nitrous	Miserables.txt 1
nivelles	Miserables.txt 18
nivernais	Miserables.txt 1
nix	Miserables.txt 1
no	Miserables.txt 1971
nobility	Miserables.txt 8
noble	Miserables.txt 25
nobly	Miserables.txt 2
nobody	Miserables.txt 8
nocturnal	Miserables.txt 24
nocturne	Miserables.txt 1
nod	Miserables.txt 2
nodded	Miserables.txt 3
noddles	Miserables.txt 2
nodier	Miserables.txt 2
noe	Miserables.txt 1
nogent	Miserables.txt 2
noir	Miserables.txt 1
noire	Miserables.txt 1
noise	Miserables.txt 76
noiseless	Miserables.txt 1
noiselessly	Miserables.txt 1
noises	Miserables.txt 6
noisily	Miserables.txt 9
noisy	Miserables.txt 5
nolle	Miserables.txt 1
nombre	Miserables.txt 1
nomenclature	Miserables.txt 1
nomentanus	Miserables.txt 1
nomina	Miserables.txt 1
non	Miserables.txt 9
nonaindieres	Miserables.txt 1
nonamdieres	Miserables.txt 1
none	Miserables.txt 83
nonproprietary	Miserables.txt 1
nons	Miserables.txt 1
nonsense	Miserables.txt 13
nonsensical	Miserables.txt 1
nonsentient	Miserables.txt 1
nook	Miserables.txt 10
nooks	Miserables.txt 10
noon	Miserables.txt 3
noonday	Miserables.txt 5
nor	Miserables.txt 219
normal	Miserables.txt 3
norman	Miserables.txt 5
normandie	Miserables.txt 2
normandy	Miserables.txt 1
north	Miserables.txt 18
northeast	Miserables.txt 1
northern	Miserables.txt 4
norway	Miserables.txt 2
nos	Miserables.txt 7
nose	Miserables.txt 54
nosed	Miserables.txt 4
nosegay	Miserables.txt 1
noses	Miserables.txt 5
noster	Miserables.txt 2
nostras	Miserables.txt 2
nostrils	Miserables.txt 9
not	Miserables.txt 3802
notabilities	Miserables.txt 1
notable	Miserables.txt 4
notably	Miserables.txt 4
notaire	Miserables.txt 2
notaries	Miserables.txt 2
notary	Miserables.txt 12
notation	Miserables.txt 2
notched	Miserables.txt 1
note	Miserables.txt 63
notebook	Miserables.txt 2
noted	Miserables.txt 13
notes	Miserables.txt 13
nothing	Miserables.txt 736
nothingness	Miserables.txt 10
nothings	Miserables.txt 2
notice	Miserables.txt 33
noticed	Miserables.txt 63
notices	Miserables.txt 2
noticing	Miserables.txt 3
notification	Miserables.txt 1
notifies	Miserables.txt 2
notify	Miserables.txt 1
noting	Miserables.txt 1
notion	Miserables.txt 5
notions	Miserables.txt 1
notoriete	Miserables.txt 1
notoriety	Miserables.txt 2
notorious	Miserables.txt 2
notre	Miserables.txt 21
notwithstanding	Miserables.txt 1
nought	Miserables.txt 2
nourish	Miserables.txt 3
nourished	Miserables.txt 1
nourishes	Miserables.txt 1
nourishing	Miserables.txt 1
nourishment	Miserables.txt 4
nous	Miserables.txt 16
nov	Miserables.txt 1
novel	Miserables.txt 9
novelties	Miserables.txt 2
novelty	Miserables.txt 4
novi	Miserables.txt 1
novice	Miserables.txt 4
novices	Miserables.txt 8
novum	Miserables.txt 1
now	Miserables.txt 568
nowadays	Miserables.txt 18
nowhere	Miserables.txt 4
nowise	Miserables.txt 1
noxious	Miserables.txt 1
nude	Miserables.txt 9
nudged	Miserables.txt 1
nudges	Miserables.txt 1
nudity	Miserables.txt 8
nuit	Miserables.txt 2
null	Miserables.txt 1
number	Miserables.txt 77
numbered	Miserables.txt 4
numbering	Miserables.txt 1
numbers	Miserables.txt 12
numeration	Miserables.txt 1
numerical	Miserables.txt 1
numerically	Miserables.txt 1
numerous	Miserables.txt 21
nummas	Miserables.txt 1
numskull	Miserables.txt 2
nun	Miserables.txt 41
nunc	Miserables.txt 1
nuncio	Miserables.txt 5
nuns	Miserables.txt 50
nuptial	Miserables.txt 8
nuptials	Miserables.txt 2
nurse	Miserables.txt 10
nursed	Miserables.txt 4
nursery	Miserables.txt 2
nurses	Miserables.txt 6
nursing	Miserables.txt 2
nut	Miserables.txt 5
nutrition	Miserables.txt 1
nutum	Miserables.txt 1
nymph	Miserables.txt 2
nymphaeas	Miserables.txt 1
nymphs	Miserables.txt 3
