p	NotreDame_De_Paris.txt 10
pace	NotreDame_De_Paris.txt 7
paced	NotreDame_De_Paris.txt 4
paces	NotreDame_De_Paris.txt 11
pacifique	NotreDame_De_Paris.txt 1
pack	NotreDame_De_Paris.txt 10
package	NotreDame_De_Paris.txt 1
packed	NotreDame_De_Paris.txt 1
packing	NotreDame_De_Paris.txt 1
paclet	NotreDame_De_Paris.txt 2
padelt	NotreDame_De_Paris.txt 1
pagan	NotreDame_De_Paris.txt 3
paganism	NotreDame_De_Paris.txt 1
pagans	NotreDame_De_Paris.txt 2
page	NotreDame_De_Paris.txt 11
pages	NotreDame_De_Paris.txt 10
pagoda	NotreDame_De_Paris.txt 3
pagodas	NotreDame_De_Paris.txt 2
paid	NotreDame_De_Paris.txt 21
pain	NotreDame_De_Paris.txt 13
pained	NotreDame_De_Paris.txt 2
painful	NotreDame_De_Paris.txt 3
pains	NotreDame_De_Paris.txt 3
painted	NotreDame_De_Paris.txt 22
painter	NotreDame_De_Paris.txt 1
painters	NotreDame_De_Paris.txt 1
painting	NotreDame_De_Paris.txt 3
paintings	NotreDame_De_Paris.txt 2
pair	NotreDame_De_Paris.txt 6
pairs	NotreDame_De_Paris.txt 1
palace	NotreDame_De_Paris.txt 44
palaces	NotreDame_De_Paris.txt 12
paladin	NotreDame_De_Paris.txt 1
palais	NotreDame_De_Paris.txt 22
pale	NotreDame_De_Paris.txt 33
paler	NotreDame_De_Paris.txt 1
palestrina	NotreDame_De_Paris.txt 1
palimpsest	NotreDame_De_Paris.txt 1
pallet	NotreDame_De_Paris.txt 14
pallid	NotreDame_De_Paris.txt 5
palm	NotreDame_De_Paris.txt 2
palmer	NotreDame_De_Paris.txt 1
palpable	NotreDame_De_Paris.txt 4
palpitate	NotreDame_De_Paris.txt 3
palpitated	NotreDame_De_Paris.txt 2
palpitating	NotreDame_De_Paris.txt 5
paltry	NotreDame_De_Paris.txt 1
palus	NotreDame_De_Paris.txt 1
pampas	NotreDame_De_Paris.txt 1
pan	NotreDame_De_Paris.txt 8
pandemonium	NotreDame_De_Paris.txt 1
pane	NotreDame_De_Paris.txt 6
panelled	NotreDame_De_Paris.txt 1
panelling	NotreDame_De_Paris.txt 1
panels	NotreDame_De_Paris.txt 2
panes	NotreDame_De_Paris.txt 8
panic	NotreDame_De_Paris.txt 1
panted	NotreDame_De_Paris.txt 2
pantheon	NotreDame_De_Paris.txt 4
panther	NotreDame_De_Paris.txt 1
panting	NotreDame_De_Paris.txt 17
pantomime	NotreDame_De_Paris.txt 2
pantomine	NotreDame_De_Paris.txt 1
papal	NotreDame_De_Paris.txt 4
papale	NotreDame_De_Paris.txt 1
papaliter	NotreDame_De_Paris.txt 1
pape	NotreDame_De_Paris.txt 1
paper	NotreDame_De_Paris.txt 9
papers	NotreDame_De_Paris.txt 2
paperwork	NotreDame_De_Paris.txt 1
paques	NotreDame_De_Paris.txt 1
paquette	NotreDame_De_Paris.txt 18
par	NotreDame_De_Paris.txt 2
para	NotreDame_De_Paris.txt 1
parade	NotreDame_De_Paris.txt 1
paraded	NotreDame_De_Paris.txt 1
paradise	NotreDame_De_Paris.txt 14
paradiso	NotreDame_De_Paris.txt 1
paragraph	NotreDame_De_Paris.txt 11
paragraphs	NotreDame_De_Paris.txt 3
parallel	NotreDame_De_Paris.txt 6
parallelism	NotreDame_De_Paris.txt 1
parallelisms	NotreDame_De_Paris.txt 1
parallelogram	NotreDame_De_Paris.txt 2
paralyzed	NotreDame_De_Paris.txt 1
parapet	NotreDame_De_Paris.txt 6
paraphernalia	NotreDame_De_Paris.txt 1
parcels	NotreDame_De_Paris.txt 1
parch	NotreDame_De_Paris.txt 1
parched	NotreDame_De_Paris.txt 1
parchment	NotreDame_De_Paris.txt 7
parchments	NotreDame_De_Paris.txt 3
parchous	NotreDame_De_Paris.txt 1
pardieu	NotreDame_De_Paris.txt 9
pardon	NotreDame_De_Paris.txt 18
pardoned	NotreDame_De_Paris.txt 2
pared	NotreDame_De_Paris.txt 1
parell	NotreDame_De_Paris.txt 1
parent	NotreDame_De_Paris.txt 1
parentheses	NotreDame_De_Paris.txt 3
parents	NotreDame_De_Paris.txt 8
parfaite	NotreDame_De_Paris.txt 1
paris	NotreDame_De_Paris.txt 272
parisi	NotreDame_De_Paris.txt 1
parisian	NotreDame_De_Paris.txt 15
parisians	NotreDame_De_Paris.txt 8
parisienne	NotreDame_De_Paris.txt 1
parisiensis	NotreDame_De_Paris.txt 1
parisis	NotreDame_De_Paris.txt 25
park	NotreDame_De_Paris.txt 2
parks	NotreDame_De_Paris.txt 1
parle	NotreDame_De_Paris.txt 1
parley	NotreDame_De_Paris.txt 1
parliament	NotreDame_De_Paris.txt 18
parliaments	NotreDame_De_Paris.txt 2
parloi	NotreDame_De_Paris.txt 1
parloir	NotreDame_De_Paris.txt 2
parodied	NotreDame_De_Paris.txt 1
parodies	NotreDame_De_Paris.txt 1
parody	NotreDame_De_Paris.txt 1
paroles	NotreDame_De_Paris.txt 1
parrhisia	NotreDame_De_Paris.txt 1
parrhisian	NotreDame_De_Paris.txt 1
parry	NotreDame_De_Paris.txt 1
part	NotreDame_De_Paris.txt 52
partaking	NotreDame_De_Paris.txt 1
parthenon	NotreDame_De_Paris.txt 6
parti	NotreDame_De_Paris.txt 4
partial	NotreDame_De_Paris.txt 1
participated	NotreDame_De_Paris.txt 1
participation	NotreDame_De_Paris.txt 1
particular	NotreDame_De_Paris.txt 15
particularly	NotreDame_De_Paris.txt 5
parties	NotreDame_De_Paris.txt 1
parting	NotreDame_De_Paris.txt 1
partisans	NotreDame_De_Paris.txt 3
partitions	NotreDame_De_Paris.txt 2
parts	NotreDame_De_Paris.txt 13
party	NotreDame_De_Paris.txt 1
parure	NotreDame_De_Paris.txt 1
parva	NotreDame_De_Paris.txt 1
parvam	NotreDame_De_Paris.txt 1
parvis	NotreDame_De_Paris.txt 27
pas	NotreDame_De_Paris.txt 10
pasque	NotreDame_De_Paris.txt 17
pasquier	NotreDame_De_Paris.txt 3
pass	NotreDame_De_Paris.txt 31
passably	NotreDame_De_Paris.txt 1
passage	NotreDame_De_Paris.txt 20
passages	NotreDame_De_Paris.txt 1
passant	NotreDame_De_Paris.txt 1
passe	NotreDame_De_Paris.txt 2
passed	NotreDame_De_Paris.txt 106
passengers	NotreDame_De_Paris.txt 1
passer	NotreDame_De_Paris.txt 5
passers	NotreDame_De_Paris.txt 15
passes	NotreDame_De_Paris.txt 6
passeur	NotreDame_De_Paris.txt 3
passibus	NotreDame_De_Paris.txt 1
passing	NotreDame_De_Paris.txt 26
passion	NotreDame_De_Paris.txt 17
passionate	NotreDame_De_Paris.txt 7
passionately	NotreDame_De_Paris.txt 1
passions	NotreDame_De_Paris.txt 4
passive	NotreDame_De_Paris.txt 1
password	NotreDame_De_Paris.txt 3
past	NotreDame_De_Paris.txt 11
paste	NotreDame_De_Paris.txt 1
pasticcio	NotreDame_De_Paris.txt 1
pastime	NotreDame_De_Paris.txt 1
pastry	NotreDame_De_Paris.txt 2
patch	NotreDame_De_Paris.txt 2
patched	NotreDame_De_Paris.txt 2
patent	NotreDame_De_Paris.txt 2
patente	NotreDame_De_Paris.txt 1
pater	NotreDame_De_Paris.txt 3
paternal	NotreDame_De_Paris.txt 2
path	NotreDame_De_Paris.txt 5
pathetic	NotreDame_De_Paris.txt 4
paths	NotreDame_De_Paris.txt 1
pathway	NotreDame_De_Paris.txt 1
patience	NotreDame_De_Paris.txt 8
patient	NotreDame_De_Paris.txt 7
patiently	NotreDame_De_Paris.txt 4
patrem	NotreDame_De_Paris.txt 1
patriotism	NotreDame_De_Paris.txt 1
patrol	NotreDame_De_Paris.txt 2
patron	NotreDame_De_Paris.txt 1
patroness	NotreDame_De_Paris.txt 1
patronizing	NotreDame_De_Paris.txt 1
patru	NotreDame_De_Paris.txt 1
patted	NotreDame_De_Paris.txt 2
patter	NotreDame_De_Paris.txt 1
pattern	NotreDame_De_Paris.txt 1
patuit	NotreDame_De_Paris.txt 1
paul	NotreDame_De_Paris.txt 4
paule	NotreDame_De_Paris.txt 1
pauli	NotreDame_De_Paris.txt 1
pause	NotreDame_De_Paris.txt 6
paused	NotreDame_De_Paris.txt 13
pave	NotreDame_De_Paris.txt 1
paved	NotreDame_De_Paris.txt 1
pavement	NotreDame_De_Paris.txt 62
pavements	NotreDame_De_Paris.txt 9
pavilions	NotreDame_De_Paris.txt 1
paving	NotreDame_De_Paris.txt 7
paw	NotreDame_De_Paris.txt 1
paws	NotreDame_De_Paris.txt 1
pax	NotreDame_De_Paris.txt 2
pay	NotreDame_De_Paris.txt 20
payeth	NotreDame_De_Paris.txt 1
paying	NotreDame_De_Paris.txt 7
payment	NotreDame_De_Paris.txt 2
payments	NotreDame_De_Paris.txt 3
paynette	NotreDame_De_Paris.txt 1
pays	NotreDame_De_Paris.txt 1
peace	NotreDame_De_Paris.txt 9
peaceable	NotreDame_De_Paris.txt 2
peacock	NotreDame_De_Paris.txt 1
peaks	NotreDame_De_Paris.txt 1
peal	NotreDame_De_Paris.txt 11
pealed	NotreDame_De_Paris.txt 1
pealing	NotreDame_De_Paris.txt 1
peals	NotreDame_De_Paris.txt 2
pearl	NotreDame_De_Paris.txt 2
pearls	NotreDame_De_Paris.txt 2
peasants	NotreDame_De_Paris.txt 5
peat	NotreDame_De_Paris.txt 1
pebble	NotreDame_De_Paris.txt 3
pebbles	NotreDame_De_Paris.txt 4
pecking	NotreDame_De_Paris.txt 1
pecoris	NotreDame_De_Paris.txt 2
peculiar	NotreDame_De_Paris.txt 15
peculiarly	NotreDame_De_Paris.txt 1
pecuniariam	NotreDame_De_Paris.txt 1
pedagogical	NotreDame_De_Paris.txt 1
pedaso	NotreDame_De_Paris.txt 2
pedes	NotreDame_De_Paris.txt 1
pedestals	NotreDame_De_Paris.txt 1
pedicas	NotreDame_De_Paris.txt 1
pediment	NotreDame_De_Paris.txt 2
peep	NotreDame_De_Paris.txt 1
peeped	NotreDame_De_Paris.txt 1
peeping	NotreDame_De_Paris.txt 1
peerage	NotreDame_De_Paris.txt 1
peered	NotreDame_De_Paris.txt 1
peering	NotreDame_De_Paris.txt 1
peevish	NotreDame_De_Paris.txt 1
pegasus	NotreDame_De_Paris.txt 1
peine	NotreDame_De_Paris.txt 3
pell	NotreDame_De_Paris.txt 7
pelleterie	NotreDame_De_Paris.txt 1
pellibus	NotreDame_De_Paris.txt 1
pen	NotreDame_De_Paris.txt 5
penal	NotreDame_De_Paris.txt 1
penalties	NotreDame_De_Paris.txt 1
penalty	NotreDame_De_Paris.txt 5
penance	NotreDame_De_Paris.txt 5
penancers	NotreDame_De_Paris.txt 1
pendard	NotreDame_De_Paris.txt 1
pendent	NotreDame_De_Paris.txt 2
pendes	NotreDame_De_Paris.txt 1
pending	NotreDame_De_Paris.txt 1
pendre	NotreDame_De_Paris.txt 1
pendulous	NotreDame_De_Paris.txt 1
pendulum	NotreDame_De_Paris.txt 1
penetrate	NotreDame_De_Paris.txt 2
penetrated	NotreDame_De_Paris.txt 5
penetrates	NotreDame_De_Paris.txt 1
penetrating	NotreDame_De_Paris.txt 3
penetration	NotreDame_De_Paris.txt 1
penitent	NotreDame_De_Paris.txt 2
penitential	NotreDame_De_Paris.txt 1
penitents	NotreDame_De_Paris.txt 1
pennon	NotreDame_De_Paris.txt 2
pennons	NotreDame_De_Paris.txt 4
pens	NotreDame_De_Paris.txt 2
pensioner	NotreDame_De_Paris.txt 3
pensive	NotreDame_De_Paris.txt 8
pensively	NotreDame_De_Paris.txt 1
pentagonal	NotreDame_De_Paris.txt 1
pentameter	NotreDame_De_Paris.txt 1
pentecost	NotreDame_De_Paris.txt 3
penthouse	NotreDame_De_Paris.txt 1
penthouses	NotreDame_De_Paris.txt 2
people	NotreDame_De_Paris.txt 134
peopled	NotreDame_De_Paris.txt 2
peperit	NotreDame_De_Paris.txt 1
per	NotreDame_De_Paris.txt 3
perceive	NotreDame_De_Paris.txt 11
perceived	NotreDame_De_Paris.txt 40
perceives	NotreDame_De_Paris.txt 1
perceiving	NotreDame_De_Paris.txt 10
perceptible	NotreDame_De_Paris.txt 5
perception	NotreDame_De_Paris.txt 1
perceptions	NotreDame_De_Paris.txt 1
perchance	NotreDame_De_Paris.txt 17
perched	NotreDame_De_Paris.txt 7
perching	NotreDame_De_Paris.txt 1
perdition	NotreDame_De_Paris.txt 2
perdu	NotreDame_De_Paris.txt 1
peremptorily	NotreDame_De_Paris.txt 1
perfect	NotreDame_De_Paris.txt 9
perfecting	NotreDame_De_Paris.txt 1
perfection	NotreDame_De_Paris.txt 1
perfectly	NotreDame_De_Paris.txt 17
perform	NotreDame_De_Paris.txt 6
performance	NotreDame_De_Paris.txt 1
performances	NotreDame_De_Paris.txt 1
performed	NotreDame_De_Paris.txt 2
performing	NotreDame_De_Paris.txt 4
perfume	NotreDame_De_Paris.txt 1
perfunctory	NotreDame_De_Paris.txt 1
perhaps	NotreDame_De_Paris.txt 37
period	NotreDame_De_Paris.txt 9
periode	NotreDame_De_Paris.txt 1
periodic	NotreDame_De_Paris.txt 1
periodical	NotreDame_De_Paris.txt 1
periods	NotreDame_De_Paris.txt 1
periphrase	NotreDame_De_Paris.txt 1
periphrases	NotreDame_De_Paris.txt 2
perishing	NotreDame_De_Paris.txt 2
peristera	NotreDame_De_Paris.txt 1
permanent	NotreDame_De_Paris.txt 7
permissible	NotreDame_De_Paris.txt 2
permission	NotreDame_De_Paris.txt 9
permit	NotreDame_De_Paris.txt 9
permits	NotreDame_De_Paris.txt 2
permitted	NotreDame_De_Paris.txt 12
permitting	NotreDame_De_Paris.txt 2
pernelle	NotreDame_De_Paris.txt 2
pernicious	NotreDame_De_Paris.txt 1
peroration	NotreDame_De_Paris.txt 1
perpendicular	NotreDame_De_Paris.txt 5
perpendicularly	NotreDame_De_Paris.txt 5
perpetual	NotreDame_De_Paris.txt 6
perpetually	NotreDame_De_Paris.txt 1
perpetuated	NotreDame_De_Paris.txt 1
perpetuating	NotreDame_De_Paris.txt 2
perpetuity	NotreDame_De_Paris.txt 1
perplexed	NotreDame_De_Paris.txt 1
perplexity	NotreDame_De_Paris.txt 1
perrette	NotreDame_De_Paris.txt 1
perrin	NotreDame_De_Paris.txt 1
persecuted	NotreDame_De_Paris.txt 2
persecutors	NotreDame_De_Paris.txt 1
persian	NotreDame_De_Paris.txt 2
persist	NotreDame_De_Paris.txt 5
persisted	NotreDame_De_Paris.txt 5
persists	NotreDame_De_Paris.txt 1
person	NotreDame_De_Paris.txt 42
personage	NotreDame_De_Paris.txt 18
personages	NotreDame_De_Paris.txt 21
personal	NotreDame_De_Paris.txt 2
personification	NotreDame_De_Paris.txt 1
persons	NotreDame_De_Paris.txt 14
perspective	NotreDame_De_Paris.txt 1
perspectives	NotreDame_De_Paris.txt 1
perspiration	NotreDame_De_Paris.txt 7
perspired	NotreDame_De_Paris.txt 1
perspiring	NotreDame_De_Paris.txt 3
persuaded	NotreDame_De_Paris.txt 1
pertinently	NotreDame_De_Paris.txt 1
perturbation	NotreDame_De_Paris.txt 2
peru	NotreDame_De_Paris.txt 2
perused	NotreDame_De_Paris.txt 2
perverse	NotreDame_De_Paris.txt 1
perverted	NotreDame_De_Paris.txt 1
pest	NotreDame_De_Paris.txt 3
pestilence	NotreDame_De_Paris.txt 1
petards	NotreDame_De_Paris.txt 1
peter	NotreDame_De_Paris.txt 9
petersburg	NotreDame_De_Paris.txt 1
petit	NotreDame_De_Paris.txt 22
petitioned	NotreDame_De_Paris.txt 1
petitions	NotreDame_De_Paris.txt 1
petits	NotreDame_De_Paris.txt 2
petrarum	NotreDame_De_Paris.txt 1
petrifaction	NotreDame_De_Paris.txt 1
petrified	NotreDame_De_Paris.txt 12
petticoat	NotreDame_De_Paris.txt 7
petticoats	NotreDame_De_Paris.txt 2
pettish	NotreDame_De_Paris.txt 1
petty	NotreDame_De_Paris.txt 4
petulant	NotreDame_De_Paris.txt 1
peuplier	NotreDame_De_Paris.txt 1
peut	NotreDame_De_Paris.txt 1
pewter	NotreDame_De_Paris.txt 2
pg	NotreDame_De_Paris.txt 1
pglaf	NotreDame_De_Paris.txt 8
phantasmagoria	NotreDame_De_Paris.txt 1
phantasmagorical	NotreDame_De_Paris.txt 1
phantasmagories	NotreDame_De_Paris.txt 1
phantom	NotreDame_De_Paris.txt 5
phantoms	NotreDame_De_Paris.txt 4
pharamond	NotreDame_De_Paris.txt 2
pharisee	NotreDame_De_Paris.txt 1
pharmacopolists	NotreDame_De_Paris.txt 1
pharmacopolizing	NotreDame_De_Paris.txt 1
pharmacy	NotreDame_De_Paris.txt 2
phenomena	NotreDame_De_Paris.txt 2
phenomenon	NotreDame_De_Paris.txt 1
phew	NotreDame_De_Paris.txt 1
phial	NotreDame_De_Paris.txt 1
phials	NotreDame_De_Paris.txt 1
phidias	NotreDame_De_Paris.txt 2
philibert	NotreDame_De_Paris.txt 1
philip	NotreDame_De_Paris.txt 12
philippe	NotreDame_De_Paris.txt 12
phillip	NotreDame_De_Paris.txt 1
philosopher	NotreDame_De_Paris.txt 41
philosophers	NotreDame_De_Paris.txt 7
philosophia	NotreDame_De_Paris.txt 1
philosophic	NotreDame_De_Paris.txt 1
philosophical	NotreDame_De_Paris.txt 2
philosophies	NotreDame_De_Paris.txt 3
philosophize	NotreDame_De_Paris.txt 1
philosopho	NotreDame_De_Paris.txt 1
philosophy	NotreDame_De_Paris.txt 11
philtres	NotreDame_De_Paris.txt 1
phiz	NotreDame_De_Paris.txt 1
phlegethon	NotreDame_De_Paris.txt 1
phlegmatic	NotreDame_De_Paris.txt 1
phoebus	NotreDame_De_Paris.txt 215
phoenician	NotreDame_De_Paris.txt 3
phosphoric	NotreDame_De_Paris.txt 1
phosphorus	NotreDame_De_Paris.txt 1
phrase	NotreDame_De_Paris.txt 10
phrases	NotreDame_De_Paris.txt 2
phthisis	NotreDame_De_Paris.txt 1
physical	NotreDame_De_Paris.txt 4
physician	NotreDame_De_Paris.txt 20
physicians	NotreDame_De_Paris.txt 2
physics	NotreDame_De_Paris.txt 2
physiognomy	NotreDame_De_Paris.txt 6
physiological	NotreDame_De_Paris.txt 1
pi	NotreDame_De_Paris.txt 2
picador	NotreDame_De_Paris.txt 1
picard	NotreDame_De_Paris.txt 1
picardos	NotreDame_De_Paris.txt 1
picards	NotreDame_De_Paris.txt 3
picardy	NotreDame_De_Paris.txt 3
picatrix	NotreDame_De_Paris.txt 1
pick	NotreDame_De_Paris.txt 7
pickaxe	NotreDame_De_Paris.txt 1
pickaxes	NotreDame_De_Paris.txt 2
picked	NotreDame_De_Paris.txt 10
picker	NotreDame_De_Paris.txt 1
pickpockets	NotreDame_De_Paris.txt 4
picks	NotreDame_De_Paris.txt 3
picture	NotreDame_De_Paris.txt 12
pictured	NotreDame_De_Paris.txt 3
pictures	NotreDame_De_Paris.txt 1
picturesque	NotreDame_De_Paris.txt 3
piece	NotreDame_De_Paris.txt 37
pieces	NotreDame_De_Paris.txt 10
pierce	NotreDame_De_Paris.txt 5
pierced	NotreDame_De_Paris.txt 17
pierces	NotreDame_De_Paris.txt 3
piercing	NotreDame_De_Paris.txt 10
pierrat	NotreDame_De_Paris.txt 17
pierre	NotreDame_De_Paris.txt 56
piety	NotreDame_De_Paris.txt 2
pig	NotreDame_De_Paris.txt 2
pigrorum	NotreDame_De_Paris.txt 1
pigs	NotreDame_De_Paris.txt 1
pikemen	NotreDame_De_Paris.txt 1
pikernan	NotreDame_De_Paris.txt 1
pikes	NotreDame_De_Paris.txt 9
pilar	NotreDame_De_Paris.txt 1
pile	NotreDame_De_Paris.txt 10
piled	NotreDame_De_Paris.txt 9
piles	NotreDame_De_Paris.txt 6
pilgrim	NotreDame_De_Paris.txt 2
pilgrims	NotreDame_De_Paris.txt 1
piliers	NotreDame_De_Paris.txt 1
piling	NotreDame_De_Paris.txt 1
pill	NotreDame_De_Paris.txt 1
pillage	NotreDame_De_Paris.txt 5
pillaged	NotreDame_De_Paris.txt 2
pillaging	NotreDame_De_Paris.txt 2
pillar	NotreDame_De_Paris.txt 25
pillared	NotreDame_De_Paris.txt 2
pillars	NotreDame_De_Paris.txt 27
pillion	NotreDame_De_Paris.txt 1
pilloried	NotreDame_De_Paris.txt 2
pillories	NotreDame_De_Paris.txt 1
pillory	NotreDame_De_Paris.txt 41
pillow	NotreDame_De_Paris.txt 5
pillows	NotreDame_De_Paris.txt 1
pilon	NotreDame_De_Paris.txt 1
piloria	NotreDame_De_Paris.txt 1
pilot	NotreDame_De_Paris.txt 1
pilou	NotreDame_De_Paris.txt 1
piment	NotreDame_De_Paris.txt 1
pin	NotreDame_De_Paris.txt 4
pincebourde	NotreDame_De_Paris.txt 2
pincers	NotreDame_De_Paris.txt 9
pinched	NotreDame_De_Paris.txt 2
pinching	NotreDame_De_Paris.txt 1
pindaric	NotreDame_De_Paris.txt 1
pine	NotreDame_De_Paris.txt 2
pinioned	NotreDame_De_Paris.txt 1
pink	NotreDame_De_Paris.txt 3
pinnacle	NotreDame_De_Paris.txt 1
pinnacles	NotreDame_De_Paris.txt 2
pinnbus	NotreDame_De_Paris.txt 1
pinnock	NotreDame_De_Paris.txt 1
pins	NotreDame_De_Paris.txt 3
pintadas	NotreDame_De_Paris.txt 1
pints	NotreDame_De_Paris.txt 1
pious	NotreDame_De_Paris.txt 9
piously	NotreDame_De_Paris.txt 2
pipe	NotreDame_De_Paris.txt 2
pipes	NotreDame_De_Paris.txt 1
pirouette	NotreDame_De_Paris.txt 3
pisa	NotreDame_De_Paris.txt 1
pistoliers	NotreDame_De_Paris.txt 2
pitch	NotreDame_De_Paris.txt 3
pitchfork	NotreDame_De_Paris.txt 2
pitchforks	NotreDame_De_Paris.txt 2
piteously	NotreDame_De_Paris.txt 3
pitfalls	NotreDame_De_Paris.txt 1
pitiable	NotreDame_De_Paris.txt 1
pitied	NotreDame_De_Paris.txt 1
pitiful	NotreDame_De_Paris.txt 6
pitiless	NotreDame_De_Paris.txt 7
pits	NotreDame_De_Paris.txt 1
pittance	NotreDame_De_Paris.txt 1
pity	NotreDame_De_Paris.txt 49
pl	NotreDame_De_Paris.txt 1
placards	NotreDame_De_Paris.txt 1
place	NotreDame_De_Paris.txt 214
placed	NotreDame_De_Paris.txt 52
places	NotreDame_De_Paris.txt 21
placing	NotreDame_De_Paris.txt 2
plague	NotreDame_De_Paris.txt 5
plaidoyer	NotreDame_De_Paris.txt 1
plain	NotreDame_De_Paris.txt 9
plainly	NotreDame_De_Paris.txt 8
plains	NotreDame_De_Paris.txt 2
plaint	NotreDame_De_Paris.txt 1
plaintiff	NotreDame_De_Paris.txt 1
plaintive	NotreDame_De_Paris.txt 3
plaintively	NotreDame_De_Paris.txt 1
plait	NotreDame_De_Paris.txt 1
plaited	NotreDame_De_Paris.txt 3
plan	NotreDame_De_Paris.txt 7
plane	NotreDame_De_Paris.txt 2
planets	NotreDame_De_Paris.txt 1
plank	NotreDame_De_Paris.txt 5
planks	NotreDame_De_Paris.txt 4
planned	NotreDame_De_Paris.txt 1
plant	NotreDame_De_Paris.txt 2
planted	NotreDame_De_Paris.txt 7
plantes	NotreDame_De_Paris.txt 1
plaster	NotreDame_De_Paris.txt 9
plastered	NotreDame_De_Paris.txt 1
plate	NotreDame_De_Paris.txt 3
plates	NotreDame_De_Paris.txt 3
platform	NotreDame_De_Paris.txt 24
platforms	NotreDame_De_Paris.txt 2
plato	NotreDame_De_Paris.txt 1
platonic	NotreDame_De_Paris.txt 1
plaudite	NotreDame_De_Paris.txt 1
plausible	NotreDame_De_Paris.txt 2
plautus	NotreDame_De_Paris.txt 3
play	NotreDame_De_Paris.txt 24
played	NotreDame_De_Paris.txt 14
player	NotreDame_De_Paris.txt 1
players	NotreDame_De_Paris.txt 1
playing	NotreDame_De_Paris.txt 6
plays	NotreDame_De_Paris.txt 4
playthings	NotreDame_De_Paris.txt 1
plea	NotreDame_De_Paris.txt 1
plead	NotreDame_De_Paris.txt 1
pleaded	NotreDame_De_Paris.txt 1
pleader	NotreDame_De_Paris.txt 1
pleading	NotreDame_De_Paris.txt 1
pleasant	NotreDame_De_Paris.txt 9
pleasantry	NotreDame_De_Paris.txt 1
please	NotreDame_De_Paris.txt 30
pleased	NotreDame_De_Paris.txt 7
pleases	NotreDame_De_Paris.txt 4
pleasing	NotreDame_De_Paris.txt 3
pleasure	NotreDame_De_Paris.txt 24
pleasures	NotreDame_De_Paris.txt 4
plebeian	NotreDame_De_Paris.txt 1
plenty	NotreDame_De_Paris.txt 4
pliant	NotreDame_De_Paris.txt 1
plot	NotreDame_De_Paris.txt 5
plots	NotreDame_De_Paris.txt 1
plotted	NotreDame_De_Paris.txt 2
ploughshares	NotreDame_De_Paris.txt 1
pluck	NotreDame_De_Paris.txt 2
plucked	NotreDame_De_Paris.txt 3
plucking	NotreDame_De_Paris.txt 1
plucks	NotreDame_De_Paris.txt 1
plum	NotreDame_De_Paris.txt 1
plumage	NotreDame_De_Paris.txt 1
plumaged	NotreDame_De_Paris.txt 1
plume	NotreDame_De_Paris.txt 2
plumed	NotreDame_De_Paris.txt 1
plumes	NotreDame_De_Paris.txt 1
plump	NotreDame_De_Paris.txt 3
plunder	NotreDame_De_Paris.txt 2
plundered	NotreDame_De_Paris.txt 2
plundering	NotreDame_De_Paris.txt 1
plunge	NotreDame_De_Paris.txt 2
plunged	NotreDame_De_Paris.txt 19
plunging	NotreDame_De_Paris.txt 1
plus	NotreDame_De_Paris.txt 5
pluto	NotreDame_De_Paris.txt 1
poaching	NotreDame_De_Paris.txt 1
pocket	NotreDame_De_Paris.txt 12
pockets	NotreDame_De_Paris.txt 1
poderse	NotreDame_De_Paris.txt 1
poem	NotreDame_De_Paris.txt 2
poems	NotreDame_De_Paris.txt 1
poet	NotreDame_De_Paris.txt 56
poetical	NotreDame_De_Paris.txt 1
poetize	NotreDame_De_Paris.txt 1
poetry	NotreDame_De_Paris.txt 10
poets	NotreDame_De_Paris.txt 6
poignant	NotreDame_De_Paris.txt 2
poignard	NotreDame_De_Paris.txt 2
point	NotreDame_De_Paris.txt 82
pointam	NotreDame_De_Paris.txt 1
pointed	NotreDame_De_Paris.txt 42
pointing	NotreDame_De_Paris.txt 7
points	NotreDame_De_Paris.txt 22
poissy	NotreDame_De_Paris.txt 1
pol	NotreDame_De_Paris.txt 7
poland	NotreDame_De_Paris.txt 2
police	NotreDame_De_Paris.txt 19
policemen	NotreDame_De_Paris.txt 3
policy	NotreDame_De_Paris.txt 1
poligny	NotreDame_De_Paris.txt 1
polish	NotreDame_De_Paris.txt 2
polished	NotreDame_De_Paris.txt 2
polishing	NotreDame_De_Paris.txt 1
polite	NotreDame_De_Paris.txt 1
politely	NotreDame_De_Paris.txt 1
politeness	NotreDame_De_Paris.txt 4
politiam	NotreDame_De_Paris.txt 1
politic	NotreDame_De_Paris.txt 1
political	NotreDame_De_Paris.txt 5
politician	NotreDame_De_Paris.txt 1
politics	NotreDame_De_Paris.txt 2
pologne	NotreDame_De_Paris.txt 1
polyglot	NotreDame_De_Paris.txt 1
polyhedron	NotreDame_De_Paris.txt 2
polyphemus	NotreDame_De_Paris.txt 1
pomp	NotreDame_De_Paris.txt 1
pompons	NotreDame_De_Paris.txt 1
pon	NotreDame_De_Paris.txt 1
ponce	NotreDame_De_Paris.txt 1
ponceau	NotreDame_De_Paris.txt 2
pond	NotreDame_De_Paris.txt 2
pondered	NotreDame_De_Paris.txt 1
pondo	NotreDame_De_Paris.txt 1
poniard	NotreDame_De_Paris.txt 6
poniarded	NotreDame_De_Paris.txt 1
poniards	NotreDame_De_Paris.txt 1
pont	NotreDame_De_Paris.txt 40
pontifical	NotreDame_De_Paris.txt 1
pontoise	NotreDame_De_Paris.txt 2
pool	NotreDame_De_Paris.txt 5
poor	NotreDame_De_Paris.txt 176
poorly	NotreDame_De_Paris.txt 1
pope	NotreDame_De_Paris.txt 49
popes	NotreDame_De_Paris.txt 1
popeship	NotreDame_De_Paris.txt 1
popincourt	NotreDame_De_Paris.txt 1
poplar	NotreDame_De_Paris.txt 1
poppy	NotreDame_De_Paris.txt 1
populace	NotreDame_De_Paris.txt 44
popular	NotreDame_De_Paris.txt 18
popularity	NotreDame_De_Paris.txt 1
populated	NotreDame_De_Paris.txt 1
population	NotreDame_De_Paris.txt 2
populi	NotreDame_De_Paris.txt 2
populosa	NotreDame_De_Paris.txt 1
populous	NotreDame_De_Paris.txt 2
porch	NotreDame_De_Paris.txt 11
porches	NotreDame_De_Paris.txt 4
porcos	NotreDame_De_Paris.txt 2
pore	NotreDame_De_Paris.txt 4
pores	NotreDame_De_Paris.txt 2
porn	NotreDame_De_Paris.txt 1
port	NotreDame_De_Paris.txt 9
portable	NotreDame_De_Paris.txt 1
portal	NotreDame_De_Paris.txt 27
portalium	NotreDame_De_Paris.txt 1
portals	NotreDame_De_Paris.txt 3
portcullis	NotreDame_De_Paris.txt 2
porte	NotreDame_De_Paris.txt 36
porter	NotreDame_De_Paris.txt 4
porti	NotreDame_De_Paris.txt 1
portion	NotreDame_De_Paris.txt 4
portions	NotreDame_De_Paris.txt 2
portliness	NotreDame_De_Paris.txt 1
portrayed	NotreDame_De_Paris.txt 2
position	NotreDame_De_Paris.txt 10
positions	NotreDame_De_Paris.txt 1
positive	NotreDame_De_Paris.txt 1
possess	NotreDame_De_Paris.txt 16
possessed	NotreDame_De_Paris.txt 23
possesses	NotreDame_De_Paris.txt 5
possession	NotreDame_De_Paris.txt 14
possessor	NotreDame_De_Paris.txt 1
possibility	NotreDame_De_Paris.txt 2
possible	NotreDame_De_Paris.txt 23
possibly	NotreDame_De_Paris.txt 8
possunt	NotreDame_De_Paris.txt 1
post	NotreDame_De_Paris.txt 16
posted	NotreDame_De_Paris.txt 9
posterity	NotreDame_De_Paris.txt 2
postern	NotreDame_De_Paris.txt 2
posting	NotreDame_De_Paris.txt 1
posts	NotreDame_De_Paris.txt 6
posture	NotreDame_De_Paris.txt 3
pot	NotreDame_De_Paris.txt 6
potatum	NotreDame_De_Paris.txt 1
potestate	NotreDame_De_Paris.txt 1
potion	NotreDame_De_Paris.txt 1
potions	NotreDame_De_Paris.txt 1
pots	NotreDame_De_Paris.txt 9
potter	NotreDame_De_Paris.txt 1
potus	NotreDame_De_Paris.txt 1
pouch	NotreDame_De_Paris.txt 3
pouissepain	NotreDame_De_Paris.txt 1
poulets	NotreDame_De_Paris.txt 1
poultry	NotreDame_De_Paris.txt 2
pound	NotreDame_De_Paris.txt 2
pounds	NotreDame_De_Paris.txt 3
pour	NotreDame_De_Paris.txt 9
pourceaux	NotreDame_De_Paris.txt 3
poured	NotreDame_De_Paris.txt 3
pouring	NotreDame_De_Paris.txt 1
poussepain	NotreDame_De_Paris.txt 14
pout	NotreDame_De_Paris.txt 9
pouted	NotreDame_De_Paris.txt 1
pouting	NotreDame_De_Paris.txt 1
poverty	NotreDame_De_Paris.txt 1
powder	NotreDame_De_Paris.txt 6
powdered	NotreDame_De_Paris.txt 1
power	NotreDame_De_Paris.txt 21
powerful	NotreDame_De_Paris.txt 19
powerfully	NotreDame_De_Paris.txt 2
powerless	NotreDame_De_Paris.txt 4
powers	NotreDame_De_Paris.txt 2
pr	NotreDame_De_Paris.txt 11
practicable	NotreDame_De_Paris.txt 1
practical	NotreDame_De_Paris.txt 1
practically	NotreDame_De_Paris.txt 2
practice	NotreDame_De_Paris.txt 1
practices	NotreDame_De_Paris.txt 1
practise	NotreDame_De_Paris.txt 1
practising	NotreDame_De_Paris.txt 1
pradon	NotreDame_De_Paris.txt 2
pragueries	NotreDame_De_Paris.txt 1
praise	NotreDame_De_Paris.txt 1
praised	NotreDame_De_Paris.txt 2
prancing	NotreDame_De_Paris.txt 2
pratensis	NotreDame_De_Paris.txt 1
pray	NotreDame_De_Paris.txt 14
prayed	NotreDame_De_Paris.txt 4
prayer	NotreDame_De_Paris.txt 9
prayers	NotreDame_De_Paris.txt 6
praying	NotreDame_De_Paris.txt 8
prays	NotreDame_De_Paris.txt 1
pre	NotreDame_De_Paris.txt 3
preached	NotreDame_De_Paris.txt 1
preaches	NotreDame_De_Paris.txt 2
precarious	NotreDame_De_Paris.txt 2
precaution	NotreDame_De_Paris.txt 1
precede	NotreDame_De_Paris.txt 2
preceded	NotreDame_De_Paris.txt 3
preceding	NotreDame_De_Paris.txt 6
precept	NotreDame_De_Paris.txt 1
precincts	NotreDame_De_Paris.txt 1
precious	NotreDame_De_Paris.txt 8
preciously	NotreDame_De_Paris.txt 1
precipice	NotreDame_De_Paris.txt 1
precipitate	NotreDame_De_Paris.txt 1
precipitated	NotreDame_De_Paris.txt 2
precipitately	NotreDame_De_Paris.txt 1
precipitating	NotreDame_De_Paris.txt 1
precisely	NotreDame_De_Paris.txt 12
precision	NotreDame_De_Paris.txt 2
precursor	NotreDame_De_Paris.txt 1
predestination	NotreDame_De_Paris.txt 3
predestinatione	NotreDame_De_Paris.txt 1
predestined	NotreDame_De_Paris.txt 1
predicament	NotreDame_De_Paris.txt 2
predicted	NotreDame_De_Paris.txt 2
predicting	NotreDame_De_Paris.txt 1
predominates	NotreDame_De_Paris.txt 1
preeminence	NotreDame_De_Paris.txt 1
preface	NotreDame_De_Paris.txt 1
prefecture	NotreDame_De_Paris.txt 1
prefer	NotreDame_De_Paris.txt 2
preferred	NotreDame_De_Paris.txt 7
prejudice	NotreDame_De_Paris.txt 1
prelates	NotreDame_De_Paris.txt 2
prelude	NotreDame_De_Paris.txt 1
premature	NotreDame_De_Paris.txt 1
prendre	NotreDame_De_Paris.txt 1
preoccupation	NotreDame_De_Paris.txt 1
preoccupations	NotreDame_De_Paris.txt 1
preoccupied	NotreDame_De_Paris.txt 3
prepare	NotreDame_De_Paris.txt 4
prepared	NotreDame_De_Paris.txt 8
preparing	NotreDame_De_Paris.txt 4
preposterous	NotreDame_De_Paris.txt 2
prerogatives	NotreDame_De_Paris.txt 2
pres	NotreDame_De_Paris.txt 2
prescribed	NotreDame_De_Paris.txt 1
presence	NotreDame_De_Paris.txt 29
present	NotreDame_De_Paris.txt 40
presentable	NotreDame_De_Paris.txt 1
presentation	NotreDame_De_Paris.txt 2
presented	NotreDame_De_Paris.txt 39
presentiment	NotreDame_De_Paris.txt 2
presenting	NotreDame_De_Paris.txt 7
presently	NotreDame_De_Paris.txt 1
presents	NotreDame_De_Paris.txt 1
preservation	NotreDame_De_Paris.txt 2
preserve	NotreDame_De_Paris.txt 9
preserved	NotreDame_De_Paris.txt 16
preserves	NotreDame_De_Paris.txt 1
preserving	NotreDame_De_Paris.txt 1
presided	NotreDame_De_Paris.txt 1
presidency	NotreDame_De_Paris.txt 2
president	NotreDame_De_Paris.txt 23
press	NotreDame_De_Paris.txt 18
pressed	NotreDame_De_Paris.txt 25
presses	NotreDame_De_Paris.txt 1
pressing	NotreDame_De_Paris.txt 9
pressure	NotreDame_De_Paris.txt 1
prester	NotreDame_De_Paris.txt 1
prestige	NotreDame_De_Paris.txt 1
presume	NotreDame_De_Paris.txt 4
presumed	NotreDame_De_Paris.txt 2
presuming	NotreDame_De_Paris.txt 1
presumption	NotreDame_De_Paris.txt 1
pretend	NotreDame_De_Paris.txt 1
pretended	NotreDame_De_Paris.txt 2
pretender	NotreDame_De_Paris.txt 1
pretending	NotreDame_De_Paris.txt 1
pretends	NotreDame_De_Paris.txt 1
pretentions	NotreDame_De_Paris.txt 1
pretext	NotreDame_De_Paris.txt 7
pretexts	NotreDame_De_Paris.txt 1
prettier	NotreDame_De_Paris.txt 4
prettiest	NotreDame_De_Paris.txt 2
prettily	NotreDame_De_Paris.txt 1
pretty	NotreDame_De_Paris.txt 66
prev	NotreDame_De_Paris.txt 1
prevent	NotreDame_De_Paris.txt 13
prevented	NotreDame_De_Paris.txt 5
preventing	NotreDame_De_Paris.txt 1
prevents	NotreDame_De_Paris.txt 1
previous	NotreDame_De_Paris.txt 2
previously	NotreDame_De_Paris.txt 9
prey	NotreDame_De_Paris.txt 6
priapus	NotreDame_De_Paris.txt 1
price	NotreDame_De_Paris.txt 2
pricked	NotreDame_De_Paris.txt 3
pricks	NotreDame_De_Paris.txt 1
pride	NotreDame_De_Paris.txt 6
priest	NotreDame_De_Paris.txt 175
priestly	NotreDame_De_Paris.txt 3
priests	NotreDame_De_Paris.txt 10
prima	NotreDame_De_Paris.txt 2
primate	NotreDame_De_Paris.txt 2
prime	NotreDame_De_Paris.txt 1
primicier	NotreDame_De_Paris.txt 1
primitive	NotreDame_De_Paris.txt 7
primo	NotreDame_De_Paris.txt 2
prince	NotreDame_De_Paris.txt 13
princes	NotreDame_De_Paris.txt 6
princess	NotreDame_De_Paris.txt 4
principal	NotreDame_De_Paris.txt 20
principally	NotreDame_De_Paris.txt 1
principle	NotreDame_De_Paris.txt 1
print	NotreDame_De_Paris.txt 1
printed	NotreDame_De_Paris.txt 13
printing	NotreDame_De_Paris.txt 18
prior	NotreDame_De_Paris.txt 1
priors	NotreDame_De_Paris.txt 1
prison	NotreDame_De_Paris.txt 11
prisoner	NotreDame_De_Paris.txt 18
prisoners	NotreDame_De_Paris.txt 3
prisons	NotreDame_De_Paris.txt 3
private	NotreDame_De_Paris.txt 5
privilege	NotreDame_De_Paris.txt 3
privileges	NotreDame_De_Paris.txt 5
privileyia	NotreDame_De_Paris.txt 1
prize	NotreDame_De_Paris.txt 1
probability	NotreDame_De_Paris.txt 1
probable	NotreDame_De_Paris.txt 4
probably	NotreDame_De_Paris.txt 7
probed	NotreDame_De_Paris.txt 1
problem	NotreDame_De_Paris.txt 1
proboscis	NotreDame_De_Paris.txt 1
procedures	NotreDame_De_Paris.txt 1
proceed	NotreDame_De_Paris.txt 10
proceeded	NotreDame_De_Paris.txt 12
proceeding	NotreDame_De_Paris.txt 5
proceedings	NotreDame_De_Paris.txt 1
process	NotreDame_De_Paris.txt 2
processing	NotreDame_De_Paris.txt 1
procession	NotreDame_De_Paris.txt 18
processions	NotreDame_De_Paris.txt 1
proclaimed	NotreDame_De_Paris.txt 3
proclamations	NotreDame_De_Paris.txt 1
procucrator	NotreDame_De_Paris.txt 1
procurator	NotreDame_De_Paris.txt 23
procurators	NotreDame_De_Paris.txt 4
procure	NotreDame_De_Paris.txt 1
procured	NotreDame_De_Paris.txt 1
procureur	NotreDame_De_Paris.txt 1
prodigious	NotreDame_De_Paris.txt 12
prodigiously	NotreDame_De_Paris.txt 1
produce	NotreDame_De_Paris.txt 12
produced	NotreDame_De_Paris.txt 31
produces	NotreDame_De_Paris.txt 4
product	NotreDame_De_Paris.txt 5
production	NotreDame_De_Paris.txt 1
products	NotreDame_De_Paris.txt 2
proebendam	NotreDame_De_Paris.txt 1
proejudicium	NotreDame_De_Paris.txt 1
proerogativis	NotreDame_De_Paris.txt 1
proesentium	NotreDame_De_Paris.txt 1
profanation	NotreDame_De_Paris.txt 1
profanations	NotreDame_De_Paris.txt 1
profane	NotreDame_De_Paris.txt 1
profaned	NotreDame_De_Paris.txt 1
profession	NotreDame_De_Paris.txt 7
professional	NotreDame_De_Paris.txt 1
professions	NotreDame_De_Paris.txt 1
professor	NotreDame_De_Paris.txt 1
professors	NotreDame_De_Paris.txt 3
profile	NotreDame_De_Paris.txt 12
profiles	NotreDame_De_Paris.txt 2
profit	NotreDame_De_Paris.txt 3
profited	NotreDame_De_Paris.txt 1
profits	NotreDame_De_Paris.txt 3
profound	NotreDame_De_Paris.txt 39
profoundly	NotreDame_De_Paris.txt 3
profundi	NotreDame_De_Paris.txt 1
profundity	NotreDame_De_Paris.txt 1
profundum	NotreDame_De_Paris.txt 1
profusion	NotreDame_De_Paris.txt 1
progenitor	NotreDame_De_Paris.txt 1
prognosticate	NotreDame_De_Paris.txt 1
prognostication	NotreDame_De_Paris.txt 1
prognostications	NotreDame_De_Paris.txt 1
progress	NotreDame_De_Paris.txt 8
progression	NotreDame_De_Paris.txt 2
progressive	NotreDame_De_Paris.txt 1
prohibition	NotreDame_De_Paris.txt 4
prohibitions	NotreDame_De_Paris.txt 1
projecisti	NotreDame_De_Paris.txt 1
project	NotreDame_De_Paris.txt 90
projected	NotreDame_De_Paris.txt 5
projectiles	NotreDame_De_Paris.txt 1
projecting	NotreDame_De_Paris.txt 4
projection	NotreDame_De_Paris.txt 5
projections	NotreDame_De_Paris.txt 3
prologue	NotreDame_De_Paris.txt 16
prologues	NotreDame_De_Paris.txt 1
prolonged	NotreDame_De_Paris.txt 3
prolonging	NotreDame_De_Paris.txt 1
prolongs	NotreDame_De_Paris.txt 1
promenades	NotreDame_De_Paris.txt 2
prominent	NotreDame_De_Paris.txt 3
prominently	NotreDame_De_Paris.txt 2
promiscuously	NotreDame_De_Paris.txt 1
promise	NotreDame_De_Paris.txt 3
promised	NotreDame_De_Paris.txt 5
promontories	NotreDame_De_Paris.txt 1
promontory	NotreDame_De_Paris.txt 1
promoting	NotreDame_De_Paris.txt 2
promotion	NotreDame_De_Paris.txt 1
prompt	NotreDame_De_Paris.txt 2
prompted	NotreDame_De_Paris.txt 1
prompter	NotreDame_De_Paris.txt 1
promptly	NotreDame_De_Paris.txt 4
promulgated	NotreDame_De_Paris.txt 1
prone	NotreDame_De_Paris.txt 2
pronounce	NotreDame_De_Paris.txt 2
pronounced	NotreDame_De_Paris.txt 20
proof	NotreDame_De_Paris.txt 4
proofread	NotreDame_De_Paris.txt 1
proofs	NotreDame_De_Paris.txt 4
prop	NotreDame_De_Paris.txt 1
propensities	NotreDame_De_Paris.txt 1
proper	NotreDame_De_Paris.txt 3
properly	NotreDame_De_Paris.txt 6
property	NotreDame_De_Paris.txt 4
prophecies	NotreDame_De_Paris.txt 1
prophecy	NotreDame_De_Paris.txt 1
prophet	NotreDame_De_Paris.txt 1
prophets	NotreDame_De_Paris.txt 1
propitious	NotreDame_De_Paris.txt 2
proportion	NotreDame_De_Paris.txt 13
proportioned	NotreDame_De_Paris.txt 1
proportions	NotreDame_De_Paris.txt 1
proposition	NotreDame_De_Paris.txt 4
propositions	NotreDame_De_Paris.txt 1
propounding	NotreDame_De_Paris.txt 2
propped	NotreDame_De_Paris.txt 2
proprietary	NotreDame_De_Paris.txt 1
prosaic	NotreDame_De_Paris.txt 1
prosaically	NotreDame_De_Paris.txt 1
prose	NotreDame_De_Paris.txt 1
prosecution	NotreDame_De_Paris.txt 3
prospect	NotreDame_De_Paris.txt 3
prosperity	NotreDame_De_Paris.txt 1
prostitution	NotreDame_De_Paris.txt 2
prostrate	NotreDame_De_Paris.txt 3
protect	NotreDame_De_Paris.txt 7
protected	NotreDame_De_Paris.txt 3
protecting	NotreDame_De_Paris.txt 1
protection	NotreDame_De_Paris.txt 4
protector	NotreDame_De_Paris.txt 2
protest	NotreDame_De_Paris.txt 2
protested	NotreDame_De_Paris.txt 1
prothonotary	NotreDame_De_Paris.txt 1
protonotare	NotreDame_De_Paris.txt 1
protonotary	NotreDame_De_Paris.txt 2
protruded	NotreDame_De_Paris.txt 1
proud	NotreDame_De_Paris.txt 7
proudest	NotreDame_De_Paris.txt 1
proudly	NotreDame_De_Paris.txt 2
prove	NotreDame_De_Paris.txt 4
proved	NotreDame_De_Paris.txt 2
proven	NotreDame_De_Paris.txt 2
proverb	NotreDame_De_Paris.txt 2
proverbial	NotreDame_De_Paris.txt 2
proverbs	NotreDame_De_Paris.txt 1
proves	NotreDame_De_Paris.txt 2
provide	NotreDame_De_Paris.txt 8
provided	NotreDame_De_Paris.txt 13
providence	NotreDame_De_Paris.txt 6
providing	NotreDame_De_Paris.txt 4
province	NotreDame_De_Paris.txt 2
provinces	NotreDame_De_Paris.txt 3
provincial	NotreDame_De_Paris.txt 7
provision	NotreDame_De_Paris.txt 1
provisions	NotreDame_De_Paris.txt 4
provoke	NotreDame_De_Paris.txt 1
provoked	NotreDame_De_Paris.txt 1
provost	NotreDame_De_Paris.txt 58
provostal	NotreDame_De_Paris.txt 1
provosts	NotreDame_De_Paris.txt 3
provostship	NotreDame_De_Paris.txt 18
prow	NotreDame_De_Paris.txt 3
prowess	NotreDame_De_Paris.txt 2
prowler	NotreDame_De_Paris.txt 1
prowling	NotreDame_De_Paris.txt 3
prowls	NotreDame_De_Paris.txt 1
prudent	NotreDame_De_Paris.txt 2
prudery	NotreDame_De_Paris.txt 1
prudes	NotreDame_De_Paris.txt 1
prune	NotreDame_De_Paris.txt 3
prussia	NotreDame_De_Paris.txt 1
prying	NotreDame_De_Paris.txt 1
psalms	NotreDame_De_Paris.txt 2
psellus	NotreDame_De_Paris.txt 1
pseudo	NotreDame_De_Paris.txt 2
psyche	NotreDame_De_Paris.txt 1
psychological	NotreDame_De_Paris.txt 1
ptisan	NotreDame_De_Paris.txt 3
public	NotreDame_De_Paris.txt 49
published	NotreDame_De_Paris.txt 2
pudgy	NotreDame_De_Paris.txt 1
puer	NotreDame_De_Paris.txt 1
puff	NotreDame_De_Paris.txt 1
puffed	NotreDame_De_Paris.txt 1
puffing	NotreDame_De_Paris.txt 2
puissant	NotreDame_De_Paris.txt 3
puits	NotreDame_De_Paris.txt 1
pull	NotreDame_De_Paris.txt 2
pulled	NotreDame_De_Paris.txt 3
pulling	NotreDame_De_Paris.txt 2
pulpit	NotreDame_De_Paris.txt 1
pulse	NotreDame_De_Paris.txt 2
pulses	NotreDame_De_Paris.txt 1
pulsus	NotreDame_De_Paris.txt 1
pumps	NotreDame_De_Paris.txt 1
pun	NotreDame_De_Paris.txt 1
punish	NotreDame_De_Paris.txt 1
punished	NotreDame_De_Paris.txt 6
punishment	NotreDame_De_Paris.txt 3
punitive	NotreDame_De_Paris.txt 1
pupil	NotreDame_De_Paris.txt 2
pupils	NotreDame_De_Paris.txt 2
puppets	NotreDame_De_Paris.txt 1
purchase	NotreDame_De_Paris.txt 1
purchased	NotreDame_De_Paris.txt 3
pure	NotreDame_De_Paris.txt 20
purely	NotreDame_De_Paris.txt 1
purgatory	NotreDame_De_Paris.txt 1
purging	NotreDame_De_Paris.txt 1
purity	NotreDame_De_Paris.txt 1
purple	NotreDame_De_Paris.txt 5
purpose	NotreDame_De_Paris.txt 18
purposes	NotreDame_De_Paris.txt 1
purse	NotreDame_De_Paris.txt 21
purses	NotreDame_De_Paris.txt 1
pursue	NotreDame_De_Paris.txt 3
pursued	NotreDame_De_Paris.txt 28
pursues	NotreDame_De_Paris.txt 2
pursuing	NotreDame_De_Paris.txt 2
pursuit	NotreDame_De_Paris.txt 9
pus	NotreDame_De_Paris.txt 1
push	NotreDame_De_Paris.txt 4
pushed	NotreDame_De_Paris.txt 11
pushes	NotreDame_De_Paris.txt 1
pushing	NotreDame_De_Paris.txt 2
pustules	NotreDame_De_Paris.txt 1
put	NotreDame_De_Paris.txt 47
puts	NotreDame_De_Paris.txt 4
putting	NotreDame_De_Paris.txt 5
puy	NotreDame_De_Paris.txt 1
pylons	NotreDame_De_Paris.txt 1
pyramid	NotreDame_De_Paris.txt 3
pyramidal	NotreDame_De_Paris.txt 2
pyramids	NotreDame_De_Paris.txt 6
pyrrhonian	NotreDame_De_Paris.txt 1
pyrrhonism	NotreDame_De_Paris.txt 1
pythagoras	NotreDame_De_Paris.txt 3
pythagorean	NotreDame_De_Paris.txt 1
pythagoreans	NotreDame_De_Paris.txt 1
