a	Miserables.txt 14598
aback	Miserables.txt 2
abaisse	Miserables.txt 1
abandon	Miserables.txt 12
abandoned	Miserables.txt 42
abandoning	Miserables.txt 6
abandonment	Miserables.txt 6
abandons	Miserables.txt 4
abarbarea	Miserables.txt 1
abased	Miserables.txt 2
abasement	Miserables.txt 3
abashed	Miserables.txt 1
abate	Miserables.txt 1
abatis	Miserables.txt 2
abattoir	Miserables.txt 1
abattoirs	Miserables.txt 1
abbate	Miserables.txt 1
abbatial	Miserables.txt 1
abbe	Miserables.txt 32
abberent	Miserables.txt 1
abbes	Miserables.txt 3
abbess	Miserables.txt 1
abbey	Miserables.txt 11
abbot	Miserables.txt 4
abbreviation	Miserables.txt 2
abc	Miserables.txt 2
abd	Miserables.txt 1
abdicate	Miserables.txt 3
abdicated	Miserables.txt 2
abdicates	Miserables.txt 3
abdicating	Miserables.txt 1
abdication	Miserables.txt 6
abdomen	Miserables.txt 1
abducting	Miserables.txt 1
abduction	Miserables.txt 3
abducts	Miserables.txt 1
abeilard	Miserables.txt 1
abeille	Miserables.txt 1
abel	Miserables.txt 2
aberration	Miserables.txt 4
abetted	Miserables.txt 1
abfxustgrnogrkzu	Miserables.txt 1
abhor	Miserables.txt 1
abhorred	Miserables.txt 2
abhorring	Miserables.txt 1
abi	Miserables.txt 1
abide	Miserables.txt 2
ability	Miserables.txt 3
abject	Miserables.txt 6
abjectness	Miserables.txt 3
abjectnesses	Miserables.txt 1
abjure	Miserables.txt 1
able	Miserables.txt 122
ablerus	Miserables.txt 1
ablutions	Miserables.txt 1
abnegation	Miserables.txt 8
abnormal	Miserables.txt 1
abode	Miserables.txt 6
abodes	Miserables.txt 2
abolish	Miserables.txt 2
abolished	Miserables.txt 2
abolishes	Miserables.txt 1
abolishing	Miserables.txt 1
abolitionists	Miserables.txt 1
abominable	Miserables.txt 21
abominably	Miserables.txt 2
abomination	Miserables.txt 4
abominations	Miserables.txt 2
aboukir	Miserables.txt 1
abound	Miserables.txt 10
abounded	Miserables.txt 12
abounds	Miserables.txt 3
about	Miserables.txt 643
above	Miserables.txt 186
abrac	Miserables.txt 1
abraded	Miserables.txt 1
abraham	Miserables.txt 1
abridge	Miserables.txt 3
abridged	Miserables.txt 3
abridgment	Miserables.txt 1
abroad	Miserables.txt 13
abrupt	Miserables.txt 27
abruptly	Miserables.txt 52
abruptness	Miserables.txt 2
absence	Miserables.txt 28
absences	Miserables.txt 2
absent	Miserables.txt 33
absented	Miserables.txt 3
absenting	Miserables.txt 1
absents	Miserables.txt 1
absinthe	Miserables.txt 5
absolute	Miserables.txt 56
absolutely	Miserables.txt 58
absolutism	Miserables.txt 1
absolved	Miserables.txt 1
absorbed	Miserables.txt 50
absorbing	Miserables.txt 3
absorbs	Miserables.txt 1
absorption	Miserables.txt 5
absorptions	Miserables.txt 1
abstain	Miserables.txt 2
abstained	Miserables.txt 3
abstains	Miserables.txt 1
abstract	Miserables.txt 4
abstracted	Miserables.txt 3
abstraction	Miserables.txt 3
abstruse	Miserables.txt 1
absurd	Miserables.txt 12
absurdities	Miserables.txt 3
absurdly	Miserables.txt 1
abundance	Miserables.txt 3
abundant	Miserables.txt 2
abuse	Miserables.txt 6
abused	Miserables.txt 2
abuses	Miserables.txt 5
abut	Miserables.txt 3
abuts	Miserables.txt 2
abutted	Miserables.txt 4
abutting	Miserables.txt 1
abyss	Miserables.txt 60
abysses	Miserables.txt 12
ac	Miserables.txt 3
acacia	Miserables.txt 1
acacias	Miserables.txt 2
academic	Miserables.txt 1
academical	Miserables.txt 1
academician	Miserables.txt 7
academicians	Miserables.txt 1
academies	Miserables.txt 1
academy	Miserables.txt 12
acarus	Miserables.txt 1
accelerated	Miserables.txt 1
accent	Miserables.txt 24
accented	Miserables.txt 1
accenting	Miserables.txt 2
accents	Miserables.txt 17
accentuate	Miserables.txt 1
accentuated	Miserables.txt 10
accentuates	Miserables.txt 1
accentuation	Miserables.txt 1
accept	Miserables.txt 28
acceptable	Miserables.txt 2
acceptance	Miserables.txt 9
acceptation	Miserables.txt 3
acceptations	Miserables.txt 1
accepted	Miserables.txt 48
accepting	Miserables.txt 4
accepts	Miserables.txt 7
access	Miserables.txt 13
accessed	Miserables.txt 1
accesses	Miserables.txt 1
accessibility	Miserables.txt 1
accessible	Miserables.txt 6
accident	Miserables.txt 15
accidental	Miserables.txt 1
accidentally	Miserables.txt 2
accidents	Miserables.txt 8
acclamation	Miserables.txt 3
acclamations	Miserables.txt 2
acclivities	Miserables.txt 1
acclivity	Miserables.txt 1
accommodate	Miserables.txt 1
accommodated	Miserables.txt 1
accommodates	Miserables.txt 1
accommodating	Miserables.txt 1
accommodation	Miserables.txt 1
accompanied	Miserables.txt 35
accompanies	Miserables.txt 2
accompaniment	Miserables.txt 3
accompany	Miserables.txt 9
accompanying	Miserables.txt 2
accomplice	Miserables.txt 6
accomplices	Miserables.txt 7
accomplish	Miserables.txt 8
accomplished	Miserables.txt 26
accomplishes	Miserables.txt 2
accomplishing	Miserables.txt 3
accomplishment	Miserables.txt 4
accons	Miserables.txt 1
accord	Miserables.txt 16
accordance	Miserables.txt 16
accorded	Miserables.txt 7
according	Miserables.txt 81
accordingly	Miserables.txt 10
accost	Miserables.txt 3
accosted	Miserables.txt 13
accosting	Miserables.txt 1
account	Miserables.txt 68
accounted	Miserables.txt 2
accounts	Miserables.txt 3
accoutred	Miserables.txt 1
accoutrements	Miserables.txt 1
accumulate	Miserables.txt 1
accumulated	Miserables.txt 2
accumulates	Miserables.txt 1
accumulation	Miserables.txt 3
accuracy	Miserables.txt 2
accurate	Miserables.txt 1
accurately	Miserables.txt 4
accursed	Miserables.txt 2
accusation	Miserables.txt 4
accusations	Miserables.txt 1
accuse	Miserables.txt 8
accused	Miserables.txt 16
accuser	Miserables.txt 2
accusers	Miserables.txt 1
accuses	Miserables.txt 3
accusing	Miserables.txt 1
accustom	Miserables.txt 3
accustomed	Miserables.txt 35
accustoms	Miserables.txt 1
aces	Miserables.txt 1
aceyte	Miserables.txt 1
achery	Miserables.txt 1
achieve	Miserables.txt 1
achilles	Miserables.txt 1
aching	Miserables.txt 1
acid	Miserables.txt 2
acids	Miserables.txt 1
acite	Miserables.txt 1
acknowledge	Miserables.txt 8
acknowledged	Miserables.txt 1
acknowledges	Miserables.txt 1
acknowledging	Miserables.txt 2
acolytes	Miserables.txt 1
acoustic	Miserables.txt 1
acquaintance	Miserables.txt 8
acquaintances	Miserables.txt 1
acquainted	Miserables.txt 39
acquiescence	Miserables.txt 1
acquire	Miserables.txt 3
acquired	Miserables.txt 23
acquit	Miserables.txt 2
acre	Miserables.txt 3
acrid	Miserables.txt 3
acrimony	Miserables.txt 2
acrobat	Miserables.txt 2
acropolis	Miserables.txt 1
across	Miserables.txt 55
act	Miserables.txt 53
acte	Miserables.txt 2
acted	Miserables.txt 6
acting	Miserables.txt 3
action	Miserables.txt 60
actions	Miserables.txt 23
actium	Miserables.txt 1
active	Miserables.txt 4
activity	Miserables.txt 7
actor	Miserables.txt 6
actors	Miserables.txt 5
actresses	Miserables.txt 1
acts	Miserables.txt 8
actual	Miserables.txt 11
actually	Miserables.txt 23
acute	Miserables.txt 2
ad	Miserables.txt 3
adam	Miserables.txt 8
adamant	Miserables.txt 1
adamastor	Miserables.txt 1
adamite	Miserables.txt 1
adaptation	Miserables.txt 1
adaptations	Miserables.txt 1
adapted	Miserables.txt 5
adays	Miserables.txt 1
add	Miserables.txt 50
added	Miserables.txt 192
adder	Miserables.txt 2
adders	Miserables.txt 1
addicted	Miserables.txt 2
adding	Miserables.txt 11
addiscerit	Miserables.txt 1
addition	Miserables.txt 35
additional	Miserables.txt 4
additions	Miserables.txt 2
address	Miserables.txt 70
addressed	Miserables.txt 66
addresses	Miserables.txt 3
addressing	Miserables.txt 17
adds	Miserables.txt 8
adel	Miserables.txt 1
adelaide	Miserables.txt 2
adhere	Miserables.txt 2
adherence	Miserables.txt 2
adheres	Miserables.txt 1
adhering	Miserables.txt 1
adhesion	Miserables.txt 1
adieu	Miserables.txt 4
adige	Miserables.txt 1
adire	Miserables.txt 1
adjoin	Miserables.txt 3
adjoined	Miserables.txt 3
adjoining	Miserables.txt 16
adjoins	Miserables.txt 4
adjourning	Miserables.txt 1
adjunct	Miserables.txt 1
adjure	Miserables.txt 1
adjust	Miserables.txt 3
adjusted	Miserables.txt 9
adjusting	Miserables.txt 1
adjusts	Miserables.txt 2
adjutant	Miserables.txt 3
adjutants	Miserables.txt 1
administer	Miserables.txt 1
administered	Miserables.txt 6
administering	Miserables.txt 5
administration	Miserables.txt 9
administrative	Miserables.txt 4
admirable	Miserables.txt 34
admirably	Miserables.txt 12
admiral	Miserables.txt 1
admirals	Miserables.txt 1
admiration	Miserables.txt 21
admire	Miserables.txt 18
admired	Miserables.txt 21
admirer	Miserables.txt 1
admires	Miserables.txt 1
admiring	Miserables.txt 5
admiringly	Miserables.txt 1
admission	Miserables.txt 2
admissions	Miserables.txt 1
admit	Miserables.txt 42
admits	Miserables.txt 7
admitted	Miserables.txt 29
admitting	Miserables.txt 5
admonition	Miserables.txt 3
adolescence	Miserables.txt 1
adolph	Miserables.txt 1
adonai	Miserables.txt 1
adopt	Miserables.txt 3
adopted	Miserables.txt 17
adopting	Miserables.txt 1
adorable	Miserables.txt 19
adorably	Miserables.txt 1
adorais	Miserables.txt 1
adoration	Miserables.txt 22
adorations	Miserables.txt 2
adore	Miserables.txt 22
adored	Miserables.txt 36
adorer	Miserables.txt 1
adores	Miserables.txt 3
adoring	Miserables.txt 5
adorned	Miserables.txt 9
adorning	Miserables.txt 1
adornments	Miserables.txt 1
adrets	Miserables.txt 1
adrien	Miserables.txt 1
adroit	Miserables.txt 5
adroitness	Miserables.txt 1
adulterated	Miserables.txt 1
adulteress	Miserables.txt 1
advance	Miserables.txt 55
advanced	Miserables.txt 56
advancement	Miserables.txt 4
advances	Miserables.txt 9
advancing	Miserables.txt 16
advantage	Miserables.txt 35
advantages	Miserables.txt 3
advent	Miserables.txt 9
adventure	Miserables.txt 36
adventurer	Miserables.txt 2
adventurers	Miserables.txt 1
adventures	Miserables.txt 15
adventuress	Miserables.txt 1
adversaries	Miserables.txt 1
adversary	Miserables.txt 3
adversity	Miserables.txt 3
advertisements	Miserables.txt 1
advertising	Miserables.txt 1
advice	Miserables.txt 19
advisable	Miserables.txt 2
advise	Miserables.txt 2
advised	Miserables.txt 5
advising	Miserables.txt 1
advocate	Miserables.txt 4
advocates	Miserables.txt 1
aeantides	Miserables.txt 1
aedibus	Miserables.txt 1
aediles	Miserables.txt 1
aegina	Miserables.txt 1
aerial	Miserables.txt 3
aerostiers	Miserables.txt 1
aeschylus	Miserables.txt 7
aesop	Miserables.txt 1
aeternam	Miserables.txt 2
afar	Miserables.txt 5
affable	Miserables.txt 4
affair	Miserables.txt 62
affairs	Miserables.txt 27
affect	Miserables.txt 4
affectation	Miserables.txt 3
affected	Miserables.txt 14
affecting	Miserables.txt 2
affection	Miserables.txt 10
affectionate	Miserables.txt 6
affections	Miserables.txt 1
affects	Miserables.txt 1
affiliated	Miserables.txt 4
affiliation	Miserables.txt 1
affiliations	Miserables.txt 2
affinities	Miserables.txt 1
affinity	Miserables.txt 1
affirm	Miserables.txt 5
affirmation	Miserables.txt 5
affirmations	Miserables.txt 2
affirmative	Miserables.txt 2
affirmatively	Miserables.txt 1
affirmed	Miserables.txt 7
affirms	Miserables.txt 1
afflatus	Miserables.txt 1
afflicted	Miserables.txt 7
affliction	Miserables.txt 5
afflictions	Miserables.txt 2
affluent	Miserables.txt 2
affluents	Miserables.txt 1
afford	Miserables.txt 9
afforded	Miserables.txt 8
affording	Miserables.txt 1
affords	Miserables.txt 2
affright	Miserables.txt 6
affront	Miserables.txt 3
affronted	Miserables.txt 1
affurer	Miserables.txt 1
aflame	Miserables.txt 4
afloat	Miserables.txt 1
afraid	Miserables.txt 46
afresh	Miserables.txt 16
africa	Miserables.txt 4
african	Miserables.txt 1
after	Miserables.txt 532
afternoon	Miserables.txt 22
afternoons	Miserables.txt 1
aftertaste	Miserables.txt 1
afterward	Miserables.txt 3
afterwards	Miserables.txt 42
aga	Miserables.txt 1
again	Miserables.txt 455
against	Miserables.txt 303
agamemnon	Miserables.txt 1
agatha	Miserables.txt 1
agathocles	Miserables.txt 1
agde	Miserables.txt 1
age	Miserables.txt 167
aged	Miserables.txt 41
agency	Miserables.txt 4
agent	Miserables.txt 45
agents	Miserables.txt 17
ages	Miserables.txt 16
aggrandizement	Miserables.txt 2
aggravated	Miserables.txt 6
aggravates	Miserables.txt 1
aggravations	Miserables.txt 1
aggregation	Miserables.txt 1
aggressive	Miserables.txt 3
aggrieved	Miserables.txt 2
agier	Miserables.txt 1
agile	Miserables.txt 4
agility	Miserables.txt 9
agincourt	Miserables.txt 1
agitate	Miserables.txt 2
agitated	Miserables.txt 18
agitation	Miserables.txt 9
agitations	Miserables.txt 3
agite	Miserables.txt 1
agnes	Miserables.txt 2
agnese	Miserables.txt 1
agnus	Miserables.txt 2
ago	Miserables.txt 97
agonies	Miserables.txt 1
agonize	Miserables.txt 1
agonized	Miserables.txt 1
agonizing	Miserables.txt 6
agony	Miserables.txt 49
agora	Miserables.txt 1
agrarian	Miserables.txt 1
agree	Miserables.txt 16
agreeable	Miserables.txt 12
agreed	Miserables.txt 23
agreeing	Miserables.txt 2
agreement	Miserables.txt 20
agrees	Miserables.txt 1
agriculture	Miserables.txt 3
agrippa	Miserables.txt 1
aground	Miserables.txt 2
ah	Miserables.txt 248
ahead	Miserables.txt 10
ai	Miserables.txt 7
aid	Miserables.txt 22
aide	Miserables.txt 2
aided	Miserables.txt 4
aiding	Miserables.txt 4
aids	Miserables.txt 3
aie	Miserables.txt 2
aigle	Miserables.txt 6
aigrefeuille	Miserables.txt 1
aile	Miserables.txt 2
ailed	Miserables.txt 1
ailing	Miserables.txt 4
aille	Miserables.txt 1
ailly	Miserables.txt 2
ailment	Miserables.txt 1
ails	Miserables.txt 2
aim	Miserables.txt 27
aime	Miserables.txt 7
aimed	Miserables.txt 9
aiming	Miserables.txt 1
aimlessly	Miserables.txt 1
aimons	Miserables.txt 2
aims	Miserables.txt 3
ain	Miserables.txt 16
ainsi	Miserables.txt 2
air	Miserables.txt 357
airing	Miserables.txt 1
airs	Miserables.txt 9
aisne	Miserables.txt 2
aix	Miserables.txt 10
ajar	Miserables.txt 7
ajax	Miserables.txt 1
ajoutant	Miserables.txt 1
ak	Miserables.txt 1
akin	Miserables.txt 1
alabaster	Miserables.txt 1
alarm	Miserables.txt 30
alarmed	Miserables.txt 29
alarming	Miserables.txt 31
alarms	Miserables.txt 2
alas	Miserables.txt 55
alava	Miserables.txt 1
alba	Miserables.txt 3
albe	Miserables.txt 1
albert	Miserables.txt 1
albertine	Miserables.txt 7
albin	Miserables.txt 1
albion	Miserables.txt 1
alcala	Miserables.txt 1
alcesimarchus	Miserables.txt 1
alcestis	Miserables.txt 2
alcippe	Miserables.txt 1
alcippus	Miserables.txt 1
alcohol	Miserables.txt 2
alcove	Miserables.txt 13
aldebaran	Miserables.txt 1
aldobrandini	Miserables.txt 1
aldus	Miserables.txt 1
alencon	Miserables.txt 1
alert	Miserables.txt 6
alethe	Miserables.txt 1
aleurs	Miserables.txt 1
alexander	Miserables.txt 11
alexandre	Miserables.txt 1
alexandria	Miserables.txt 2
alexandrine	Miserables.txt 2
alexis	Miserables.txt 1
alfred	Miserables.txt 2
algebra	Miserables.txt 2
algeria	Miserables.txt 1
algesiras	Miserables.txt 1
alias	Miserables.txt 19
alicante	Miserables.txt 1
alighieri	Miserables.txt 2
alight	Miserables.txt 5
alighted	Miserables.txt 5
alii	Miserables.txt 2
alike	Miserables.txt 6
alive	Miserables.txt 31
alix	Miserables.txt 3
all	Miserables.txt 2489
alla	Miserables.txt 1
allais	Miserables.txt 2
allait	Miserables.txt 2
allayed	Miserables.txt 2
alleche	Miserables.txt 1
allee	Miserables.txt 1
alleged	Miserables.txt 1
alleging	Miserables.txt 2
allegri	Miserables.txt 1
alleluia	Miserables.txt 1
aller	Miserables.txt 2
alleud	Miserables.txt 11
alleurs	Miserables.txt 1
alleviated	Miserables.txt 1
alley	Miserables.txt 51
alleys	Miserables.txt 24
alliance	Miserables.txt 9
alliances	Miserables.txt 1
allies	Miserables.txt 3
allocution	Miserables.txt 1
allot	Miserables.txt 1
allots	Miserables.txt 1
allotted	Miserables.txt 3
allow	Miserables.txt 53
allowable	Miserables.txt 1
allowance	Miserables.txt 5
allowances	Miserables.txt 2
allowed	Miserables.txt 87
allowing	Miserables.txt 21
allows	Miserables.txt 6
alloz	Miserables.txt 1
allude	Miserables.txt 1
alluded	Miserables.txt 6
alluding	Miserables.txt 4
allumant	Miserables.txt 1
alluring	Miserables.txt 1
allusion	Miserables.txt 8
allusions	Miserables.txt 2
alluvial	Miserables.txt 1
alluvium	Miserables.txt 2
alluye	Miserables.txt 1
ally	Miserables.txt 2
alma	Miserables.txt 1
almagro	Miserables.txt 1
almost	Miserables.txt 328
almosts	Miserables.txt 1
alms	Miserables.txt 19
almude	Miserables.txt 1
aloe	Miserables.txt 1
aloft	Miserables.txt 2
alone	Miserables.txt 206
along	Miserables.txt 126
alongside	Miserables.txt 2
aloof	Miserables.txt 3
aloud	Miserables.txt 37
alpes	Miserables.txt 4
alphabet	Miserables.txt 4
alphabetical	Miserables.txt 2
alphabets	Miserables.txt 1
alphonse	Miserables.txt 2
alpinula	Miserables.txt 1
alps	Miserables.txt 8
already	Miserables.txt 190
alsace	Miserables.txt 1
also	Miserables.txt 225
alta	Miserables.txt 1
altar	Miserables.txt 34
altarations	Miserables.txt 1
altars	Miserables.txt 2
alten	Miserables.txt 4
alter	Miserables.txt 6
alteration	Miserables.txt 1
alterations	Miserables.txt 1
altered	Miserables.txt 7
alternate	Miserables.txt 3
alternated	Miserables.txt 1
alternately	Miserables.txt 1
alternating	Miserables.txt 1
alternative	Miserables.txt 2
alternatives	Miserables.txt 1
although	Miserables.txt 85
altogether	Miserables.txt 8
alum	Miserables.txt 1
alvares	Miserables.txt 3
alveras	Miserables.txt 1
alvinzi	Miserables.txt 1
always	Miserables.txt 312
alzey	Miserables.txt 1
am	Miserables.txt 547
amalgamate	Miserables.txt 3
amalgamated	Miserables.txt 5
amalgamating	Miserables.txt 2
amant	Miserables.txt 1
amaranthine	Miserables.txt 1
amasie	Miserables.txt 1
amassed	Miserables.txt 1
amateur	Miserables.txt 2
amativeness	Miserables.txt 1
amator	Miserables.txt 2
amavit	Miserables.txt 1
amaze	Miserables.txt 2
amazed	Miserables.txt 14
amazement	Miserables.txt 42
amazes	Miserables.txt 1
amazon	Miserables.txt 1
ambassadeur	Miserables.txt 1
ambassador	Miserables.txt 3
ambassadors	Miserables.txt 1
ambigu	Miserables.txt 1
ambiguous	Miserables.txt 2
ambiorix	Miserables.txt 2
ambition	Miserables.txt 12
ambitions	Miserables.txt 1
ambitious	Miserables.txt 4
ambubaiarum	Miserables.txt 1
ambubajae	Miserables.txt 1
ambulance	Miserables.txt 7
ambulances	Miserables.txt 1
ambuscade	Miserables.txt 3
ambuscades	Miserables.txt 2
ambush	Miserables.txt 19
ambushed	Miserables.txt 2
ambushes	Miserables.txt 4
ame	Miserables.txt 2
ameliorate	Miserables.txt 1
amelioration	Miserables.txt 3
amelot	Miserables.txt 3
amen	Miserables.txt 4
amends	Miserables.txt 1
america	Miserables.txt 10
american	Miserables.txt 2
ami	Miserables.txt 3
amiability	Miserables.txt 1
amiable	Miserables.txt 17
amiably	Miserables.txt 1
amicable	Miserables.txt 3
amid	Miserables.txt 72
amiens	Miserables.txt 1
amiss	Miserables.txt 1
ammonia	Miserables.txt 1
ammunition	Miserables.txt 7
amnesties	Miserables.txt 1
amnesty	Miserables.txt 1
among	Miserables.txt 168
amor	Miserables.txt 2
amorous	Miserables.txt 4
amount	Miserables.txt 35
amounted	Miserables.txt 7
amounts	Miserables.txt 4
amour	Miserables.txt 9
amoureuse	Miserables.txt 1
amoureux	Miserables.txt 1
amours	Miserables.txt 2
amphiaraus	Miserables.txt 1
amphibious	Miserables.txt 1
amphictyons	Miserables.txt 3
amphitheatre	Miserables.txt 1
amphitrite	Miserables.txt 1
amphora	Miserables.txt 2
ample	Miserables.txt 3
amplitude	Miserables.txt 1
amsterdam	Miserables.txt 1
amuse	Miserables.txt 13
amused	Miserables.txt 7
amuses	Miserables.txt 6
amusing	Miserables.txt 13
an	Miserables.txt 2128
anacephorus	Miserables.txt 1
anacharsis	Miserables.txt 1
anachronism	Miserables.txt 2
analogies	Miserables.txt 1
analogous	Miserables.txt 1
analogy	Miserables.txt 1
analyze	Miserables.txt 1
analyzed	Miserables.txt 2
analyzes	Miserables.txt 2
analyzing	Miserables.txt 1
anaras	Miserables.txt 1
anarchical	Miserables.txt 1
anarchist	Miserables.txt 1
anarchy	Miserables.txt 12
anatomy	Miserables.txt 1
anceau	Miserables.txt 3
ancestor	Miserables.txt 1
ancestors	Miserables.txt 1
ancestresses	Miserables.txt 1
anche	Miserables.txt 1
anchor	Miserables.txt 4
anchored	Miserables.txt 2
anchorite	Miserables.txt 2
anchylosis	Miserables.txt 1
ancien	Miserables.txt 1
ancient	Miserables.txt 131
ancients	Miserables.txt 4
anciot	Miserables.txt 1
ancona	Miserables.txt 3
ancre	Miserables.txt 1
and	Miserables.txt 14939
andelys	Miserables.txt 1
andernach	Miserables.txt 1
andirons	Miserables.txt 1
andre	Miserables.txt 8
andrew	Miserables.txt 3
andromeda	Miserables.txt 1
andujar	Miserables.txt 1
anecdotes	Miserables.txt 1
anent	Miserables.txt 2
anew	Miserables.txt 3
ange	Miserables.txt 2
angel	Miserables.txt 53
angeles	Miserables.txt 2
angelic	Miserables.txt 9
angelically	Miserables.txt 1
angelique	Miserables.txt 1
angelo	Miserables.txt 3
angelorum	Miserables.txt 1
angelos	Miserables.txt 1
angels	Miserables.txt 31
anger	Miserables.txt 6
angered	Miserables.txt 3
angers	Miserables.txt 3
anges	Miserables.txt 1
anglais	Miserables.txt 1
angle	Miserables.txt 63
angled	Miserables.txt 1
angles	Miserables.txt 34
anglo	Miserables.txt 2
angouleme	Miserables.txt 8
angrily	Miserables.txt 2
angry	Miserables.txt 28
anguish	Miserables.txt 46
anguishes	Miserables.txt 1
angular	Miserables.txt 7
angusta	Miserables.txt 2
animal	Miserables.txt 20
animalcule	Miserables.txt 1
animals	Miserables.txt 10
animated	Miserables.txt 5
animates	Miserables.txt 2
animation	Miserables.txt 4
animaux	Miserables.txt 1
animosity	Miserables.txt 1
anjou	Miserables.txt 1
ankle	Miserables.txt 7
ankles	Miserables.txt 4
annales	Miserables.txt 2
anne	Miserables.txt 3
annihilate	Miserables.txt 3
annihilated	Miserables.txt 7
annihilates	Miserables.txt 1
annihilating	Miserables.txt 1
annihilation	Miserables.txt 1
anniversary	Miserables.txt 1
annonciation	Miserables.txt 1
annos	Miserables.txt 1
annotated	Miserables.txt 2
annotating	Miserables.txt 3
announce	Miserables.txt 10
announced	Miserables.txt 19
announcement	Miserables.txt 5
announces	Miserables.txt 1
announcing	Miserables.txt 1
annoy	Miserables.txt 3
annoyance	Miserables.txt 1
annoyed	Miserables.txt 2
annoying	Miserables.txt 3
annuaire	Miserables.txt 1
annual	Miserables.txt 3
annually	Miserables.txt 3
annuity	Miserables.txt 2
annulled	Miserables.txt 1
annuls	Miserables.txt 2
annum	Miserables.txt 2
anointed	Miserables.txt 1
anointing	Miserables.txt 1
anointment	Miserables.txt 1
anonymous	Miserables.txt 2
another	Miserables.txt 286
ans	Miserables.txt 1
ansiaux	Miserables.txt 1
answer	Miserables.txt 40
answered	Miserables.txt 50
answering	Miserables.txt 2
answers	Miserables.txt 5
ant	Miserables.txt 5
antaeus	Miserables.txt 1
antagonism	Miserables.txt 1
antagonisms	Miserables.txt 1
antagonistic	Miserables.txt 1
antam	Miserables.txt 1
antan	Miserables.txt 2
ante	Miserables.txt 1
antechamber	Miserables.txt 15
antennae	Miserables.txt 3
anterior	Miserables.txt 4
anteroom	Miserables.txt 3
anticipation	Miserables.txt 1
antidote	Miserables.txt 1
antilochus	Miserables.txt 1
antin	Miserables.txt 3
antinous	Miserables.txt 1
antipathies	Miserables.txt 1
antipathy	Miserables.txt 1
antipope	Miserables.txt 1
antiquary	Miserables.txt 1
antiquated	Miserables.txt 5
antique	Miserables.txt 30
antiquity	Miserables.txt 6
antitheses	Miserables.txt 2
antithesis	Miserables.txt 2
antoine	Miserables.txt 44
antoinette	Miserables.txt 2
antwerp	Miserables.txt 1
anvil	Miserables.txt 1
anville	Miserables.txt 1
anxieties	Miserables.txt 6
anxiety	Miserables.txt 37
anxious	Miserables.txt 6
any	Miserables.txt 579
anybody	Miserables.txt 4
anyone	Miserables.txt 7
anything	Miserables.txt 214
anyway	Miserables.txt 3
anywhere	Miserables.txt 15
aout	Miserables.txt 1
apart	Miserables.txt 26
apartment	Miserables.txt 25
apartments	Miserables.txt 7
apathy	Miserables.txt 3
aperture	Miserables.txt 17
apertures	Miserables.txt 1
apex	Miserables.txt 1
aphorisms	Miserables.txt 2
apicides	Miserables.txt 1
apiece	Miserables.txt 2
apocalypse	Miserables.txt 4
apocalypses	Miserables.txt 2
apocrypha	Miserables.txt 1
apocryphal	Miserables.txt 1
apollo	Miserables.txt 4
apoplexy	Miserables.txt 2
apostle	Miserables.txt 2
apostles	Miserables.txt 3
apostleship	Miserables.txt 1
apostolics	Miserables.txt 1
apostrophe	Miserables.txt 6
apostrophize	Miserables.txt 1
apostrophized	Miserables.txt 3
apostrophizing	Miserables.txt 1
apothecary	Miserables.txt 7
apotheoses	Miserables.txt 1
apotheosis	Miserables.txt 3
appalled	Miserables.txt 1
apparatus	Miserables.txt 8
apparatuses	Miserables.txt 1
apparel	Miserables.txt 1
apparent	Miserables.txt 18
apparently	Miserables.txt 15
apparition	Miserables.txt 25
apparitions	Miserables.txt 4
appeal	Miserables.txt 11
appealed	Miserables.txt 1
appeals	Miserables.txt 3
appear	Miserables.txt 47
appearance	Miserables.txt 110
appearances	Miserables.txt 17
appeared	Miserables.txt 155
appearing	Miserables.txt 9
appears	Miserables.txt 41
appease	Miserables.txt 1
appeased	Miserables.txt 2
appela	Miserables.txt 1
appellation	Miserables.txt 5
appellations	Miserables.txt 4
appended	Miserables.txt 1
appetite	Miserables.txt 16
appetites	Miserables.txt 2
applaud	Miserables.txt 2
applauded	Miserables.txt 6
applauders	Miserables.txt 1
applauding	Miserables.txt 1
applauds	Miserables.txt 2
applause	Miserables.txt 6
apple	Miserables.txt 23
apples	Miserables.txt 17
applicable	Miserables.txt 5
application	Miserables.txt 2
applied	Miserables.txt 19
applies	Miserables.txt 5
applique	Miserables.txt 1
apply	Miserables.txt 9
applying	Miserables.txt 1
appointed	Miserables.txt 24
appointment	Miserables.txt 3
apportions	Miserables.txt 1
appreciated	Miserables.txt 1
appreciating	Miserables.txt 1
apprehend	Miserables.txt 2
apprehended	Miserables.txt 2
apprehending	Miserables.txt 1
apprehensions	Miserables.txt 2
apprenticed	Miserables.txt 1
apprenticeship	Miserables.txt 1
approach	Miserables.txt 34
approached	Miserables.txt 65
approaches	Miserables.txt 5
approaching	Miserables.txt 33
approbrium	Miserables.txt 1
appropriate	Miserables.txt 2
appropriated	Miserables.txt 3
appropriately	Miserables.txt 1
appropriateness	Miserables.txt 1
approval	Miserables.txt 3
approve	Miserables.txt 3
approved	Miserables.txt 6
approves	Miserables.txt 1
approximation	Miserables.txt 2
approximative	Miserables.txt 1
apricot	Miserables.txt 2
april	Miserables.txt 25
apron	Miserables.txt 15
aprons	Miserables.txt 1
apropos	Miserables.txt 5
apse	Miserables.txt 2
apt	Miserables.txt 2
aptera	Miserables.txt 1
aptitude	Miserables.txt 4
aptitudes	Miserables.txt 3
apuleius	Miserables.txt 2
aquafortis	Miserables.txt 1
aquatic	Miserables.txt 1
aqueduct	Miserables.txt 2
aquila	Miserables.txt 1
aquiline	Miserables.txt 1
arab	Miserables.txt 9
arabesque	Miserables.txt 1
arabesques	Miserables.txt 1
arabic	Miserables.txt 1
arabs	Miserables.txt 1
araby	Miserables.txt 1
arago	Miserables.txt 1
arbalete	Miserables.txt 2
arbiter	Miserables.txt 2
arbitrary	Miserables.txt 2
arbore	Miserables.txt 1
arbors	Miserables.txt 1
arbre	Miserables.txt 4
arc	Miserables.txt 6
arcade	Miserables.txt 4
arcades	Miserables.txt 6
arcanum	Miserables.txt 1
arch	Miserables.txt 11
archangel	Miserables.txt 5
archangels	Miserables.txt 2
archbishop	Miserables.txt 27
archbishops	Miserables.txt 3
archduchess	Miserables.txt 1
archduke	Miserables.txt 1
arche	Miserables.txt 3
arched	Miserables.txt 10
archer	Miserables.txt 1
arches	Miserables.txt 4
archi	Miserables.txt 1
archidiaconates	Miserables.txt 1
archimedes	Miserables.txt 1
arching	Miserables.txt 1
architect	Miserables.txt 6
architects	Miserables.txt 1
architecture	Miserables.txt 5
archive	Miserables.txt 13
archives	Miserables.txt 4
arcis	Miserables.txt 2
arcola	Miserables.txt 4
arcueil	Miserables.txt 1
ardent	Miserables.txt 8
ardently	Miserables.txt 1
ardor	Miserables.txt 3
arduous	Miserables.txt 1
are	Miserables.txt 2165
area	Miserables.txt 1
aren	Miserables.txt 4
arenas	Miserables.txt 1
aretaon	Miserables.txt 1
argand	Miserables.txt 2
argens	Miserables.txt 1
argent	Miserables.txt 2
argenteuil	Miserables.txt 4
argiraspides	Miserables.txt 1
argos	Miserables.txt 1
argot	Miserables.txt 8
argue	Miserables.txt 1
argued	Miserables.txt 3
argues	Miserables.txt 1
argument	Miserables.txt 4
arguments	Miserables.txt 5
argus	Miserables.txt 1
argyrippus	Miserables.txt 1
arid	Miserables.txt 1
aright	Miserables.txt 1
arisba	Miserables.txt 1
arise	Miserables.txt 12
arisen	Miserables.txt 2
arises	Miserables.txt 10
arising	Miserables.txt 3
aristocracy	Miserables.txt 3
aristocrat	Miserables.txt 3
aristocratic	Miserables.txt 2
aristogeiton	Miserables.txt 1
aristogiton	Miserables.txt 1
aristophanes	Miserables.txt 1
aristotle	Miserables.txt 1
arles	Miserables.txt 1
arlincourt	Miserables.txt 1
arm	Miserables.txt 164
armament	Miserables.txt 1
armand	Miserables.txt 1
armchair	Miserables.txt 4
arme	Miserables.txt 39
armed	Miserables.txt 52
armies	Miserables.txt 11
armor	Miserables.txt 2
armorer	Miserables.txt 2
armorers	Miserables.txt 2
armorial	Miserables.txt 1
armpits	Miserables.txt 3
arms	Miserables.txt 201
armuyr	Miserables.txt 1
army	Miserables.txt 98
arnauld	Miserables.txt 1
arnault	Miserables.txt 1
arnay	Miserables.txt 1
arnoul	Miserables.txt 1
arnould	Miserables.txt 1
arnoux	Miserables.txt 1
aromatics	Miserables.txt 2
arondissement	Miserables.txt 1
arose	Miserables.txt 24
arostogeiton	Miserables.txt 1
arouet	Miserables.txt 1
around	Miserables.txt 123
arouse	Miserables.txt 8
aroused	Miserables.txt 13
arouses	Miserables.txt 1
arrange	Miserables.txt 10
arranged	Miserables.txt 54
arrangement	Miserables.txt 5
arrangements	Miserables.txt 9
arranges	Miserables.txt 4
arranging	Miserables.txt 6
arrant	Miserables.txt 1
arras	Miserables.txt 37
array	Miserables.txt 4
arrayed	Miserables.txt 2
arrears	Miserables.txt 2
arrest	Miserables.txt 29
arrested	Miserables.txt 34
arresting	Miserables.txt 7
arrests	Miserables.txt 3
arriva	Miserables.txt 1
arrival	Miserables.txt 40
arrive	Miserables.txt 32
arrived	Miserables.txt 111
arrives	Miserables.txt 9
arriving	Miserables.txt 39
arrobe	Miserables.txt 1
arrogance	Miserables.txt 2
arrogant	Miserables.txt 2
arrondissement	Miserables.txt 10
arrondissements	Miserables.txt 1
arsenal	Miserables.txt 11
arsenals	Miserables.txt 1
art	Miserables.txt 42
artaxerxes	Miserables.txt 1
arteries	Miserables.txt 4
artery	Miserables.txt 2
artevelde	Miserables.txt 2
arthur	Miserables.txt 1
arthurs	Miserables.txt 2
article	Miserables.txt 12
articles	Miserables.txt 9
articulate	Miserables.txt 2
articulated	Miserables.txt 4
articulating	Miserables.txt 1
articulations	Miserables.txt 1
artificial	Miserables.txt 3
artificially	Miserables.txt 1
artillerists	Miserables.txt 2
artillery	Miserables.txt 43
artisan	Miserables.txt 8
artisans	Miserables.txt 5
artist	Miserables.txt 9
artistic	Miserables.txt 4
artistically	Miserables.txt 5
artists	Miserables.txt 7
artois	Miserables.txt 4
artonge	Miserables.txt 1
arts	Miserables.txt 5
as	Miserables.txt 3255
ascend	Miserables.txt 13
ascended	Miserables.txt 32
ascending	Miserables.txt 8
ascends	Miserables.txt 3
ascension	Miserables.txt 4
ascent	Miserables.txt 6
ascents	Miserables.txt 2
ascetic	Miserables.txt 4
asceticism	Miserables.txt 2
ascii	Miserables.txt 2
ash	Miserables.txt 3
ashamed	Miserables.txt 11
ashes	Miserables.txt 24
asia	Miserables.txt 7
asiatic	Miserables.txt 1
aside	Miserables.txt 73
asides	Miserables.txt 3
asile	Miserables.txt 1
asinarium	Miserables.txt 1
ask	Miserables.txt 63
askance	Miserables.txt 2
asked	Miserables.txt 134
askew	Miserables.txt 1
asking	Miserables.txt 19
asks	Miserables.txt 3
asleep	Miserables.txt 77
asnieres	Miserables.txt 1
asp	Miserables.txt 1
asparagus	Miserables.txt 1
aspasia	Miserables.txt 4
aspect	Miserables.txt 46
aspects	Miserables.txt 13
asperities	Miserables.txt 1
asperity	Miserables.txt 1
asphyxia	Miserables.txt 2
aspirant	Miserables.txt 2
aspirants	Miserables.txt 2
aspiration	Miserables.txt 5
aspirations	Miserables.txt 4
aspire	Miserables.txt 2
aspired	Miserables.txt 5
aspires	Miserables.txt 1
aspiring	Miserables.txt 1
ass	Miserables.txt 5
assail	Miserables.txt 3
assailant	Miserables.txt 1
assailants	Miserables.txt 22
assailed	Miserables.txt 12
assas	Miserables.txt 1
assassin	Miserables.txt 27
assassinate	Miserables.txt 3
assassinated	Miserables.txt 12
assassinating	Miserables.txt 1
assassination	Miserables.txt 8
assassinations	Miserables.txt 1
assassins	Miserables.txt 9
assault	Miserables.txt 21
assaulted	Miserables.txt 3
assaults	Miserables.txt 1
asse	Miserables.txt 1
assemblage	Miserables.txt 1
assemblages	Miserables.txt 2
assemble	Miserables.txt 1
assembled	Miserables.txt 12
assembles	Miserables.txt 1
assemblies	Miserables.txt 1
assembling	Miserables.txt 2
assembly	Miserables.txt 6
assent	Miserables.txt 2
asserted	Miserables.txt 5
assertion	Miserables.txt 3
assertions	Miserables.txt 1
asserts	Miserables.txt 1
asses	Miserables.txt 3
assessed	Miserables.txt 1
assets	Miserables.txt 1
asseyait	Miserables.txt 1
assiduity	Miserables.txt 3
assiduous	Miserables.txt 1
assigned	Miserables.txt 4
assimilated	Miserables.txt 1
assimilates	Miserables.txt 1
assimilation	Miserables.txt 1
assisi	Miserables.txt 1
assist	Miserables.txt 7
assistance	Miserables.txt 22
assistant	Miserables.txt 5
assisted	Miserables.txt 7
assisting	Miserables.txt 4
assizes	Miserables.txt 22
associate	Miserables.txt 2
associated	Miserables.txt 12
associates	Miserables.txt 1
association	Miserables.txt 6
associations	Miserables.txt 4
assonance	Miserables.txt 1
assorted	Miserables.txt 2
assuage	Miserables.txt 1
assuaging	Miserables.txt 1
assume	Miserables.txt 5
assumed	Miserables.txt 35
assumes	Miserables.txt 6
assuming	Miserables.txt 6
assumption	Miserables.txt 2
assurance	Miserables.txt 10
assure	Miserables.txt 10
assured	Miserables.txt 10
assuredly	Miserables.txt 22
asterisk	Miserables.txt 1
asthma	Miserables.txt 3
astonish	Miserables.txt 2
astonished	Miserables.txt 26
astonishes	Miserables.txt 1
astonishing	Miserables.txt 5
astonishingly	Miserables.txt 1
astonishment	Miserables.txt 20
astonishments	Miserables.txt 2
astor	Miserables.txt 1
astound	Miserables.txt 1
astounded	Miserables.txt 6
astounding	Miserables.txt 4
astounds	Miserables.txt 3
astray	Miserables.txt 10
astre	Miserables.txt 1
astride	Miserables.txt 4
astronomer	Miserables.txt 2
astronomers	Miserables.txt 1
asturias	Miserables.txt 2
astute	Miserables.txt 1
astyalus	Miserables.txt 1
asunder	Miserables.txt 3
asylum	Miserables.txt 2
at	Miserables.txt 4070
atala	Miserables.txt 2
ate	Miserables.txt 35
atheist	Miserables.txt 3
atheists	Miserables.txt 2
athenian	Miserables.txt 2
athenians	Miserables.txt 2
athens	Miserables.txt 6
athlete	Miserables.txt 3
athwart	Miserables.txt 28
atiger	Miserables.txt 1
atigeur	Miserables.txt 1
atlantic	Miserables.txt 1
atmosphere	Miserables.txt 7
atmospheric	Miserables.txt 1
atom	Miserables.txt 8
atoms	Miserables.txt 2
atrocious	Miserables.txt 2
atrocity	Miserables.txt 3
attach	Miserables.txt 6
attached	Miserables.txt 49
attaches	Miserables.txt 1
attaching	Miserables.txt 5
attachment	Miserables.txt 1
attack	Miserables.txt 61
attacked	Miserables.txt 33
attacking	Miserables.txt 10
attacks	Miserables.txt 8
attain	Miserables.txt 4
attainable	Miserables.txt 1
attained	Miserables.txt 18
attaining	Miserables.txt 3
attains	Miserables.txt 2
attar	Miserables.txt 1
attempt	Miserables.txt 33
attempted	Miserables.txt 10
attempting	Miserables.txt 1
attempts	Miserables.txt 10
attend	Miserables.txt 9
attendance	Miserables.txt 1
attended	Miserables.txt 9
attending	Miserables.txt 1
attends	Miserables.txt 1
attention	Miserables.txt 96
attentions	Miserables.txt 3
attentive	Miserables.txt 12
attentively	Miserables.txt 17
attenuating	Miserables.txt 4
attestation	Miserables.txt 1
attested	Miserables.txt 4
attests	Miserables.txt 1
attic	Miserables.txt 40
attics	Miserables.txt 5
attila	Miserables.txt 1
attire	Miserables.txt 8
attired	Miserables.txt 1
attitude	Miserables.txt 62
attitudes	Miserables.txt 9
attorney	Miserables.txt 45
attorneys	Miserables.txt 7
attract	Miserables.txt 9
attracted	Miserables.txt 19
attracting	Miserables.txt 2
attraction	Miserables.txt 5
attractive	Miserables.txt 2
attracts	Miserables.txt 6
attribute	Miserables.txt 3
attributed	Miserables.txt 10
au	Miserables.txt 20
aube	Miserables.txt 2
aubepines	Miserables.txt 1
auberge	Miserables.txt 1
aubert	Miserables.txt 1
aubervilliers	Miserables.txt 2
aubiers	Miserables.txt 1
aubigne	Miserables.txt 1
aubry	Miserables.txt 4
auch	Miserables.txt 1
auction	Miserables.txt 1
audacious	Miserables.txt 8
audaciously	Miserables.txt 3
audacity	Miserables.txt 15
audeat	Miserables.txt 1
audible	Miserables.txt 55
audience	Miserables.txt 21
audincourt	Miserables.txt 1
auditing	Miserables.txt 1
auditor	Miserables.txt 1
auditors	Miserables.txt 1
audry	Miserables.txt 1
aug	Miserables.txt 1
augean	Miserables.txt 1
augment	Miserables.txt 8
augmentation	Miserables.txt 3
augmentations	Miserables.txt 2
augmented	Miserables.txt 17
augmenting	Miserables.txt 4
augments	Miserables.txt 1
augured	Miserables.txt 2
augurs	Miserables.txt 2
augury	Miserables.txt 1
august	Miserables.txt 38
auguste	Miserables.txt 3
augustin	Miserables.txt 1
augustine	Miserables.txt 2
augustines	Miserables.txt 3
augustins	Miserables.txt 1
aulaire	Miserables.txt 1
aulus	Miserables.txt 1
aumarais	Miserables.txt 5
aunt	Miserables.txt 57
aunts	Miserables.txt 1
aunty	Miserables.txt 1
aura	Miserables.txt 1
aure	Miserables.txt 2
aurelius	Miserables.txt 2
aureole	Miserables.txt 7
auricula	Miserables.txt 1
aurora	Miserables.txt 10
auroral	Miserables.txt 2
auroras	Miserables.txt 1
aurore	Miserables.txt 1
auscultate	Miserables.txt 1
auscultation	Miserables.txt 1
auspicious	Miserables.txt 1
austere	Miserables.txt 16
austerities	Miserables.txt 6
austerity	Miserables.txt 4
austerlits	Miserables.txt 1
austerlitz	Miserables.txt 42
austin	Miserables.txt 3
austria	Miserables.txt 4
austrian	Miserables.txt 2
austrians	Miserables.txt 3
authentic	Miserables.txt 2
authenticated	Miserables.txt 3
authenticating	Miserables.txt 1
author	Miserables.txt 23
authoritative	Miserables.txt 2
authoritatively	Miserables.txt 2
authorities	Miserables.txt 20
authority	Miserables.txt 56
authorization	Miserables.txt 2
authorize	Miserables.txt 3
authorized	Miserables.txt 4
authorizes	Miserables.txt 1
authors	Miserables.txt 4
autograph	Miserables.txt 1
automatic	Miserables.txt 1
autonomasia	Miserables.txt 1
autre	Miserables.txt 3
autumn	Miserables.txt 7
auvergene	Miserables.txt 1
auvergnat	Miserables.txt 6
auvergne	Miserables.txt 7
auverney	Miserables.txt 1
aux	Miserables.txt 20
auxiliaries	Miserables.txt 1
auxiliary	Miserables.txt 3
avail	Miserables.txt 2
available	Miserables.txt 2
availed	Miserables.txt 2
avait	Miserables.txt 5
avalanche	Miserables.txt 2
avalanches	Miserables.txt 2
avaray	Miserables.txt 1
avarice	Miserables.txt 1
avaricious	Miserables.txt 7
avatars	Miserables.txt 2
ave	Miserables.txt 4
avec	Miserables.txt 4
avelle	Miserables.txt 1
avenge	Miserables.txt 3
avenged	Miserables.txt 3
avenging	Miserables.txt 3
aventine	Miserables.txt 4
avenue	Miserables.txt 7
average	Miserables.txt 5
aversion	Miserables.txt 4
avert	Miserables.txt 1
aves	Miserables.txt 1
aviaries	Miserables.txt 1
avidity	Miserables.txt 3
avignon	Miserables.txt 2
avions	Miserables.txt 1
avocat	Miserables.txt 2
avoid	Miserables.txt 13
avoided	Miserables.txt 21
avoiding	Miserables.txt 6
avoids	Miserables.txt 1
avoir	Miserables.txt 1
avons	Miserables.txt 2
avow	Miserables.txt 3
avowal	Miserables.txt 2
avoye	Miserables.txt 5
avril	Miserables.txt 2
await	Miserables.txt 8
awaited	Miserables.txt 12
awaiting	Miserables.txt 16
awaits	Miserables.txt 3
awake	Miserables.txt 9
awaken	Miserables.txt 5
awakened	Miserables.txt 12
awakening	Miserables.txt 8
awakens	Miserables.txt 4
awakes	Miserables.txt 2
awaking	Miserables.txt 2
awarded	Miserables.txt 1
awards	Miserables.txt 1
aware	Miserables.txt 28
awate	Miserables.txt 1
away	Miserables.txt 304
awe	Miserables.txt 4
awfully	Miserables.txt 1
awhile	Miserables.txt 2
awkward	Miserables.txt 9
awkwardly	Miserables.txt 1
awkwardness	Miserables.txt 1
awl	Miserables.txt 1
awoke	Miserables.txt 12
awry	Miserables.txt 2
axe	Miserables.txt 23
axes	Miserables.txt 5
axiom	Miserables.txt 1
axioms	Miserables.txt 2
axle	Miserables.txt 5
axles	Miserables.txt 3
axylus	Miserables.txt 1
aymon	Miserables.txt 1
azaleas	Miserables.txt 1
azelma	Miserables.txt 22
azrael	Miserables.txt 1
azure	Miserables.txt 22
