l	Miserables.txt 155, NotreDame_De_Paris.txt 42
la	Miserables.txt 291, NotreDame_De_Paris.txt 198
laas	NotreDame_De_Paris.txt 1
labarre	Miserables.txt 10
labatut	Miserables.txt 1
label	Miserables.txt 1
labor	Miserables.txt 39, NotreDame_De_Paris.txt 8
laborat	NotreDame_De_Paris.txt 3
laboratories	NotreDame_De_Paris.txt 1, Miserables.txt 1
laboratory	NotreDame_De_Paris.txt 3, Miserables.txt 3
labored	Miserables.txt 4
laborer	Miserables.txt 10
laborers	Miserables.txt 6
laboring	Miserables.txt 3
laborious	Miserables.txt 5, NotreDame_De_Paris.txt 2
laboriously	Miserables.txt 3, NotreDame_De_Paris.txt 1
labors	Miserables.txt 5, NotreDame_De_Paris.txt 2
labouisse	Miserables.txt 1
laburnum	Miserables.txt 1
labyrinth	Miserables.txt 14, NotreDame_De_Paris.txt 10
labyrinthine	Miserables.txt 2, NotreDame_De_Paris.txt 1
labyrinths	Miserables.txt 2
lac	Miserables.txt 1
lacabre	NotreDame_De_Paris.txt 1
lace	Miserables.txt 15, NotreDame_De_Paris.txt 6
laced	NotreDame_De_Paris.txt 1, Miserables.txt 1
lacedaemonian	Miserables.txt 1
lacenaire	Miserables.txt 6
lacer	Miserables.txt 1
lacerated	Miserables.txt 5, NotreDame_De_Paris.txt 2
lacerates	Miserables.txt 1
laceration	Miserables.txt 1
laces	Miserables.txt 3, NotreDame_De_Paris.txt 2
lacets	Miserables.txt 1
lacework	NotreDame_De_Paris.txt 1
lachaise	Miserables.txt 6
lacing	Miserables.txt 1
lack	Miserables.txt 29, NotreDame_De_Paris.txt 8
lacked	Miserables.txt 13, NotreDame_De_Paris.txt 6
lackey	Miserables.txt 5, NotreDame_De_Paris.txt 3
lackeys	NotreDame_De_Paris.txt 9, Miserables.txt 5
lacking	Miserables.txt 35, NotreDame_De_Paris.txt 5
lacks	NotreDame_De_Paris.txt 5, Miserables.txt 5
laconic	Miserables.txt 4, NotreDame_De_Paris.txt 1
laconically	Miserables.txt 1
laconicism	Miserables.txt 1
laconics	NotreDame_De_Paris.txt 1
lacoste	Miserables.txt 5
lacquer	Miserables.txt 3
lad	Miserables.txt 26, NotreDame_De_Paris.txt 1
ladder	NotreDame_De_Paris.txt 44, Miserables.txt 27
ladders	Miserables.txt 10, NotreDame_De_Paris.txt 4
ladehors	NotreDame_De_Paris.txt 1
laden	Miserables.txt 8
ladies	Miserables.txt 36, NotreDame_De_Paris.txt 7
ladle	Miserables.txt 4
ladre	NotreDame_De_Paris.txt 1
lads	NotreDame_De_Paris.txt 2, Miserables.txt 1
lady	Miserables.txt 47, NotreDame_De_Paris.txt 23
ladyfinger	Miserables.txt 1
laennec	Miserables.txt 1
laensberg	Miserables.txt 1
laertius	Miserables.txt 4
lafayette	Miserables.txt 20
lafayettes	Miserables.txt 1
laffitte	Miserables.txt 16
lafitte	Miserables.txt 1
lafon	Miserables.txt 1
laggard	Miserables.txt 1
laggards	NotreDame_De_Paris.txt 1
lagging	Miserables.txt 1
lagny	Miserables.txt 9
lagrange	Miserables.txt 1
lahautiere	Miserables.txt 1
laid	Miserables.txt 113, NotreDame_De_Paris.txt 24
laigle	Miserables.txt 43
lain	NotreDame_De_Paris.txt 2, Miserables.txt 1
laine	Miserables.txt 1
lair	Miserables.txt 19, NotreDame_De_Paris.txt 6
lairs	Miserables.txt 1
laiter	Miserables.txt 1
lake	Miserables.txt 9, NotreDame_De_Paris.txt 4
lakes	Miserables.txt 1
lallemand	Miserables.txt 1
lama	Miserables.txt 1
lamarque	Miserables.txt 14
lamartine	Miserables.txt 1
lamb	Miserables.txt 7, NotreDame_De_Paris.txt 5
lamballe	Miserables.txt 1
lambert	Miserables.txt 4, NotreDame_De_Paris.txt 1
lambs	Miserables.txt 2, NotreDame_De_Paris.txt 1
lame	NotreDame_De_Paris.txt 14, Miserables.txt 7
lamennais	Miserables.txt 3
lament	NotreDame_De_Paris.txt 1
lamentable	Miserables.txt 19, NotreDame_De_Paris.txt 4
lamentation	NotreDame_De_Paris.txt 1
lamentations	Miserables.txt 2
lamenting	NotreDame_De_Paris.txt 1, Miserables.txt 1
laminas	NotreDame_De_Paris.txt 1
lamoignon	Miserables.txt 4
lamothe	Miserables.txt 4
lamotte	Miserables.txt 1
lamp	Miserables.txt 28, NotreDame_De_Paris.txt 21
lampas	Miserables.txt 1
lampblack	Miserables.txt 2
lamplighter	NotreDame_De_Paris.txt 1
lamps	NotreDame_De_Paris.txt 5, Miserables.txt 4
lancait	Miserables.txt 1
lance	NotreDame_De_Paris.txt 3, Miserables.txt 3
lancer	Miserables.txt 20
lancers	Miserables.txt 7
lances	NotreDame_De_Paris.txt 5, Miserables.txt 3
lancet	NotreDame_De_Paris.txt 1, Miserables.txt 1
lancret	Miserables.txt 1
land	Miserables.txt 37, NotreDame_De_Paris.txt 6
landau	Miserables.txt 1
landed	Miserables.txt 5, NotreDame_De_Paris.txt 3
landing	Miserables.txt 9, NotreDame_De_Paris.txt 3
landlady	Miserables.txt 3
landless	NotreDame_De_Paris.txt 1
landlord	Miserables.txt 16
landry	NotreDame_De_Paris.txt 2
lands	Miserables.txt 5, NotreDame_De_Paris.txt 1
landscape	Miserables.txt 5, NotreDame_De_Paris.txt 1
landslip	Miserables.txt 1
lane	Miserables.txt 37, NotreDame_De_Paris.txt 2
lanes	Miserables.txt 4
langevin	Miserables.txt 1
langleviel	Miserables.txt 1
langres	Miserables.txt 1
language	Miserables.txt 50, NotreDame_De_Paris.txt 17
languages	Miserables.txt 4, NotreDame_De_Paris.txt 1
languedoc	Miserables.txt 1
languid	Miserables.txt 2
languidly	Miserables.txt 1
languished	Miserables.txt 2
languishing	Miserables.txt 2
languor	Miserables.txt 2, NotreDame_De_Paris.txt 1
laniare	NotreDame_De_Paris.txt 1
lannes	Miserables.txt 1
lanoire	Miserables.txt 1
lansquine	Miserables.txt 1
lantern	Miserables.txt 46, NotreDame_De_Paris.txt 16
lanterne	Miserables.txt 1
lanterns	Miserables.txt 25, NotreDame_De_Paris.txt 2
lanturn	NotreDame_De_Paris.txt 1
laon	Miserables.txt 1
lap	Miserables.txt 1
lapides	Miserables.txt 3
lapis	NotreDame_De_Paris.txt 1
laplace	Miserables.txt 1
lappe	Miserables.txt 1
lapped	Miserables.txt 1
lapping	Miserables.txt 1
laps	NotreDame_De_Paris.txt 1, Miserables.txt 1
lapse	Miserables.txt 11, NotreDame_De_Paris.txt 2
lapsed	Miserables.txt 1
laquasio	NotreDame_De_Paris.txt 1
larbin	Miserables.txt 1
larboard	Miserables.txt 1
larcenies	NotreDame_De_Paris.txt 1
lard	NotreDame_De_Paris.txt 1
larded	Miserables.txt 1
larder	NotreDame_De_Paris.txt 1
large	Miserables.txt 212, NotreDame_De_Paris.txt 80
largely	NotreDame_De_Paris.txt 1, Miserables.txt 1
larger	Miserables.txt 14, NotreDame_De_Paris.txt 8
largest	Miserables.txt 5, NotreDame_De_Paris.txt 4
larifla	Miserables.txt 1
lark	Miserables.txt 38, NotreDame_De_Paris.txt 3
larmes	Miserables.txt 1
laroche	Miserables.txt 1
larose	Miserables.txt 1
lartif	Miserables.txt 1
larton	Miserables.txt 3
larva	Miserables.txt 1
larvae	Miserables.txt 1
larynx	Miserables.txt 1
las	NotreDame_De_Paris.txt 2
lasciate	NotreDame_De_Paris.txt 2
lash	NotreDame_De_Paris.txt 2, Miserables.txt 1
lashed	Miserables.txt 2
lashes	Miserables.txt 9, NotreDame_De_Paris.txt 2
lashings	Miserables.txt 1
lass	Miserables.txt 4
lasses	Miserables.txt 3
lassitude	Miserables.txt 7
last	Miserables.txt 340, NotreDame_De_Paris.txt 126
lasted	Miserables.txt 26, NotreDame_De_Paris.txt 9
lasting	Miserables.txt 2
lastly	NotreDame_De_Paris.txt 14, Miserables.txt 8
lasts	Miserables.txt 3, NotreDame_De_Paris.txt 1
latch	Miserables.txt 16, NotreDame_De_Paris.txt 1
late	Miserables.txt 33, NotreDame_De_Paris.txt 14
lately	Miserables.txt 4, NotreDame_De_Paris.txt 1
latent	Miserables.txt 10, NotreDame_De_Paris.txt 1
later	Miserables.txt 173, NotreDame_De_Paris.txt 31
lateral	NotreDame_De_Paris.txt 5, Miserables.txt 2
laterally	NotreDame_De_Paris.txt 1
latest	Miserables.txt 3
lath	Miserables.txt 1
lathes	Miserables.txt 2
laths	NotreDame_De_Paris.txt 3
latil	Miserables.txt 1
latin	Miserables.txt 27, NotreDame_De_Paris.txt 24
latinist	Miserables.txt 1
latinitas	NotreDame_De_Paris.txt 1
latitudes	Miserables.txt 1
latour	Miserables.txt 1
latter	Miserables.txt 71, NotreDame_De_Paris.txt 23
lattice	Miserables.txt 5, NotreDame_De_Paris.txt 1
latticed	NotreDame_De_Paris.txt 3
lattices	Miserables.txt 2
laubespine	Miserables.txt 1
laudable	NotreDame_De_Paris.txt 1
laudamus	NotreDame_De_Paris.txt 1
lauded	NotreDame_De_Paris.txt 1
laudiniere	Miserables.txt 1
laugh	Miserables.txt 83, NotreDame_De_Paris.txt 48
laughable	Miserables.txt 2
laughed	Miserables.txt 35, NotreDame_De_Paris.txt 17
laughing	Miserables.txt 51, NotreDame_De_Paris.txt 16
laughingly	Miserables.txt 2
laughs	Miserables.txt 13, NotreDame_De_Paris.txt 3
laughter	Miserables.txt 47, NotreDame_De_Paris.txt 40
launch	Miserables.txt 1
launched	Miserables.txt 8, NotreDame_De_Paris.txt 6
launching	NotreDame_De_Paris.txt 1, Miserables.txt 1
laundress	Miserables.txt 3, NotreDame_De_Paris.txt 1
laundresses	Miserables.txt 4, NotreDame_De_Paris.txt 1
laundry	Miserables.txt 1
laurel	Miserables.txt 3, NotreDame_De_Paris.txt 1
laurels	Miserables.txt 2
laurent	NotreDame_De_Paris.txt 4
laurier	NotreDame_De_Paris.txt 1
laurium	Miserables.txt 1
lauzet	Miserables.txt 1
lava	NotreDame_De_Paris.txt 2, Miserables.txt 1
lavater	Miserables.txt 1
lavatory	NotreDame_De_Paris.txt 1, Miserables.txt 1
lavbesp	Miserables.txt 1
laved	Miserables.txt 1
laveuve	Miserables.txt 1
lavish	Miserables.txt 4
lavished	Miserables.txt 4, NotreDame_De_Paris.txt 1
lavishes	Miserables.txt 2, NotreDame_De_Paris.txt 1
lavishing	Miserables.txt 3, NotreDame_De_Paris.txt 1
lavishly	NotreDame_De_Paris.txt 1, Miserables.txt 1
law	Miserables.txt 137, NotreDame_De_Paris.txt 44
lawful	NotreDame_De_Paris.txt 1
lawgiver	Miserables.txt 1
lawless	NotreDame_De_Paris.txt 1
lawn	Miserables.txt 3
laws	Miserables.txt 28, NotreDame_De_Paris.txt 10
lawsuit	Miserables.txt 1
lawsuits	Miserables.txt 3
lawyer	Miserables.txt 42, NotreDame_De_Paris.txt 1
lawyers	Miserables.txt 9
lay	Miserables.txt 129, NotreDame_De_Paris.txt 31
laye	NotreDame_De_Paris.txt 2
layer	NotreDame_De_Paris.txt 11, Miserables.txt 11
layers	Miserables.txt 6, NotreDame_De_Paris.txt 3
laying	Miserables.txt 7, NotreDame_De_Paris.txt 6
layman	NotreDame_De_Paris.txt 2
lays	Miserables.txt 5
lazar	NotreDame_De_Paris.txt 2
lazare	Miserables.txt 3
lazaretto	Miserables.txt 1
lazariste	Miserables.txt 1
lazarists	Miserables.txt 2
laziness	NotreDame_De_Paris.txt 2, Miserables.txt 2
lazuli	NotreDame_De_Paris.txt 1
lazy	Miserables.txt 6, NotreDame_De_Paris.txt 5
lazybones	Miserables.txt 1
lazzarone	Miserables.txt 2
le	Miserables.txt 238, NotreDame_De_Paris.txt 58
lead	Miserables.txt 42, NotreDame_De_Paris.txt 24
leaden	NotreDame_De_Paris.txt 8, Miserables.txt 7
leader	Miserables.txt 15, NotreDame_De_Paris.txt 1
leaders	Miserables.txt 15
leading	Miserables.txt 27, NotreDame_De_Paris.txt 7
leads	Miserables.txt 17, NotreDame_De_Paris.txt 9
leadsman	Miserables.txt 1
leaf	NotreDame_De_Paris.txt 12, Miserables.txt 8
leafless	Miserables.txt 3
leaflets	Miserables.txt 1
leafy	NotreDame_De_Paris.txt 1
league	Miserables.txt 13, NotreDame_De_Paris.txt 3
leagues	Miserables.txt 43, NotreDame_De_Paris.txt 11
leak	Miserables.txt 2
leakage	Miserables.txt 2
lean	Miserables.txt 10, NotreDame_De_Paris.txt 2
leander	Miserables.txt 1
leaned	Miserables.txt 28, NotreDame_De_Paris.txt 7
leaning	Miserables.txt 22, NotreDame_De_Paris.txt 16
leanness	NotreDame_De_Paris.txt 2, Miserables.txt 1
leans	Miserables.txt 2
leap	NotreDame_De_Paris.txt 5, Miserables.txt 3
leaped	Miserables.txt 9, NotreDame_De_Paris.txt 7
leaping	NotreDame_De_Paris.txt 7, Miserables.txt 3
leaps	Miserables.txt 6
learn	Miserables.txt 16, NotreDame_De_Paris.txt 4
learned	Miserables.txt 39, NotreDame_De_Paris.txt 29
learning	NotreDame_De_Paris.txt 11, Miserables.txt 7
learns	NotreDame_De_Paris.txt 1, Miserables.txt 1
lease	Miserables.txt 2
leased	Miserables.txt 2
leases	Miserables.txt 2
least	Miserables.txt 109, NotreDame_De_Paris.txt 53
leather	NotreDame_De_Paris.txt 20, Miserables.txt 18
leave	Miserables.txt 86, NotreDame_De_Paris.txt 30
leaved	Miserables.txt 2
leaven	Miserables.txt 1
leavened	NotreDame_De_Paris.txt 3
leaves	Miserables.txt 48, NotreDame_De_Paris.txt 14
leaveth	NotreDame_De_Paris.txt 1
leaving	Miserables.txt 44, NotreDame_De_Paris.txt 12
lebel	Miserables.txt 1
lebeuf	Miserables.txt 1
leblanc	Miserables.txt 112
lebras	Miserables.txt 1
lebrun	Miserables.txt 2
leclerc	NotreDame_De_Paris.txt 1
lecornu	NotreDame_De_Paris.txt 8
lecouffe	Miserables.txt 1
lectern	NotreDame_De_Paris.txt 1
lectoure	NotreDame_De_Paris.txt 1
lecture	NotreDame_De_Paris.txt 1, Miserables.txt 1
lecturers	Miserables.txt 1
lectures	Miserables.txt 3
led	Miserables.txt 45, NotreDame_De_Paris.txt 19
ledge	NotreDame_De_Paris.txt 2
leech	NotreDame_De_Paris.txt 6, Miserables.txt 1
leeches	Miserables.txt 1
lefebvre	Miserables.txt 2
left	Miserables.txt 356, NotreDame_De_Paris.txt 103
leg	Miserables.txt 37, NotreDame_De_Paris.txt 15
legacy	Miserables.txt 3
legal	Miserables.txt 16, NotreDame_De_Paris.txt 2
legally	Miserables.txt 3, NotreDame_De_Paris.txt 1
leganez	NotreDame_De_Paris.txt 1
legate	NotreDame_De_Paris.txt 8
legend	Miserables.txt 5
legendary	Miserables.txt 2
legends	Miserables.txt 5, NotreDame_De_Paris.txt 1
legere	Miserables.txt 1
legged	NotreDame_De_Paris.txt 3, Miserables.txt 1
legible	Miserables.txt 2
legibly	Miserables.txt 1
legion	Miserables.txt 17, NotreDame_De_Paris.txt 3
legionaries	Miserables.txt 1
legions	Miserables.txt 11, NotreDame_De_Paris.txt 1
legislation	NotreDame_De_Paris.txt 2, Miserables.txt 1
legislative	Miserables.txt 2
legislator	Miserables.txt 1
legist	Miserables.txt 2
legists	Miserables.txt 1
legitimacy	Miserables.txt 5
legitimate	Miserables.txt 14
legitimist	Miserables.txt 3
legitimists	Miserables.txt 1
legitur	NotreDame_De_Paris.txt 1
legle	Miserables.txt 2
legless	NotreDame_De_Paris.txt 3, Miserables.txt 1
legris	NotreDame_De_Paris.txt 2
legros	Miserables.txt 1
legs	Miserables.txt 38, NotreDame_De_Paris.txt 31
leibnitz	Miserables.txt 1
leipzig	Miserables.txt 2
leisure	Miserables.txt 9, NotreDame_De_Paris.txt 3
lemaitre	Miserables.txt 1
lemarchant	Miserables.txt 1
lemarin	Miserables.txt 1
lemblin	Miserables.txt 2
lemonade	Miserables.txt 1
lemy	NotreDame_De_Paris.txt 1
lend	Miserables.txt 15, NotreDame_De_Paris.txt 6
lending	Miserables.txt 6
lends	Miserables.txt 4
length	Miserables.txt 45, NotreDame_De_Paris.txt 43
lengthened	NotreDame_De_Paris.txt 1, Miserables.txt 1
lengthening	Miserables.txt 1
lengths	NotreDame_De_Paris.txt 1, Miserables.txt 1
lengthwise	NotreDame_De_Paris.txt 1, Miserables.txt 1
lengthy	Miserables.txt 2
lenoir	Miserables.txt 4
lenormand	Miserables.txt 1
lenotre	Miserables.txt 1
lent	Miserables.txt 18, NotreDame_De_Paris.txt 3
lenten	Miserables.txt 1
leo	Miserables.txt 3, NotreDame_De_Paris.txt 1
leon	Miserables.txt 4
leonidas	Miserables.txt 5
leonine	Miserables.txt 2
leopards	NotreDame_De_Paris.txt 1
lepers	NotreDame_De_Paris.txt 1
leprosy	Miserables.txt 4, NotreDame_De_Paris.txt 1
leprous	NotreDame_De_Paris.txt 2, Miserables.txt 2
lerida	Miserables.txt 1
lerins	Miserables.txt 1
les	Miserables.txt 60, NotreDame_De_Paris.txt 10
lescaut	Miserables.txt 1
lescrivain	NotreDame_De_Paris.txt 1
lesdiguieres	Miserables.txt 1
lesgle	Miserables.txt 5
lesgueules	Miserables.txt 2
lesions	NotreDame_De_Paris.txt 1, Miserables.txt 1
lespinasse	NotreDame_De_Paris.txt 1
less	Miserables.txt 167, NotreDame_De_Paris.txt 84
lessen	Miserables.txt 1
lessened	Miserables.txt 1
lessens	Miserables.txt 4
lesser	Miserables.txt 4, NotreDame_De_Paris.txt 2
lesson	Miserables.txt 11, NotreDame_De_Paris.txt 2
lessons	Miserables.txt 9
lest	Miserables.txt 10, NotreDame_De_Paris.txt 6
lestins	NotreDame_De_Paris.txt 1
let	Miserables.txt 458, NotreDame_De_Paris.txt 123
letellier	Miserables.txt 2
lethargic	NotreDame_De_Paris.txt 1, Miserables.txt 1
lethargies	Miserables.txt 1
lethargy	Miserables.txt 3
lethe	Miserables.txt 1
letourneur	Miserables.txt 1
lets	Miserables.txt 7, NotreDame_De_Paris.txt 2
letter	Miserables.txt 140, NotreDame_De_Paris.txt 6
lettered	NotreDame_De_Paris.txt 3, Miserables.txt 2
letters	Miserables.txt 71, NotreDame_De_Paris.txt 34
letting	Miserables.txt 8, NotreDame_De_Paris.txt 2
lettuce	NotreDame_De_Paris.txt 2, Miserables.txt 1
leu	Miserables.txt 2
leur	Miserables.txt 3, NotreDame_De_Paris.txt 1
levant	Miserables.txt 1
levantin	Miserables.txt 1
levantine	Miserables.txt 3
levee	Miserables.txt 2
level	Miserables.txt 44, NotreDame_De_Paris.txt 7
levelled	Miserables.txt 7
leveller	Miserables.txt 1
levellers	Miserables.txt 1
levelling	Miserables.txt 2
levels	Miserables.txt 2, NotreDame_De_Paris.txt 1
leven	Miserables.txt 1
lever	Miserables.txt 8
levers	NotreDame_De_Paris.txt 2
levi	Miserables.txt 1
leviathan	Miserables.txt 2
levied	Miserables.txt 3
levies	Miserables.txt 2
levis	Miserables.txt 1
leviticus	Miserables.txt 1
levities	Miserables.txt 1
levity	Miserables.txt 1
levre	Miserables.txt 1
lewd	NotreDame_De_Paris.txt 3
lewdness	NotreDame_De_Paris.txt 1
lex	NotreDame_De_Paris.txt 1, Miserables.txt 1
lexicon	NotreDame_De_Paris.txt 1
leyden	Miserables.txt 1
lez	NotreDame_De_Paris.txt 1
lheulier	NotreDame_De_Paris.txt 5
li	NotreDame_De_Paris.txt 18
liability	NotreDame_De_Paris.txt 4, Miserables.txt 3
liable	Miserables.txt 6, NotreDame_De_Paris.txt 1
liaison	Miserables.txt 1
liar	Miserables.txt 3
liard	Miserables.txt 7, NotreDame_De_Paris.txt 1
liards	NotreDame_De_Paris.txt 5
liars	Miserables.txt 1
liberal	Miserables.txt 8, NotreDame_De_Paris.txt 3
liberalism	Miserables.txt 6
liberals	Miserables.txt 6
liberate	Miserables.txt 1
liberated	Miserables.txt 6
liberating	Miserables.txt 1
liberation	Miserables.txt 4
liberator	Miserables.txt 4
liberators	Miserables.txt 1
liberavit	Miserables.txt 2
liberian	Miserables.txt 1
libero	NotreDame_De_Paris.txt 1
liberties	NotreDame_De_Paris.txt 2, Miserables.txt 2
libertine	NotreDame_De_Paris.txt 6, Miserables.txt 1
libertise	Miserables.txt 1
libertize	Miserables.txt 1
liberty	Miserables.txt 98, NotreDame_De_Paris.txt 15
libraries	NotreDame_De_Paris.txt 1
library	Miserables.txt 17, NotreDame_De_Paris.txt 2
libras	Miserables.txt 2
librations	Miserables.txt 1
libretto	Miserables.txt 1
lic	NotreDame_De_Paris.txt 1
lice	Miserables.txt 5
license	Miserables.txt 18, NotreDame_De_Paris.txt 17
licensed	Miserables.txt 3, NotreDame_De_Paris.txt 2
licentia	Miserables.txt 1
licentiate	NotreDame_De_Paris.txt 2, Miserables.txt 1
licentiates	Miserables.txt 1
licet	Miserables.txt 1
lichens	Miserables.txt 1
lick	Miserables.txt 2, NotreDame_De_Paris.txt 1
licked	Miserables.txt 1
licking	NotreDame_De_Paris.txt 2
lid	Miserables.txt 5
lids	Miserables.txt 5, NotreDame_De_Paris.txt 1
lie	Miserables.txt 48, NotreDame_De_Paris.txt 7
liebig	Miserables.txt 1
lied	Miserables.txt 14, NotreDame_De_Paris.txt 2
lieds	NotreDame_De_Paris.txt 1
lief	NotreDame_De_Paris.txt 1
liege	Miserables.txt 2
lies	Miserables.txt 57, NotreDame_De_Paris.txt 6
liest	NotreDame_De_Paris.txt 2
lieu	Miserables.txt 7, NotreDame_De_Paris.txt 3
lieutenant	Miserables.txt 28, NotreDame_De_Paris.txt 5
lieutenants	Miserables.txt 4, NotreDame_De_Paris.txt 2
life	Miserables.txt 424, NotreDame_De_Paris.txt 93
lifeless	NotreDame_De_Paris.txt 3, Miserables.txt 2
lifetime	Miserables.txt 4
lift	Miserables.txt 14, NotreDame_De_Paris.txt 1
lifted	Miserables.txt 27, NotreDame_De_Paris.txt 7
lifting	Miserables.txt 4, NotreDame_De_Paris.txt 1
lifts	Miserables.txt 2
ligature	Miserables.txt 1
ligatures	NotreDame_De_Paris.txt 1, Miserables.txt 1
light	Miserables.txt 436, NotreDame_De_Paris.txt 122
lighted	Miserables.txt 107, NotreDame_De_Paris.txt 28
lighten	Miserables.txt 1
lightened	Miserables.txt 2
lightening	Miserables.txt 1
lightens	Miserables.txt 1
lighter	Miserables.txt 5
lighterman	Miserables.txt 1
lightest	Miserables.txt 2
lighting	Miserables.txt 4, NotreDame_De_Paris.txt 2
lightly	Miserables.txt 10, NotreDame_De_Paris.txt 1
lightness	NotreDame_De_Paris.txt 2
lightning	Miserables.txt 62, NotreDame_De_Paris.txt 18
lightnings	Miserables.txt 6, NotreDame_De_Paris.txt 4
lights	Miserables.txt 20, NotreDame_De_Paris.txt 5
ligniville	Miserables.txt 1
ligny	Miserables.txt 1
like	Miserables.txt 985, NotreDame_De_Paris.txt 404
liked	Miserables.txt 32, NotreDame_De_Paris.txt 5
likely	Miserables.txt 2, NotreDame_De_Paris.txt 1
likeness	Miserables.txt 5
likes	NotreDame_De_Paris.txt 2, Miserables.txt 2
likewise	NotreDame_De_Paris.txt 4, Miserables.txt 4
lilac	Miserables.txt 1
lilacs	Miserables.txt 7
lilies	Miserables.txt 4
lille	Miserables.txt 2
lillois	Miserables.txt 1
lilting	Miserables.txt 1
lily	Miserables.txt 7, NotreDame_De_Paris.txt 1
limam	Miserables.txt 1
limb	Miserables.txt 14, NotreDame_De_Paris.txt 6
limbo	Miserables.txt 2
limbos	Miserables.txt 2
limbs	Miserables.txt 20, NotreDame_De_Paris.txt 10
lime	Miserables.txt 8
limestone	NotreDame_De_Paris.txt 1
limit	Miserables.txt 16, NotreDame_De_Paris.txt 2
limitation	Miserables.txt 4, NotreDame_De_Paris.txt 3
limited	Miserables.txt 8, NotreDame_De_Paris.txt 6
limitless	Miserables.txt 1
limits	Miserables.txt 9, NotreDame_De_Paris.txt 2
limo	NotreDame_De_Paris.txt 1
limoges	Miserables.txt 3
limosin	Miserables.txt 1
limousin	Miserables.txt 1
limp	Miserables.txt 5, NotreDame_De_Paris.txt 1
limped	Miserables.txt 4
limpers	Miserables.txt 1
limpid	Miserables.txt 5, NotreDame_De_Paris.txt 1
limping	NotreDame_De_Paris.txt 5
limps	NotreDame_De_Paris.txt 1, Miserables.txt 1
linden	Miserables.txt 5
line	Miserables.txt 87, NotreDame_De_Paris.txt 23
lineage	NotreDame_De_Paris.txt 1
lineaments	Miserables.txt 1
lined	Miserables.txt 7, NotreDame_De_Paris.txt 2
linen	Miserables.txt 61, NotreDame_De_Paris.txt 6
lines	Miserables.txt 68, NotreDame_De_Paris.txt 14
ling	NotreDame_De_Paris.txt 1
linger	Miserables.txt 3
lingered	Miserables.txt 9, NotreDame_De_Paris.txt 4
lingerie	Miserables.txt 1
lingering	Miserables.txt 2
lingers	Miserables.txt 4
lingre	Miserables.txt 1
linguist	Miserables.txt 1
lining	Miserables.txt 3
link	Miserables.txt 2, NotreDame_De_Paris.txt 1
linked	NotreDame_De_Paris.txt 2, Miserables.txt 2
links	Miserables.txt 5, NotreDame_De_Paris.txt 3
linnaeus	Miserables.txt 1
linnet	Miserables.txt 1
linnets	Miserables.txt 3
linseed	Miserables.txt 1
linsey	NotreDame_De_Paris.txt 2
lint	Miserables.txt 14
lintstocks	Miserables.txt 1
lion	Miserables.txt 27, NotreDame_De_Paris.txt 11
lioness	NotreDame_De_Paris.txt 2
lions	NotreDame_De_Paris.txt 10, Miserables.txt 6
lip	Miserables.txt 10, NotreDame_De_Paris.txt 4
lips	Miserables.txt 57, NotreDame_De_Paris.txt 45
liquid	Miserables.txt 8, NotreDame_De_Paris.txt 1
liquidation	Miserables.txt 1
liquids	Miserables.txt 1
liquor	Miserables.txt 2
lirlonfa	Miserables.txt 1
lis	NotreDame_De_Paris.txt 6
lisa	Miserables.txt 1
lise	Miserables.txt 2
lisette	Miserables.txt 1
lisp	Miserables.txt 1
lisped	NotreDame_De_Paris.txt 2
lisping	Miserables.txt 1
lisps	Miserables.txt 1
list	Miserables.txt 13, NotreDame_De_Paris.txt 2
listen	Miserables.txt 64, NotreDame_De_Paris.txt 45
listened	Miserables.txt 69, NotreDame_De_Paris.txt 19
listener	NotreDame_De_Paris.txt 1
listeners	NotreDame_De_Paris.txt 1, Miserables.txt 1
listening	Miserables.txt 32, NotreDame_De_Paris.txt 21
listens	Miserables.txt 3
listing	Miserables.txt 1
listlessness	Miserables.txt 1
listolier	Miserables.txt 12
litany	NotreDame_De_Paris.txt 1
literally	Miserables.txt 8, NotreDame_De_Paris.txt 1
literary	Miserables.txt 22, NotreDame_De_Paris.txt 16
literature	Miserables.txt 9, NotreDame_De_Paris.txt 3
litigants	NotreDame_De_Paris.txt 1
litres	Miserables.txt 2
litter	Miserables.txt 5, NotreDame_De_Paris.txt 4
littered	Miserables.txt 1
litters	Miserables.txt 2
little	Miserables.txt 983, NotreDame_De_Paris.txt 369
liv	NotreDame_De_Paris.txt 1
live	Miserables.txt 136, NotreDame_De_Paris.txt 13
lived	Miserables.txt 102, NotreDame_De_Paris.txt 6
livelihood	Miserables.txt 2
lively	Miserables.txt 15, NotreDame_De_Paris.txt 10
liver	Miserables.txt 4
liveries	Miserables.txt 3
livery	NotreDame_De_Paris.txt 3, Miserables.txt 2
lives	Miserables.txt 47, NotreDame_De_Paris.txt 2
livid	Miserables.txt 34, NotreDame_De_Paris.txt 3
lividly	Miserables.txt 2
lividness	Miserables.txt 2
living	Miserables.txt 108, NotreDame_De_Paris.txt 31
livres	NotreDame_De_Paris.txt 42, Miserables.txt 16
livry	Miserables.txt 5
lizard	Miserables.txt 2, NotreDame_De_Paris.txt 1
lizards	Miserables.txt 2
ll	Miserables.txt 87, NotreDame_De_Paris.txt 17
llama	Miserables.txt 1
lo	Miserables.txt 2
load	Miserables.txt 18, NotreDame_De_Paris.txt 2
loaded	Miserables.txt 24, NotreDame_De_Paris.txt 20
loading	Miserables.txt 2
loads	Miserables.txt 5, NotreDame_De_Paris.txt 1
loadstone	Miserables.txt 1
loadstones	NotreDame_De_Paris.txt 1
loaf	Miserables.txt 18, NotreDame_De_Paris.txt 2
loam	Miserables.txt 1
loan	Miserables.txt 2
loans	NotreDame_De_Paris.txt 1
loath	NotreDame_De_Paris.txt 1
lobau	Miserables.txt 11
lobby	Miserables.txt 1
lobe	NotreDame_De_Paris.txt 1, Miserables.txt 1
local	Miserables.txt 14
localities	Miserables.txt 3, NotreDame_De_Paris.txt 1
locality	Miserables.txt 8, NotreDame_De_Paris.txt 1
located	Miserables.txt 7, NotreDame_De_Paris.txt 4
locations	NotreDame_De_Paris.txt 2, Miserables.txt 2
locher	Miserables.txt 1
loches	NotreDame_De_Paris.txt 1
lock	Miserables.txt 27, NotreDame_De_Paris.txt 7
locked	Miserables.txt 14, NotreDame_De_Paris.txt 1
locking	Miserables.txt 2
locks	Miserables.txt 21, NotreDame_De_Paris.txt 3
locksmith	Miserables.txt 4, NotreDame_De_Paris.txt 1
locksmiths	NotreDame_De_Paris.txt 4
loco	Miserables.txt 2
locomotive	Miserables.txt 2
locomotives	Miserables.txt 2
locus	NotreDame_De_Paris.txt 1
locution	Miserables.txt 1
locutions	Miserables.txt 1
lodge	Miserables.txt 20, NotreDame_De_Paris.txt 3
lodged	Miserables.txt 12, NotreDame_De_Paris.txt 1
lodgement	Miserables.txt 1
lodger	Miserables.txt 6
lodgers	Miserables.txt 3
lodges	Miserables.txt 3
lodging	Miserables.txt 19, NotreDame_De_Paris.txt 7
lodgings	Miserables.txt 17
lodi	Miserables.txt 3
lodoiska	Miserables.txt 1
lods	Miserables.txt 1
loemnoeus	NotreDame_De_Paris.txt 1
loetare	NotreDame_De_Paris.txt 1
loft	Miserables.txt 2
loftier	Miserables.txt 1
loftiest	Miserables.txt 2
loftiness	Miserables.txt 1
lofty	Miserables.txt 63, NotreDame_De_Paris.txt 34
log	Miserables.txt 2, NotreDame_De_Paris.txt 1
loggerheads	Miserables.txt 2
logic	Miserables.txt 16, NotreDame_De_Paris.txt 2
logical	Miserables.txt 8, NotreDame_De_Paris.txt 2
logs	Miserables.txt 1
loi	NotreDame_De_Paris.txt 1
loins	Miserables.txt 11, NotreDame_De_Paris.txt 3
loire	Miserables.txt 8
loiterers	Miserables.txt 1
loizerolles	Miserables.txt 1
lola	Miserables.txt 2
lolling	NotreDame_De_Paris.txt 2
lolotte	Miserables.txt 2
lombard	NotreDame_De_Paris.txt 2, Miserables.txt 2
lombards	NotreDame_De_Paris.txt 1, Miserables.txt 1
lombier	Miserables.txt 2
lon	Miserables.txt 14
london	Miserables.txt 11, NotreDame_De_Paris.txt 3
londrin	Miserables.txt 1
lone	Miserables.txt 3
loneliness	NotreDame_De_Paris.txt 1
lonely	Miserables.txt 2, NotreDame_De_Paris.txt 1
long	Miserables.txt 416, NotreDame_De_Paris.txt 151
longchamps	Miserables.txt 3
longed	Miserables.txt 3
longer	Miserables.txt 432, NotreDame_De_Paris.txt 135
longest	Miserables.txt 4, NotreDame_De_Paris.txt 2
longevity	Miserables.txt 2
longshoreman	Miserables.txt 1
longshoremen	Miserables.txt 2, NotreDame_De_Paris.txt 1
longue	NotreDame_De_Paris.txt 1
longuejoue	NotreDame_De_Paris.txt 1
longueville	Miserables.txt 1
longwood	Miserables.txt 1
lonjumeau	Miserables.txt 1
lons	NotreDame_De_Paris.txt 1
look	Miserables.txt 164, NotreDame_De_Paris.txt 81
looked	Miserables.txt 132, NotreDame_De_Paris.txt 66
looking	Miserables.txt 49, NotreDame_De_Paris.txt 19
lookout	NotreDame_De_Paris.txt 1, Miserables.txt 1
looks	NotreDame_De_Paris.txt 13, Miserables.txt 12
loomed	Miserables.txt 1
loop	Miserables.txt 4
loophole	NotreDame_De_Paris.txt 4, Miserables.txt 1
loopholes	Miserables.txt 7, NotreDame_De_Paris.txt 2
loose	Miserables.txt 15, NotreDame_De_Paris.txt 6
loosed	Miserables.txt 3, NotreDame_De_Paris.txt 1
loosely	Miserables.txt 1
loosened	Miserables.txt 3, NotreDame_De_Paris.txt 2
looses	Miserables.txt 1
loosing	Miserables.txt 2, NotreDame_De_Paris.txt 1
lopez	Miserables.txt 1
loquacious	Miserables.txt 2
loquacity	Miserables.txt 2
loques	Miserables.txt 1
lord	NotreDame_De_Paris.txt 33, Miserables.txt 24
lordly	Miserables.txt 1
lords	NotreDame_De_Paris.txt 11, Miserables.txt 3
lordship	NotreDame_De_Paris.txt 1, Miserables.txt 1
lordships	NotreDame_De_Paris.txt 1
lore	NotreDame_De_Paris.txt 1
lorette	Miserables.txt 1
lormian	Miserables.txt 1
lorn	Miserables.txt 1
lorraine	NotreDame_De_Paris.txt 1, Miserables.txt 1
lorsqu	Miserables.txt 1
lorsque	Miserables.txt 2
los	NotreDame_De_Paris.txt 1
lose	Miserables.txt 44, NotreDame_De_Paris.txt 11
loses	Miserables.txt 4, NotreDame_De_Paris.txt 2
losing	Miserables.txt 17, NotreDame_De_Paris.txt 1
loss	Miserables.txt 16, NotreDame_De_Paris.txt 2
losses	Miserables.txt 2
lost	Miserables.txt 159, NotreDame_De_Paris.txt 56
losthin	Miserables.txt 1
losvel	Miserables.txt 1
lot	Miserables.txt 9, NotreDame_De_Paris.txt 1
lothian	Miserables.txt 1
lotions	Miserables.txt 2
lots	Miserables.txt 4
lottery	Miserables.txt 7
loud	Miserables.txt 27, NotreDame_De_Paris.txt 12
louder	NotreDame_De_Paris.txt 3, Miserables.txt 2
loudest	NotreDame_De_Paris.txt 1, Miserables.txt 1
loudly	Miserables.txt 8, NotreDame_De_Paris.txt 4
louis	Miserables.txt 176, NotreDame_De_Paris.txt 99
louise	Miserables.txt 1
louison	Miserables.txt 2
lounge	Miserables.txt 3
lounged	Miserables.txt 1
lounger	Miserables.txt 3
loungers	Miserables.txt 4, NotreDame_De_Paris.txt 1
lounges	Miserables.txt 2
lounging	Miserables.txt 3
loup	Miserables.txt 3
loups	Miserables.txt 3
lourdes	Miserables.txt 1
louse	Miserables.txt 5
lout	NotreDame_De_Paris.txt 3, Miserables.txt 2
loutish	NotreDame_De_Paris.txt 1
louts	NotreDame_De_Paris.txt 10
louvain	NotreDame_De_Paris.txt 1
louvel	Miserables.txt 1
louviers	Miserables.txt 2, NotreDame_De_Paris.txt 1
louvois	Miserables.txt 2
louvre	NotreDame_De_Paris.txt 19, Miserables.txt 12
love	Miserables.txt 369, NotreDame_De_Paris.txt 133
loved	Miserables.txt 89, NotreDame_De_Paris.txt 22
loveliest	Miserables.txt 1
loveliness	Miserables.txt 1
lovely	Miserables.txt 12, NotreDame_De_Paris.txt 5
lover	Miserables.txt 21, NotreDame_De_Paris.txt 6
lovers	Miserables.txt 26, NotreDame_De_Paris.txt 7
loves	Miserables.txt 33, NotreDame_De_Paris.txt 10
lovest	Miserables.txt 1
loveth	NotreDame_De_Paris.txt 1
loving	Miserables.txt 16, NotreDame_De_Paris.txt 2
lovingly	NotreDame_De_Paris.txt 2, Miserables.txt 2
low	Miserables.txt 160, NotreDame_De_Paris.txt 94
lowe	Miserables.txt 2
lower	Miserables.txt 71, NotreDame_De_Paris.txt 25
lowered	Miserables.txt 25, NotreDame_De_Paris.txt 14
lowering	Miserables.txt 10
lowers	Miserables.txt 1
lowest	Miserables.txt 12, NotreDame_De_Paris.txt 1
lowliness	Miserables.txt 1
lowly	Miserables.txt 7, NotreDame_De_Paris.txt 1
loyal	NotreDame_De_Paris.txt 1, Miserables.txt 1
loyally	NotreDame_De_Paris.txt 1, Miserables.txt 1
loyalty	Miserables.txt 6, NotreDame_De_Paris.txt 1
loys	NotreDame_De_Paris.txt 1
loyson	Miserables.txt 2
lozenges	NotreDame_De_Paris.txt 1
lt	Miserables.txt 2
lu	Miserables.txt 1
lub	Miserables.txt 1
luc	Miserables.txt 5
luceat	Miserables.txt 1
lucenet	Miserables.txt 1
lucid	Miserables.txt 2
lucidity	Miserables.txt 3
lucifer	Miserables.txt 1
luck	Miserables.txt 16, NotreDame_De_Paris.txt 2
luckily	NotreDame_De_Paris.txt 2, Miserables.txt 2
lucky	Miserables.txt 16, NotreDame_De_Paris.txt 1
lucques	NotreDame_De_Paris.txt 1
lucrative	Miserables.txt 3
lucre	Miserables.txt 2
lucretius	Miserables.txt 1
ludovici	NotreDame_De_Paris.txt 1
ludovico	NotreDame_De_Paris.txt 1
ludwig	Miserables.txt 1
lugubrious	Miserables.txt 32, NotreDame_De_Paris.txt 7
lugubriously	Miserables.txt 1
lui	Miserables.txt 4
luise	Miserables.txt 1
luiserne	Miserables.txt 1
lukewarm	Miserables.txt 2
lukewarmness	NotreDame_De_Paris.txt 1
lull	Miserables.txt 3, NotreDame_De_Paris.txt 1
lullaby	Miserables.txt 1
lulle	NotreDame_De_Paris.txt 1
lulled	NotreDame_De_Paris.txt 3, Miserables.txt 3
lulls	Miserables.txt 1
lumiere	Miserables.txt 1
luminary	NotreDame_De_Paris.txt 1, Miserables.txt 1
luminous	Miserables.txt 24, NotreDame_De_Paris.txt 9
luminously	Miserables.txt 1
lump	Miserables.txt 4, NotreDame_De_Paris.txt 1
lumps	Miserables.txt 1
lune	Miserables.txt 3
lunenburg	Miserables.txt 3
luneville	Miserables.txt 1
lungs	Miserables.txt 10, NotreDame_De_Paris.txt 4
luniere	Miserables.txt 1
lurched	Miserables.txt 1
lured	Miserables.txt 1
lurette	Miserables.txt 1
lurked	Miserables.txt 4
lurking	NotreDame_De_Paris.txt 1
lurks	Miserables.txt 2
lust	NotreDame_De_Paris.txt 1
lustily	Miserables.txt 1
lustre	Miserables.txt 1
lustrous	Miserables.txt 4
lusts	Miserables.txt 2
lutetia	Miserables.txt 1
luther	NotreDame_De_Paris.txt 5, Miserables.txt 2
lutzen	Miserables.txt 2
lux	Miserables.txt 5
luxembourg	Miserables.txt 56, NotreDame_De_Paris.txt 3
luxuriant	NotreDame_De_Paris.txt 4
luxuriantly	NotreDame_De_Paris.txt 1
luxuries	Miserables.txt 2
luxuriosa	NotreDame_De_Paris.txt 1
luxurious	Miserables.txt 1
luxuriously	Miserables.txt 1
luxury	Miserables.txt 14, NotreDame_De_Paris.txt 2
luzerne	Miserables.txt 2
lyceum	Miserables.txt 1
lyceums	Miserables.txt 1
lycia	Miserables.txt 1
lying	Miserables.txt 37, NotreDame_De_Paris.txt 16
lymph	Miserables.txt 1
lymphatic	Miserables.txt 3
lynch	Miserables.txt 4
lynx	NotreDame_De_Paris.txt 1, Miserables.txt 1
lyon	NotreDame_De_Paris.txt 1
lyons	Miserables.txt 6, NotreDame_De_Paris.txt 1
lyre	NotreDame_De_Paris.txt 1, Miserables.txt 1
lyric	NotreDame_De_Paris.txt 1, Miserables.txt 1
lyrical	Miserables.txt 3
lyrically	Miserables.txt 1
lys	NotreDame_De_Paris.txt 62, Miserables.txt 13
