kader	Miserables.txt 1
kaleidoscope	NotreDame_De_Paris.txt 1, Miserables.txt 1
kantersten	NotreDame_De_Paris.txt 1
karnac	NotreDame_De_Paris.txt 1
keel	Miserables.txt 6
keen	Miserables.txt 1
keener	Miserables.txt 1
keenly	Miserables.txt 1
keep	Miserables.txt 69, NotreDame_De_Paris.txt 19
keeper	Miserables.txt 49, NotreDame_De_Paris.txt 4
keepers	Miserables.txt 3
keeping	Miserables.txt 21, NotreDame_De_Paris.txt 8
keeps	Miserables.txt 8, NotreDame_De_Paris.txt 4
keepsakes	Miserables.txt 1
kekcaa	Miserables.txt 2
kekscheb	Miserables.txt 1
keksekca	Miserables.txt 2
kellermann	Miserables.txt 4
kellner	Miserables.txt 1
kempt	Miserables.txt 5
kennel	Miserables.txt 6, NotreDame_De_Paris.txt 2
kept	Miserables.txt 66, NotreDame_De_Paris.txt 10
keravenant	Miserables.txt 1
kerchief	Miserables.txt 4
kerchiefs	Miserables.txt 1
kettle	Miserables.txt 1
key	Miserables.txt 68, NotreDame_De_Paris.txt 15
keyhole	Miserables.txt 3, NotreDame_De_Paris.txt 1
keys	Miserables.txt 5, NotreDame_De_Paris.txt 2
keystone	NotreDame_De_Paris.txt 4
khan	NotreDame_De_Paris.txt 1
khorassan	Miserables.txt 1
kian	Miserables.txt 1
kick	Miserables.txt 8, NotreDame_De_Paris.txt 6
kicked	Miserables.txt 3, NotreDame_De_Paris.txt 2
kicking	Miserables.txt 1
kicks	Miserables.txt 5
kielmansegg	Miserables.txt 1
kill	Miserables.txt 27, NotreDame_De_Paris.txt 19
killed	Miserables.txt 80, NotreDame_De_Paris.txt 12
killing	Miserables.txt 4
kills	Miserables.txt 10, NotreDame_De_Paris.txt 3
kilns	Miserables.txt 2
kind	Miserables.txt 35, NotreDame_De_Paris.txt 5
kindle	Miserables.txt 1
kindled	Miserables.txt 1
kindles	Miserables.txt 2
kindliness	Miserables.txt 2, NotreDame_De_Paris.txt 1
kindly	Miserables.txt 21, NotreDame_De_Paris.txt 2
kindness	Miserables.txt 19, NotreDame_De_Paris.txt 2
kindnesses	Miserables.txt 1
kinds	Miserables.txt 3
king	NotreDame_De_Paris.txt 300, Miserables.txt 124
kingdom	NotreDame_De_Paris.txt 8, Miserables.txt 5
kingdoms	Miserables.txt 2, NotreDame_De_Paris.txt 1
kingly	Miserables.txt 1
kings	Miserables.txt 35, NotreDame_De_Paris.txt 29
kinsman	Miserables.txt 1
kirikikiou	Miserables.txt 2
kislar	Miserables.txt 1
kiss	Miserables.txt 25, NotreDame_De_Paris.txt 15
kissed	Miserables.txt 23, NotreDame_De_Paris.txt 7
kisses	NotreDame_De_Paris.txt 14, Miserables.txt 7
kissing	NotreDame_De_Paris.txt 6, Miserables.txt 1
kisss	Miserables.txt 2
kitchen	Miserables.txt 21, NotreDame_De_Paris.txt 1
kitchens	NotreDame_De_Paris.txt 3, Miserables.txt 2
kitten	Miserables.txt 3, NotreDame_De_Paris.txt 1
kleber	Miserables.txt 3
kluze	Miserables.txt 1
knacker	Miserables.txt 3, NotreDame_De_Paris.txt 2
knapsack	Miserables.txt 18
knapsacks	Miserables.txt 1
knave	NotreDame_De_Paris.txt 25, Miserables.txt 3
knavery	Miserables.txt 2
knaves	NotreDame_De_Paris.txt 8, Miserables.txt 1
knawed	NotreDame_De_Paris.txt 1
kneaded	Miserables.txt 1
knee	Miserables.txt 36, NotreDame_De_Paris.txt 13
kneecap	Miserables.txt 1
kneed	NotreDame_De_Paris.txt 1
kneel	Miserables.txt 6, NotreDame_De_Paris.txt 2
kneeling	Miserables.txt 10, NotreDame_De_Paris.txt 4
kneels	Miserables.txt 2
kneepan	Miserables.txt 1
knees	Miserables.txt 82, NotreDame_De_Paris.txt 56
knell	Miserables.txt 6
knells	Miserables.txt 1
knelt	Miserables.txt 12, NotreDame_De_Paris.txt 7
knew	Miserables.txt 170, NotreDame_De_Paris.txt 39
knickknacks	Miserables.txt 1
knife	Miserables.txt 31, NotreDame_De_Paris.txt 10
knight	Miserables.txt 3, NotreDame_De_Paris.txt 1
knighted	Miserables.txt 1
knights	Miserables.txt 1
knitted	Miserables.txt 7, NotreDame_De_Paris.txt 2
knitting	Miserables.txt 4
knives	Miserables.txt 7
knob	Miserables.txt 6
knock	Miserables.txt 17, NotreDame_De_Paris.txt 6
knocked	Miserables.txt 18, NotreDame_De_Paris.txt 3
knocker	Miserables.txt 7, NotreDame_De_Paris.txt 1
knocking	Miserables.txt 5, NotreDame_De_Paris.txt 1
knocks	Miserables.txt 3
knoll	Miserables.txt 5
knolls	Miserables.txt 1
knot	Miserables.txt 17, NotreDame_De_Paris.txt 1
knots	Miserables.txt 4, NotreDame_De_Paris.txt 3
knotted	Miserables.txt 11, NotreDame_De_Paris.txt 10
knotting	Miserables.txt 2
knotty	Miserables.txt 2
know	Miserables.txt 520, NotreDame_De_Paris.txt 192
knowest	Miserables.txt 3
knoweth	NotreDame_De_Paris.txt 3, Miserables.txt 1
knowing	Miserables.txt 54, NotreDame_De_Paris.txt 13
knowingly	Miserables.txt 1
knowledge	Miserables.txt 10, NotreDame_De_Paris.txt 3
known	Miserables.txt 104, NotreDame_De_Paris.txt 12
knows	Miserables.txt 128, NotreDame_De_Paris.txt 26
knuckle	Miserables.txt 1
koburger	NotreDame_De_Paris.txt 1
kock	Miserables.txt 1
koran	NotreDame_De_Paris.txt 1
kosciusko	Miserables.txt 2
kruideniers	Miserables.txt 2
kuere	NotreDame_De_Paris.txt 1
kylsom	Miserables.txt 3
kyrie	NotreDame_De_Paris.txt 2
