f	Miserables.txt 19, NotreDame_De_Paris.txt 16
fa	NotreDame_De_Paris.txt 38, Miserables.txt 1
fabantou	Miserables.txt 17
fable	Miserables.txt 2
fables	Miserables.txt 1
fabre	Miserables.txt 10
fabri	Miserables.txt 1
fabricate	Miserables.txt 1
fabricated	Miserables.txt 1
fabrique	Miserables.txt 1
fabulous	Miserables.txt 5
fabvier	Miserables.txt 1
fac	NotreDame_De_Paris.txt 2
facade	Miserables.txt 9, NotreDame_De_Paris.txt 1
facades	Miserables.txt 4
faccia	Miserables.txt 1
face	Miserables.txt 323, NotreDame_De_Paris.txt 164
faced	Miserables.txt 11, NotreDame_De_Paris.txt 4
faces	Miserables.txt 34, NotreDame_De_Paris.txt 30
faceted	NotreDame_De_Paris.txt 1
facets	NotreDame_De_Paris.txt 1
facial	Miserables.txt 1
facies	NotreDame_De_Paris.txt 1
facile	NotreDame_De_Paris.txt 1
facilitate	Miserables.txt 2
facility	Miserables.txt 3, NotreDame_De_Paris.txt 1
facing	Miserables.txt 25, NotreDame_De_Paris.txt 1
facit	NotreDame_De_Paris.txt 1, Miserables.txt 1
facitote	NotreDame_De_Paris.txt 2
facsimile	Miserables.txt 2
fact	Miserables.txt 281, NotreDame_De_Paris.txt 95
facta	Miserables.txt 2
faction	Miserables.txt 3, NotreDame_De_Paris.txt 1
factions	Miserables.txt 1
factious	Miserables.txt 2
factories	Miserables.txt 5
factors	Miserables.txt 1
factory	Miserables.txt 17
facts	Miserables.txt 47, NotreDame_De_Paris.txt 4
faculties	Miserables.txt 5, NotreDame_De_Paris.txt 4
faculty	Miserables.txt 6, NotreDame_De_Paris.txt 2
faded	Miserables.txt 5, NotreDame_De_Paris.txt 1
fades	NotreDame_De_Paris.txt 1
fading	Miserables.txt 4, NotreDame_De_Paris.txt 1
faenza	Miserables.txt 1
fafiot	Miserables.txt 2
fagon	Miserables.txt 1
fagot	NotreDame_De_Paris.txt 11, Miserables.txt 4
fagots	Miserables.txt 5, NotreDame_De_Paris.txt 4
faience	NotreDame_De_Paris.txt 1, Miserables.txt 1
fail	Miserables.txt 9
failed	Miserables.txt 19, NotreDame_De_Paris.txt 3
failing	Miserables.txt 3, NotreDame_De_Paris.txt 2
fails	Miserables.txt 1
failure	Miserables.txt 7, NotreDame_De_Paris.txt 4
failures	Miserables.txt 3
faim	Miserables.txt 1
fain	Miserables.txt 1
faint	Miserables.txt 19, NotreDame_De_Paris.txt 1
fainted	NotreDame_De_Paris.txt 2, Miserables.txt 2
fainter	Miserables.txt 1
faintest	Miserables.txt 3
fainting	Miserables.txt 7, NotreDame_De_Paris.txt 2
faintly	Miserables.txt 4
fair	NotreDame_De_Paris.txt 34, Miserables.txt 16
fairbanks	NotreDame_De_Paris.txt 1, Miserables.txt 1
faire	NotreDame_De_Paris.txt 1
fairest	NotreDame_De_Paris.txt 1
fairies	Miserables.txt 2
fairly	Miserables.txt 7, NotreDame_De_Paris.txt 3
fairs	Miserables.txt 6
fairy	Miserables.txt 8, NotreDame_De_Paris.txt 3
fairylike	NotreDame_De_Paris.txt 1
faisaient	Miserables.txt 2
fait	Miserables.txt 1
faite	Miserables.txt 1
faith	Miserables.txt 40, NotreDame_De_Paris.txt 17
faithful	Miserables.txt 8, NotreDame_De_Paris.txt 7
faithfully	Miserables.txt 2
fakir	Miserables.txt 1
fakirs	Miserables.txt 1
falbala	Miserables.txt 1
falcon	Miserables.txt 1
fall	Miserables.txt 140, NotreDame_De_Paris.txt 39
fallait	Miserables.txt 1
fallen	Miserables.txt 101, NotreDame_De_Paris.txt 17
falling	Miserables.txt 58, NotreDame_De_Paris.txt 16
fallow	Miserables.txt 1
falls	Miserables.txt 35, NotreDame_De_Paris.txt 2
falourdel	NotreDame_De_Paris.txt 13
false	Miserables.txt 54, NotreDame_De_Paris.txt 5
falsehood	Miserables.txt 3
falsely	NotreDame_De_Paris.txt 1, Miserables.txt 1
falsetto	NotreDame_De_Paris.txt 1
falsifying	Miserables.txt 1
falstaff	Miserables.txt 2
falsum	Miserables.txt 1
faltered	NotreDame_De_Paris.txt 1
faltering	Miserables.txt 1
falzapada	NotreDame_De_Paris.txt 1
fame	NotreDame_De_Paris.txt 2, Miserables.txt 2
famed	Miserables.txt 1
fameuil	Miserables.txt 11
familiar	Miserables.txt 13, NotreDame_De_Paris.txt 8
familiarity	Miserables.txt 3
familiarize	Miserables.txt 1
familiarized	Miserables.txt 1
familiarly	Miserables.txt 4, NotreDame_De_Paris.txt 2
families	Miserables.txt 31, NotreDame_De_Paris.txt 2
family	Miserables.txt 101, NotreDame_De_Paris.txt 15
famine	NotreDame_De_Paris.txt 2, Miserables.txt 2
famished	Miserables.txt 3, NotreDame_De_Paris.txt 2
famous	Miserables.txt 27, NotreDame_De_Paris.txt 13
fampoux	Miserables.txt 1
famueil	Miserables.txt 1
fan	Miserables.txt 3
fanatic	Miserables.txt 2
fanatical	Miserables.txt 2
fanaticism	Miserables.txt 8
fanaticisms	Miserables.txt 2
fanatics	Miserables.txt 2
fanchons	Miserables.txt 1
fancied	Miserables.txt 16, NotreDame_De_Paris.txt 9
fancies	Miserables.txt 8, NotreDame_De_Paris.txt 4
fanciful	NotreDame_De_Paris.txt 3
fancy	Miserables.txt 24, NotreDame_De_Paris.txt 13
fancying	Miserables.txt 2
fandangoes	NotreDame_De_Paris.txt 1
fangled	Miserables.txt 1
fangs	Miserables.txt 1
fanned	Miserables.txt 1
fannicot	Miserables.txt 6
fanouel	NotreDame_De_Paris.txt 1
fans	Miserables.txt 1
fantasies	NotreDame_De_Paris.txt 1
fantastic	NotreDame_De_Paris.txt 12, Miserables.txt 12
fantastical	NotreDame_De_Paris.txt 1
fantastically	NotreDame_De_Paris.txt 4
fantasy	Miserables.txt 2
fantine	Miserables.txt 210
faoucq	Miserables.txt 1
far	Miserables.txt 199, NotreDame_De_Paris.txt 72
faraud	Miserables.txt 1
farce	Miserables.txt 11, NotreDame_De_Paris.txt 3
farces	Miserables.txt 1
farcical	Miserables.txt 2
fare	Miserables.txt 3, NotreDame_De_Paris.txt 1
fared	Miserables.txt 1
farewell	Miserables.txt 13, NotreDame_De_Paris.txt 6
fargel	NotreDame_De_Paris.txt 1
farinace	Miserables.txt 1
farlane	Miserables.txt 2
farm	Miserables.txt 13, NotreDame_De_Paris.txt 2
farmer	Miserables.txt 3, NotreDame_De_Paris.txt 2
farmers	Miserables.txt 3
farmhouse	Miserables.txt 1
farming	Miserables.txt 2
farms	Miserables.txt 3
farnese	Miserables.txt 2
farrier	NotreDame_De_Paris.txt 1, Miserables.txt 1
farriers	NotreDame_De_Paris.txt 1
farther	NotreDame_De_Paris.txt 7, Miserables.txt 3
farthing	Miserables.txt 8, NotreDame_De_Paris.txt 2
farthings	NotreDame_De_Paris.txt 6, Miserables.txt 2
fas	NotreDame_De_Paris.txt 1, Miserables.txt 1
fascinate	Miserables.txt 1
fascinated	NotreDame_De_Paris.txt 3, Miserables.txt 2
fascinating	Miserables.txt 2
fascination	NotreDame_De_Paris.txt 3, Miserables.txt 3
fashion	Miserables.txt 76, NotreDame_De_Paris.txt 35
fashionable	Miserables.txt 6, NotreDame_De_Paris.txt 1
fashioned	Miserables.txt 4, NotreDame_De_Paris.txt 2
fashioning	NotreDame_De_Paris.txt 1
fashions	Miserables.txt 6, NotreDame_De_Paris.txt 3
fast	Miserables.txt 49, NotreDame_De_Paris.txt 8
fasten	Miserables.txt 10
fastened	Miserables.txt 32, NotreDame_De_Paris.txt 13
fastening	Miserables.txt 3
fastenings	Miserables.txt 3
faster	NotreDame_De_Paris.txt 1, Miserables.txt 1
fastidious	Miserables.txt 1
fasting	Miserables.txt 6, NotreDame_De_Paris.txt 2
fasts	Miserables.txt 1
fat	Miserables.txt 12, NotreDame_De_Paris.txt 6
fatal	Miserables.txt 60, NotreDame_De_Paris.txt 18
fatalist	Miserables.txt 1
fatalities	Miserables.txt 3
fatality	Miserables.txt 15, NotreDame_De_Paris.txt 4
fatally	Miserables.txt 6
fate	Miserables.txt 46, NotreDame_De_Paris.txt 13
fated	Miserables.txt 1
fates	Miserables.txt 2
father	Miserables.txt 605, NotreDame_De_Paris.txt 46
fatherland	Miserables.txt 3
fathers	Miserables.txt 20, NotreDame_De_Paris.txt 3
fathom	Miserables.txt 4
fathomed	NotreDame_De_Paris.txt 1
fathomless	Miserables.txt 5
fathoms	Miserables.txt 11, NotreDame_De_Paris.txt 1
fatigue	Miserables.txt 33, NotreDame_De_Paris.txt 8
fatigued	Miserables.txt 14, NotreDame_De_Paris.txt 2
fatiguing	Miserables.txt 1
fatis	Miserables.txt 1
fatness	Miserables.txt 1
faton	Miserables.txt 1
fatten	NotreDame_De_Paris.txt 1
fatter	Miserables.txt 1
fatuity	NotreDame_De_Paris.txt 1, Miserables.txt 1
fatum	NotreDame_De_Paris.txt 1
faubin	NotreDame_De_Paris.txt 1
faublas	Miserables.txt 1
faubourg	Miserables.txt 60, NotreDame_De_Paris.txt 4
faubourgs	Miserables.txt 12, NotreDame_De_Paris.txt 2
faucet	Miserables.txt 3
faucets	Miserables.txt 1
fauchants	Miserables.txt 1
fauchelevant	Miserables.txt 1
fauchelevent	Miserables.txt 298
fauchelevents	Miserables.txt 1
fauchewhat	Miserables.txt 1
fault	Miserables.txt 74, NotreDame_De_Paris.txt 11
faults	Miserables.txt 17, NotreDame_De_Paris.txt 3
faulty	Miserables.txt 2
faun	NotreDame_De_Paris.txt 1, Miserables.txt 1
fauna	Miserables.txt 1
fauntleroy	Miserables.txt 1
fauq	Miserables.txt 1
faust	NotreDame_De_Paris.txt 2, Miserables.txt 1
faut	Miserables.txt 1
faute	Miserables.txt 8
fauvent	Miserables.txt 22
faux	Miserables.txt 5
faverolles	Miserables.txt 16
favor	Miserables.txt 31, NotreDame_De_Paris.txt 6
favorable	Miserables.txt 5, NotreDame_De_Paris.txt 3
favorably	Miserables.txt 3
favored	NotreDame_De_Paris.txt 6, Miserables.txt 4
favorite	Miserables.txt 8, NotreDame_De_Paris.txt 3
favorites	NotreDame_De_Paris.txt 1, Miserables.txt 1
favors	Miserables.txt 2
favourite	Miserables.txt 42
favyn	NotreDame_De_Paris.txt 1
fawn	NotreDame_De_Paris.txt 3, Miserables.txt 1
fawned	Miserables.txt 1
fawns	Miserables.txt 1
fe	Miserables.txt 2
fear	Miserables.txt 90, NotreDame_De_Paris.txt 30
feared	Miserables.txt 32, NotreDame_De_Paris.txt 10
fearful	Miserables.txt 20
fearfully	Miserables.txt 1
fearing	Miserables.txt 5
fears	Miserables.txt 9, NotreDame_De_Paris.txt 2
feast	NotreDame_De_Paris.txt 7, Miserables.txt 6
feasted	NotreDame_De_Paris.txt 1
feasting	NotreDame_De_Paris.txt 2, Miserables.txt 2
feasts	NotreDame_De_Paris.txt 2
feat	Miserables.txt 1
feather	Miserables.txt 5, NotreDame_De_Paris.txt 3
feathered	NotreDame_De_Paris.txt 1
featherless	Miserables.txt 1
feathers	Miserables.txt 5, NotreDame_De_Paris.txt 1
feats	Miserables.txt 4, NotreDame_De_Paris.txt 3
feature	Miserables.txt 7, NotreDame_De_Paris.txt 1
features	Miserables.txt 10, NotreDame_De_Paris.txt 5
febrile	Miserables.txt 1
february	Miserables.txt 23, NotreDame_De_Paris.txt 1
febves	NotreDame_De_Paris.txt 1
fecamp	Miserables.txt 1
fecund	Miserables.txt 2, NotreDame_De_Paris.txt 1
fecundated	Miserables.txt 1
fecundating	Miserables.txt 1
fecundity	Miserables.txt 1
fed	Miserables.txt 8, NotreDame_De_Paris.txt 1
federal	NotreDame_De_Paris.txt 2, Miserables.txt 2
federates	Miserables.txt 1
federation	Miserables.txt 1
fee	Miserables.txt 12, NotreDame_De_Paris.txt 9
feeble	Miserables.txt 32, NotreDame_De_Paris.txt 6
feebleness	Miserables.txt 6, NotreDame_De_Paris.txt 1
feebler	Miserables.txt 1
feebly	Miserables.txt 8, NotreDame_De_Paris.txt 3
feed	NotreDame_De_Paris.txt 1, Miserables.txt 1
feeding	NotreDame_De_Paris.txt 1
feel	Miserables.txt 74, NotreDame_De_Paris.txt 20
feeling	Miserables.txt 34, NotreDame_De_Paris.txt 16
feelings	Miserables.txt 5
feels	Miserables.txt 41, NotreDame_De_Paris.txt 12
fees	Miserables.txt 5, NotreDame_De_Paris.txt 4
feet	Miserables.txt 208, NotreDame_De_Paris.txt 110
feign	Miserables.txt 1
feigned	Miserables.txt 2, NotreDame_De_Paris.txt 1
feigns	Miserables.txt 2
feint	Miserables.txt 2
feints	Miserables.txt 1
feletez	Miserables.txt 1
felicitations	NotreDame_De_Paris.txt 1
felicite	Miserables.txt 1
felicities	Miserables.txt 2
felicitous	Miserables.txt 1
felicity	Miserables.txt 12, NotreDame_De_Paris.txt 1
feline	Miserables.txt 2
felix	Miserables.txt 7
fell	Miserables.txt 197, NotreDame_De_Paris.txt 79
fellers	Miserables.txt 1
fellies	Miserables.txt 1
fellow	Miserables.txt 88, NotreDame_De_Paris.txt 28
fellows	Miserables.txt 19, NotreDame_De_Paris.txt 7
fellowship	Miserables.txt 1
felly	Miserables.txt 1
felt	Miserables.txt 304, NotreDame_De_Paris.txt 91
female	Miserables.txt 28, NotreDame_De_Paris.txt 16
females	NotreDame_De_Paris.txt 1, Miserables.txt 1
feminine	Miserables.txt 12, NotreDame_De_Paris.txt 4
femme	Miserables.txt 1
fen	NotreDame_De_Paris.txt 1
fence	Miserables.txt 20, NotreDame_De_Paris.txt 1
fenced	NotreDame_De_Paris.txt 1
fencing	Miserables.txt 8
fender	Miserables.txt 2
fennel	Miserables.txt 1
ferdinand	Miserables.txt 2
ferment	NotreDame_De_Paris.txt 3
fermentation	Miserables.txt 7
fermenting	Miserables.txt 1
ferments	NotreDame_De_Paris.txt 1
ferney	Miserables.txt 1
fernicle	NotreDame_De_Paris.txt 1
ferns	Miserables.txt 1
ferocious	Miserables.txt 44, NotreDame_De_Paris.txt 1
ferociously	Miserables.txt 3
ferocities	Miserables.txt 2
ferocity	Miserables.txt 6
ferou	Miserables.txt 1
ferrara	Miserables.txt 1
ferret	Miserables.txt 1
ferreted	Miserables.txt 2
ferrette	Miserables.txt 1
ferronnerie	NotreDame_De_Paris.txt 1
ferrution	NotreDame_De_Paris.txt 1
ferry	Miserables.txt 1
ferryman	NotreDame_De_Paris.txt 5
fers	Miserables.txt 1
fertanche	Miserables.txt 1
fertile	Miserables.txt 2, NotreDame_De_Paris.txt 1
fertility	Miserables.txt 1
fertilizers	Miserables.txt 1
fertille	Miserables.txt 1
fervacques	Miserables.txt 1
fervent	NotreDame_De_Paris.txt 1, Miserables.txt 1
fervor	Miserables.txt 1
fesch	Miserables.txt 3
festival	Miserables.txt 19, NotreDame_De_Paris.txt 17
festivals	Miserables.txt 6, NotreDame_De_Paris.txt 4
festive	Miserables.txt 1
fetch	Miserables.txt 23
fetched	Miserables.txt 3
fetching	Miserables.txt 1
fete	Miserables.txt 1
fetes	Miserables.txt 1
fetiches	Miserables.txt 1
fetid	Miserables.txt 7
fetidness	Miserables.txt 3
fetter	Miserables.txt 3, NotreDame_De_Paris.txt 1
fettered	Miserables.txt 1
fetters	Miserables.txt 6, NotreDame_De_Paris.txt 1
feu	NotreDame_De_Paris.txt 2, Miserables.txt 1
feudal	NotreDame_De_Paris.txt 9, Miserables.txt 5
feudalism	NotreDame_De_Paris.txt 5, Miserables.txt 3
feuillage	NotreDame_De_Paris.txt 1
feuillantines	Miserables.txt 1
feuilly	Miserables.txt 26
fever	Miserables.txt 44, NotreDame_De_Paris.txt 3
fevered	Miserables.txt 1
feverish	Miserables.txt 11
feverishly	Miserables.txt 1
fevers	Miserables.txt 6, NotreDame_De_Paris.txt 1
fevrier	Miserables.txt 1
few	Miserables.txt 284, NotreDame_De_Paris.txt 77
fewer	Miserables.txt 4
fex	Miserables.txt 2
feydeau	Miserables.txt 1
fez	Miserables.txt 2
fi	Miserables.txt 1
fiacre	Miserables.txt 17
fiacres	Miserables.txt 2
fiat	NotreDame_De_Paris.txt 2, Miserables.txt 2
fibre	NotreDame_De_Paris.txt 1
fibres	NotreDame_De_Paris.txt 2, Miserables.txt 2
fibrous	NotreDame_De_Paris.txt 1
fichtre	Miserables.txt 1
fichu	Miserables.txt 5
fichus	Miserables.txt 2
fickle	NotreDame_De_Paris.txt 1
fickleness	Miserables.txt 1
fictions	Miserables.txt 5
fictitious	Miserables.txt 2, NotreDame_De_Paris.txt 1
ficulnus	NotreDame_De_Paris.txt 1
fiddler	NotreDame_De_Paris.txt 1
fidelitas	NotreDame_De_Paris.txt 1
fidelity	Miserables.txt 4, NotreDame_De_Paris.txt 2
fidenae	Miserables.txt 1
fidgeted	Miserables.txt 1
fie	NotreDame_De_Paris.txt 2
fief	NotreDame_De_Paris.txt 10
fiefs	NotreDame_De_Paris.txt 1
field	Miserables.txt 58, NotreDame_De_Paris.txt 12
fields	Miserables.txt 27, NotreDame_De_Paris.txt 8
fiends	Miserables.txt 2
fier	Miserables.txt 1
fierce	Miserables.txt 29, NotreDame_De_Paris.txt 6
fiercest	Miserables.txt 2
fiery	NotreDame_De_Paris.txt 3, Miserables.txt 2
fieschi	Miserables.txt 1
fievee	Miserables.txt 1
fife	NotreDame_De_Paris.txt 2, Miserables.txt 1
fift	Miserables.txt 1
fifteen	Miserables.txt 89, NotreDame_De_Paris.txt 25
fifteenth	NotreDame_De_Paris.txt 29, Miserables.txt 6
fifth	Miserables.txt 29, NotreDame_De_Paris.txt 5
fifthly	Miserables.txt 1
fiftieth	Miserables.txt 1
fifty	Miserables.txt 67, NotreDame_De_Paris.txt 13
fig	Miserables.txt 4
figaro	NotreDame_De_Paris.txt 1
fight	Miserables.txt 21, NotreDame_De_Paris.txt 3
fighters	NotreDame_De_Paris.txt 1
fighting	Miserables.txt 20, NotreDame_De_Paris.txt 2
fights	Miserables.txt 2
figs	Miserables.txt 2
figuier	Miserables.txt 1
figuras	NotreDame_De_Paris.txt 1
figurative	Miserables.txt 1
figuratively	NotreDame_De_Paris.txt 1
figure	Miserables.txt 42, NotreDame_De_Paris.txt 24
figured	Miserables.txt 10, NotreDame_De_Paris.txt 4
figures	Miserables.txt 33, NotreDame_De_Paris.txt 25
figuring	NotreDame_De_Paris.txt 1
figuris	NotreDame_De_Paris.txt 1
filaments	Miserables.txt 1
filch	Miserables.txt 1
filched	Miserables.txt 4
file	Miserables.txt 19, NotreDame_De_Paris.txt 7
filed	Miserables.txt 1
files	Miserables.txt 11, NotreDame_De_Paris.txt 2
filial	Miserables.txt 2, NotreDame_De_Paris.txt 1
filium	Miserables.txt 2
fill	Miserables.txt 16, NotreDame_De_Paris.txt 4
fille	NotreDame_De_Paris.txt 3
filled	Miserables.txt 118, NotreDame_De_Paris.txt 28
filles	Miserables.txt 41, NotreDame_De_Paris.txt 1
fillets	Miserables.txt 1
fillette	Miserables.txt 1
filling	Miserables.txt 6
fillip	Miserables.txt 4, NotreDame_De_Paris.txt 1
filliping	Miserables.txt 1
fills	Miserables.txt 8, NotreDame_De_Paris.txt 4
filousophe	Miserables.txt 1
fils	Miserables.txt 1
filspierre	Miserables.txt 2
filter	Miserables.txt 4
filtered	Miserables.txt 3, NotreDame_De_Paris.txt 1
filtering	NotreDame_De_Paris.txt 1
filters	NotreDame_De_Paris.txt 1, Miserables.txt 1
filth	Miserables.txt 19, NotreDame_De_Paris.txt 1
filthy	Miserables.txt 1
final	Miserables.txt 24, NotreDame_De_Paris.txt 6
finally	Miserables.txt 57, NotreDame_De_Paris.txt 23
finance	Miserables.txt 2
finances	NotreDame_De_Paris.txt 1, Miserables.txt 1
financial	Miserables.txt 2, NotreDame_De_Paris.txt 1
financier	Miserables.txt 1
finch	Miserables.txt 1
find	Miserables.txt 135, NotreDame_De_Paris.txt 41
finder	Miserables.txt 1
finding	Miserables.txt 24, NotreDame_De_Paris.txt 8
finds	Miserables.txt 36, NotreDame_De_Paris.txt 10
fine	Miserables.txt 141, NotreDame_De_Paris.txt 126
fined	NotreDame_De_Paris.txt 1
finely	NotreDame_De_Paris.txt 1, Miserables.txt 1
fineness	Miserables.txt 3, NotreDame_De_Paris.txt 1
finer	NotreDame_De_Paris.txt 2
finery	Miserables.txt 3
fines	NotreDame_De_Paris.txt 1
finest	NotreDame_De_Paris.txt 8, Miserables.txt 6
finger	Miserables.txt 36, NotreDame_De_Paris.txt 25
fingering	NotreDame_De_Paris.txt 1
fingers	Miserables.txt 41, NotreDame_De_Paris.txt 15
finical	Miserables.txt 1
finis	Miserables.txt 2
finish	Miserables.txt 19, NotreDame_De_Paris.txt 10
finished	Miserables.txt 62, NotreDame_De_Paris.txt 19
finishes	NotreDame_De_Paris.txt 1, Miserables.txt 1
finishing	Miserables.txt 8
finistere	Miserables.txt 1
finite	Miserables.txt 3
finnicky	Miserables.txt 1
fioriture	NotreDame_De_Paris.txt 1
fiques	Miserables.txt 1
fir	Miserables.txt 1
fire	Miserables.txt 179, NotreDame_De_Paris.txt 85
firebrand	Miserables.txt 4, NotreDame_De_Paris.txt 2
fired	Miserables.txt 24, NotreDame_De_Paris.txt 1
firedogs	Miserables.txt 1
firelight	Miserables.txt 3
fireman	Miserables.txt 3
firemen	Miserables.txt 3
fireplace	Miserables.txt 30
fires	Miserables.txt 8, NotreDame_De_Paris.txt 5
fireside	Miserables.txt 4
firewood	NotreDame_De_Paris.txt 2
firework	NotreDame_De_Paris.txt 1
fireworks	Miserables.txt 3, NotreDame_De_Paris.txt 1
firing	Miserables.txt 25
firm	Miserables.txt 38, NotreDame_De_Paris.txt 9
firma	Miserables.txt 1
firmament	Miserables.txt 5
firmer	Miserables.txt 1
firmest	Miserables.txt 1
firmly	Miserables.txt 13, NotreDame_De_Paris.txt 3
firmness	Miserables.txt 8, NotreDame_De_Paris.txt 2
first	Miserables.txt 582, NotreDame_De_Paris.txt 185
firstly	Miserables.txt 2
fish	Miserables.txt 14, NotreDame_De_Paris.txt 5
fisher	Miserables.txt 1
fisherman	Miserables.txt 2
fishermen	Miserables.txt 1
fishes	NotreDame_De_Paris.txt 3, Miserables.txt 3
fishing	Miserables.txt 1
fishmarket	Miserables.txt 1
fishmarkets	Miserables.txt 1
fishmonger	Miserables.txt 3
fishponds	NotreDame_De_Paris.txt 2
fishwife	Miserables.txt 5, NotreDame_De_Paris.txt 1
fishwives	Miserables.txt 1
fishwoman	Miserables.txt 1
fishwomen	Miserables.txt 1
fissure	Miserables.txt 3
fissures	Miserables.txt 3, NotreDame_De_Paris.txt 2
fist	Miserables.txt 43, NotreDame_De_Paris.txt 6
fistfuls	Miserables.txt 2
fists	Miserables.txt 21, NotreDame_De_Paris.txt 12
fit	Miserables.txt 32, NotreDame_De_Paris.txt 8
fitness	NotreDame_De_Paris.txt 1, Miserables.txt 1
fits	Miserables.txt 11, NotreDame_De_Paris.txt 1
fitted	NotreDame_De_Paris.txt 6, Miserables.txt 6
fitting	Miserables.txt 8, NotreDame_De_Paris.txt 3
fitz	Miserables.txt 1
five	Miserables.txt 285, NotreDame_De_Paris.txt 35
fix	Miserables.txt 11, NotreDame_De_Paris.txt 3
fixation	Miserables.txt 1
fixed	Miserables.txt 78, NotreDame_De_Paris.txt 38
fixedly	Miserables.txt 11, NotreDame_De_Paris.txt 4
fixes	Miserables.txt 2
fixing	Miserables.txt 6, NotreDame_De_Paris.txt 4
fixings	Miserables.txt 1
fixity	Miserables.txt 3
fl	NotreDame_De_Paris.txt 1
flabbily	NotreDame_De_Paris.txt 1
flabby	Miserables.txt 2
flaccid	Miserables.txt 1
flaccus	Miserables.txt 1
flachot	Miserables.txt 1
flag	Miserables.txt 54
flagellate	NotreDame_De_Paris.txt 1
flagged	Miserables.txt 4
flagging	NotreDame_De_Paris.txt 2
flagon	NotreDame_De_Paris.txt 2
flagrant	Miserables.txt 4
flags	Miserables.txt 6
flagstone	NotreDame_De_Paris.txt 1, Miserables.txt 1
flagstones	Miserables.txt 3, NotreDame_De_Paris.txt 2
flake	Miserables.txt 2
flakes	Miserables.txt 3, NotreDame_De_Paris.txt 1
flambeaux	NotreDame_De_Paris.txt 1
flame	Miserables.txt 34, NotreDame_De_Paris.txt 22
flamed	Miserables.txt 5, NotreDame_De_Paris.txt 2
flamel	NotreDame_De_Paris.txt 15
flames	Miserables.txt 9, NotreDame_De_Paris.txt 6
flaming	Miserables.txt 12, NotreDame_De_Paris.txt 9
flaminius	Miserables.txt 1
flamma	NotreDame_De_Paris.txt 1
flanders	NotreDame_De_Paris.txt 16, Miserables.txt 3
flank	Miserables.txt 7, NotreDame_De_Paris.txt 1
flanked	Miserables.txt 7, NotreDame_De_Paris.txt 6
flanks	NotreDame_De_Paris.txt 3
flannel	Miserables.txt 1
flapped	Miserables.txt 1
flaps	Miserables.txt 1
flare	Miserables.txt 1
flaring	NotreDame_De_Paris.txt 2, Miserables.txt 1
flash	Miserables.txt 42, NotreDame_De_Paris.txt 18
flashed	NotreDame_De_Paris.txt 11, Miserables.txt 9
flashes	Miserables.txt 17, NotreDame_De_Paris.txt 2
flashing	NotreDame_De_Paris.txt 6, Miserables.txt 4
flask	Miserables.txt 3
flasks	NotreDame_De_Paris.txt 1, Miserables.txt 1
flat	Miserables.txt 39, NotreDame_De_Paris.txt 10
flatness	Miserables.txt 1
flats	Miserables.txt 1
flattened	NotreDame_De_Paris.txt 5, Miserables.txt 4
flatter	Miserables.txt 2
flattered	Miserables.txt 5, NotreDame_De_Paris.txt 2
flattering	NotreDame_De_Paris.txt 1
flatters	Miserables.txt 3
flaunted	Miserables.txt 2
flavius	Miserables.txt 1
flavor	Miserables.txt 4
flaw	Miserables.txt 1
flax	Miserables.txt 2, NotreDame_De_Paris.txt 1
flay	NotreDame_De_Paris.txt 1
flayed	NotreDame_De_Paris.txt 2, Miserables.txt 2
flayer	NotreDame_De_Paris.txt 1
flea	Miserables.txt 1
fleas	NotreDame_De_Paris.txt 2, Miserables.txt 1
flebit	Miserables.txt 1
fled	Miserables.txt 37, NotreDame_De_Paris.txt 19
flee	Miserables.txt 22, NotreDame_De_Paris.txt 11
fleece	NotreDame_De_Paris.txt 3, Miserables.txt 2
fleecy	NotreDame_De_Paris.txt 1
fleeing	Miserables.txt 10, NotreDame_De_Paris.txt 2
flees	Miserables.txt 2
fleet	Miserables.txt 6
fleets	Miserables.txt 1
fleming	Miserables.txt 11, NotreDame_De_Paris.txt 1
flemings	NotreDame_De_Paris.txt 18, Miserables.txt 1
flemish	NotreDame_De_Paris.txt 27, Miserables.txt 1
flesh	Miserables.txt 40, NotreDame_De_Paris.txt 18
fleshless	NotreDame_De_Paris.txt 5, Miserables.txt 1
fleur	NotreDame_De_Paris.txt 62, Miserables.txt 9
fleuries	NotreDame_De_Paris.txt 1
fleurs	Miserables.txt 9, NotreDame_De_Paris.txt 6
fleurus	Miserables.txt 1
fleury	Miserables.txt 2
flew	Miserables.txt 16, NotreDame_De_Paris.txt 7
flicked	Miserables.txt 1
flicker	Miserables.txt 2
flickered	NotreDame_De_Paris.txt 3, Miserables.txt 1
flickering	Miserables.txt 4, NotreDame_De_Paris.txt 3
flickerings	Miserables.txt 2
flies	Miserables.txt 13, NotreDame_De_Paris.txt 7
flight	Miserables.txt 63, NotreDame_De_Paris.txt 16
flights	Miserables.txt 2
flinch	Miserables.txt 3
flinched	Miserables.txt 2
flinching	Miserables.txt 3
fling	Miserables.txt 14, NotreDame_De_Paris.txt 13
flinging	NotreDame_De_Paris.txt 5, Miserables.txt 5
flings	Miserables.txt 15
flint	Miserables.txt 1
flints	Miserables.txt 1
flippant	Miserables.txt 1
flit	Miserables.txt 2, NotreDame_De_Paris.txt 1
flits	Miserables.txt 1
flitted	NotreDame_De_Paris.txt 3, Miserables.txt 2
flitting	Miserables.txt 2
float	Miserables.txt 6, NotreDame_De_Paris.txt 2
floated	Miserables.txt 11, NotreDame_De_Paris.txt 2
floating	Miserables.txt 16, NotreDame_De_Paris.txt 7
floats	Miserables.txt 6, NotreDame_De_Paris.txt 2
flock	Miserables.txt 8, NotreDame_De_Paris.txt 3
flocked	Miserables.txt 2
flocks	NotreDame_De_Paris.txt 2, Miserables.txt 2
flog	NotreDame_De_Paris.txt 1
flogged	NotreDame_De_Paris.txt 1, Miserables.txt 1
flogging	Miserables.txt 1
flood	Miserables.txt 10, NotreDame_De_Paris.txt 8
flooded	Miserables.txt 2, NotreDame_De_Paris.txt 1
flooding	Miserables.txt 1
floods	NotreDame_De_Paris.txt 5, Miserables.txt 3
floor	Miserables.txt 118, NotreDame_De_Paris.txt 30
flooring	Miserables.txt 5
floors	Miserables.txt 2
flora	Miserables.txt 10
floral	Miserables.txt 1
floreal	Miserables.txt 3
florence	Miserables.txt 2
florentin	Miserables.txt 2
florentine	NotreDame_De_Paris.txt 1, Miserables.txt 1
florian	NotreDame_De_Paris.txt 14, Miserables.txt 1
florid	Miserables.txt 1
florilegium	Miserables.txt 1
florin	NotreDame_De_Paris.txt 1
florists	Miserables.txt 2
floss	Miserables.txt 1
flotilla	Miserables.txt 1
flots	Miserables.txt 1
flounce	NotreDame_De_Paris.txt 1
floundered	NotreDame_De_Paris.txt 1
floundering	Miserables.txt 2
flour	Miserables.txt 3
flourish	Miserables.txt 3, NotreDame_De_Paris.txt 1
flourished	Miserables.txt 3
flourishing	Miserables.txt 4
flow	Miserables.txt 8, NotreDame_De_Paris.txt 4
flowed	Miserables.txt 14, NotreDame_De_Paris.txt 5
flower	Miserables.txt 35, NotreDame_De_Paris.txt 3
flowered	Miserables.txt 2, NotreDame_De_Paris.txt 1
flowers	Miserables.txt 95, NotreDame_De_Paris.txt 13
flowery	Miserables.txt 2
flowing	Miserables.txt 4, NotreDame_De_Paris.txt 3
flows	Miserables.txt 5, NotreDame_De_Paris.txt 1
fluctuations	Miserables.txt 2
fluctus	NotreDame_De_Paris.txt 1
flue	Miserables.txt 10
fluency	Miserables.txt 1
fluently	Miserables.txt 1
fluid	Miserables.txt 2, NotreDame_De_Paris.txt 1
fluidity	Miserables.txt 2
flumem	NotreDame_De_Paris.txt 1
flung	Miserables.txt 60, NotreDame_De_Paris.txt 38
flurried	Miserables.txt 1
flush	Miserables.txt 6, NotreDame_De_Paris.txt 3
flushed	Miserables.txt 2
flute	Miserables.txt 9, NotreDame_De_Paris.txt 2
fluted	NotreDame_De_Paris.txt 1, Miserables.txt 1
flutes	NotreDame_De_Paris.txt 2, Miserables.txt 1
flutings	Miserables.txt 1
flutter	Miserables.txt 6
fluttered	Miserables.txt 7
fluttering	Miserables.txt 7, NotreDame_De_Paris.txt 1
flutterings	Miserables.txt 1
fluvio	NotreDame_De_Paris.txt 1
flux	NotreDame_De_Paris.txt 1
fly	NotreDame_De_Paris.txt 26, Miserables.txt 25
flying	NotreDame_De_Paris.txt 14, Miserables.txt 8
fo	NotreDame_De_Paris.txt 1, Miserables.txt 1
foam	Miserables.txt 10
foamed	NotreDame_De_Paris.txt 2, Miserables.txt 1
foaming	NotreDame_De_Paris.txt 5, Miserables.txt 3
fob	Miserables.txt 9, NotreDame_De_Paris.txt 2
fobs	Miserables.txt 5
focus	Miserables.txt 1
focused	Miserables.txt 1
fodder	Miserables.txt 1
fodit	Miserables.txt 1
foe	Miserables.txt 1
foetus	Miserables.txt 3
fog	Miserables.txt 11, NotreDame_De_Paris.txt 4
foggy	Miserables.txt 1
fogs	Miserables.txt 2
foh	NotreDame_De_Paris.txt 1
foi	NotreDame_De_Paris.txt 1
foil	Miserables.txt 1
foiled	Miserables.txt 1
foils	Miserables.txt 3
foin	NotreDame_De_Paris.txt 3
fois	Miserables.txt 1
foix	NotreDame_De_Paris.txt 1, Miserables.txt 1
folard	Miserables.txt 2
fold	Miserables.txt 19, NotreDame_De_Paris.txt 3
folded	Miserables.txt 46, NotreDame_De_Paris.txt 6
folder	Miserables.txt 1
folding	Miserables.txt 11
folds	Miserables.txt 24, NotreDame_De_Paris.txt 5
foliage	NotreDame_De_Paris.txt 8, Miserables.txt 6
folie	Miserables.txt 1
foliis	Miserables.txt 2
folio	Miserables.txt 3, NotreDame_De_Paris.txt 2
folios	Miserables.txt 3
folk	NotreDame_De_Paris.txt 1
folks	Miserables.txt 19, NotreDame_De_Paris.txt 1
folle	NotreDame_De_Paris.txt 3
follies	Miserables.txt 9, NotreDame_De_Paris.txt 2
follow	Miserables.txt 53, NotreDame_De_Paris.txt 27
followed	Miserables.txt 106, NotreDame_De_Paris.txt 49
follower	NotreDame_De_Paris.txt 1
followers	NotreDame_De_Paris.txt 1
following	Miserables.txt 149, NotreDame_De_Paris.txt 24
follows	Miserables.txt 23, NotreDame_De_Paris.txt 3
folly	Miserables.txt 16, NotreDame_De_Paris.txt 9
fomentations	Miserables.txt 1
fond	Miserables.txt 34, NotreDame_De_Paris.txt 6
fondest	Miserables.txt 1
fondled	NotreDame_De_Paris.txt 1
fondling	NotreDame_De_Paris.txt 2
fondly	Miserables.txt 1
fonfrede	Miserables.txt 1
font	NotreDame_De_Paris.txt 3
fontaine	Miserables.txt 3, NotreDame_De_Paris.txt 2
fontainebleau	Miserables.txt 5
fontaines	Miserables.txt 2
fontenoy	Miserables.txt 2
fontevrault	Miserables.txt 3
fontis	Miserables.txt 12
food	Miserables.txt 21, NotreDame_De_Paris.txt 2
fool	Miserables.txt 22, NotreDame_De_Paris.txt 11
foolish	Miserables.txt 16, NotreDame_De_Paris.txt 8
foolishly	Miserables.txt 2
fools	NotreDame_De_Paris.txt 30, Miserables.txt 5
foot	Miserables.txt 139, NotreDame_De_Paris.txt 80
footed	Miserables.txt 4, NotreDame_De_Paris.txt 2
foothold	NotreDame_De_Paris.txt 1, Miserables.txt 1
footing	Miserables.txt 6
footnote	Miserables.txt 70
footnotes	Miserables.txt 1
footpad	NotreDame_De_Paris.txt 1
footprints	Miserables.txt 1
footrope	Miserables.txt 1
footstep	Miserables.txt 4, NotreDame_De_Paris.txt 1
footsteps	Miserables.txt 15
foppish	Miserables.txt 1
for	Miserables.txt 2987, NotreDame_De_Paris.txt 952
forbade	Miserables.txt 3, NotreDame_De_Paris.txt 2
forbid	Miserables.txt 4
forbidden	Miserables.txt 8, NotreDame_De_Paris.txt 3
forbidding	NotreDame_De_Paris.txt 1
forcalquier	Miserables.txt 1
force	Miserables.txt 129, NotreDame_De_Paris.txt 28
forced	Miserables.txt 73, NotreDame_De_Paris.txt 20
forceps	NotreDame_De_Paris.txt 1
forces	Miserables.txt 17, NotreDame_De_Paris.txt 5
forcibly	NotreDame_De_Paris.txt 3, Miserables.txt 1
forcing	NotreDame_De_Paris.txt 3, Miserables.txt 3
fore	Miserables.txt 8, NotreDame_De_Paris.txt 3
forearm	Miserables.txt 1
foreboding	Miserables.txt 1
forefinger	Miserables.txt 6, NotreDame_De_Paris.txt 2
forefingers	Miserables.txt 2
forego	Miserables.txt 1
foreground	Miserables.txt 1
forehead	Miserables.txt 11, NotreDame_De_Paris.txt 4
foreheads	NotreDame_De_Paris.txt 1, Miserables.txt 1
foreign	Miserables.txt 8, NotreDame_De_Paris.txt 2
foreigner	Miserables.txt 2
forelegs	Miserables.txt 2
foremost	NotreDame_De_Paris.txt 2, Miserables.txt 1
forepaws	NotreDame_De_Paris.txt 1
foresaw	Miserables.txt 1
foresee	Miserables.txt 3
foreseeing	Miserables.txt 4, NotreDame_De_Paris.txt 1
foreseen	Miserables.txt 7, NotreDame_De_Paris.txt 2
foreshortening	Miserables.txt 1
foresight	Miserables.txt 6
forest	Miserables.txt 84, NotreDame_De_Paris.txt 9
forestall	Miserables.txt 1
forestalled	Miserables.txt 2
forests	Miserables.txt 10, NotreDame_De_Paris.txt 4
foret	Miserables.txt 2
foretaste	Miserables.txt 1
foretold	NotreDame_De_Paris.txt 1
foretop	Miserables.txt 1
forever	Miserables.txt 43, NotreDame_De_Paris.txt 10
forevermore	Miserables.txt 1
forfeiture	Miserables.txt 1
forge	Miserables.txt 6, NotreDame_De_Paris.txt 3
forged	Miserables.txt 2
forger	Miserables.txt 1
forgery	Miserables.txt 1
forges	Miserables.txt 1
forget	Miserables.txt 30, NotreDame_De_Paris.txt 8
forgetful	Miserables.txt 8
forgetfulness	Miserables.txt 12, NotreDame_De_Paris.txt 2
forgets	Miserables.txt 6
forgetting	NotreDame_De_Paris.txt 6, Miserables.txt 6
forgive	Miserables.txt 3, NotreDame_De_Paris.txt 2
forgiven	Miserables.txt 2
forgiveness	Miserables.txt 2
forgiving	Miserables.txt 1
forgot	Miserables.txt 19, NotreDame_De_Paris.txt 5
forgotten	Miserables.txt 51, NotreDame_De_Paris.txt 21
forioso	Miserables.txt 2
forismaritagium	NotreDame_De_Paris.txt 1
fork	Miserables.txt 7, NotreDame_De_Paris.txt 1
forked	NotreDame_De_Paris.txt 1, Miserables.txt 1
forks	Miserables.txt 13, NotreDame_De_Paris.txt 1
forlorn	Miserables.txt 1
form	Miserables.txt 146, NotreDame_De_Paris.txt 75
formal	NotreDame_De_Paris.txt 2, Miserables.txt 1
formalities	Miserables.txt 1
formality	Miserables.txt 2
format	NotreDame_De_Paris.txt 4, Miserables.txt 4
formation	Miserables.txt 17, NotreDame_De_Paris.txt 3
formations	NotreDame_De_Paris.txt 2, Miserables.txt 1
formats	NotreDame_De_Paris.txt 2, Miserables.txt 2
formed	Miserables.txt 120, NotreDame_De_Paris.txt 45
former	Miserables.txt 50, NotreDame_De_Paris.txt 7
formerly	Miserables.txt 54, NotreDame_De_Paris.txt 11
formic	Miserables.txt 1
formidable	Miserables.txt 85, NotreDame_De_Paris.txt 30
formidably	Miserables.txt 1
forming	Miserables.txt 13, NotreDame_De_Paris.txt 4
formless	Miserables.txt 2, NotreDame_De_Paris.txt 1
formoe	NotreDame_De_Paris.txt 1
forms	Miserables.txt 75, NotreDame_De_Paris.txt 18
formula	Miserables.txt 5, NotreDame_De_Paris.txt 3
formulas	NotreDame_De_Paris.txt 1, Miserables.txt 1
formulate	NotreDame_De_Paris.txt 1
formulated	NotreDame_De_Paris.txt 2
fornication	NotreDame_De_Paris.txt 1
forsooth	Miserables.txt 1
fort	Miserables.txt 2
forte	NotreDame_De_Paris.txt 1
fortescue	NotreDame_De_Paris.txt 1
forth	Miserables.txt 154, NotreDame_De_Paris.txt 65
forties	Miserables.txt 1
fortieth	NotreDame_De_Paris.txt 1
fortification	NotreDame_De_Paris.txt 1
fortifications	NotreDame_De_Paris.txt 2
fortified	NotreDame_De_Paris.txt 3, Miserables.txt 2
fortify	Miserables.txt 3
fortnight	Miserables.txt 8, NotreDame_De_Paris.txt 2
fortress	Miserables.txt 11, NotreDame_De_Paris.txt 8
fortresses	NotreDame_De_Paris.txt 3, Miserables.txt 3
forts	Miserables.txt 1
fortunata	Miserables.txt 1
fortunate	Miserables.txt 7, NotreDame_De_Paris.txt 3
fortunately	Miserables.txt 13, NotreDame_De_Paris.txt 8
fortunatus	Miserables.txt 1
fortune	Miserables.txt 56, NotreDame_De_Paris.txt 5
fortunes	Miserables.txt 6, NotreDame_De_Paris.txt 3
forty	Miserables.txt 91, NotreDame_De_Paris.txt 16
forward	Miserables.txt 44, NotreDame_De_Paris.txt 5
forwarded	Miserables.txt 4
forwards	Miserables.txt 8
fossa	Miserables.txt 1
fosse	Miserables.txt 3
fosseaux	Miserables.txt 1
fossil	Miserables.txt 1
fossils	Miserables.txt 1
foster	Miserables.txt 2, NotreDame_De_Paris.txt 1
fouarre	NotreDame_De_Paris.txt 1
fouche	Miserables.txt 2
foudre	Miserables.txt 2
fougere	Miserables.txt 2
fought	Miserables.txt 19, NotreDame_De_Paris.txt 2
fouillou	Miserables.txt 1
foul	Miserables.txt 5, NotreDame_De_Paris.txt 1
foulness	Miserables.txt 2
foultitude	Miserables.txt 1
found	Miserables.txt 280, NotreDame_De_Paris.txt 86
foundation	Miserables.txt 58, NotreDame_De_Paris.txt 32
foundations	NotreDame_De_Paris.txt 2, Miserables.txt 1
founded	Miserables.txt 10, NotreDame_De_Paris.txt 3
founder	Miserables.txt 3
foundered	Miserables.txt 1
founders	Miserables.txt 1
founding	Miserables.txt 2, NotreDame_De_Paris.txt 1
foundling	NotreDame_De_Paris.txt 9, Miserables.txt 1
foundlings	NotreDame_De_Paris.txt 5, Miserables.txt 2
foundries	NotreDame_De_Paris.txt 1, Miserables.txt 1
fountain	Miserables.txt 17, NotreDame_De_Paris.txt 4
fountains	NotreDame_De_Paris.txt 1, Miserables.txt 1
fouquier	Miserables.txt 1
four	Miserables.txt 378, NotreDame_De_Paris.txt 107
fourbault	NotreDame_De_Paris.txt 4
fourcroy	Miserables.txt 1
fourier	Miserables.txt 4
fouriers	Miserables.txt 2
fourrata	NotreDame_De_Paris.txt 1
fourratis	NotreDame_De_Paris.txt 1
fours	Miserables.txt 5, NotreDame_De_Paris.txt 4
fourteen	Miserables.txt 17, NotreDame_De_Paris.txt 8
fourteenth	Miserables.txt 5, NotreDame_De_Paris.txt 3
fourth	Miserables.txt 39, NotreDame_De_Paris.txt 8
fourthly	Miserables.txt 2
fourths	Miserables.txt 1
fowl	NotreDame_De_Paris.txt 2
fox	NotreDame_De_Paris.txt 5, Miserables.txt 4
foxes	Miserables.txt 2
foxtail	Miserables.txt 1
foy	Miserables.txt 8
fr	NotreDame_De_Paris.txt 2
fraction	Miserables.txt 3
fractions	Miserables.txt 1
fracture	NotreDame_De_Paris.txt 1, Miserables.txt 1
fractured	Miserables.txt 3
fractures	NotreDame_De_Paris.txt 2, Miserables.txt 2
fragile	NotreDame_De_Paris.txt 6, Miserables.txt 6
fragment	Miserables.txt 19, NotreDame_De_Paris.txt 4
fragmentary	Miserables.txt 2
fragments	NotreDame_De_Paris.txt 8, Miserables.txt 6
fragrant	Miserables.txt 5
frail	NotreDame_De_Paris.txt 13, Miserables.txt 9
frais	Miserables.txt 2
frame	Miserables.txt 17, NotreDame_De_Paris.txt 9
framed	NotreDame_De_Paris.txt 3, Miserables.txt 3
frames	Miserables.txt 4, NotreDame_De_Paris.txt 1
framework	NotreDame_De_Paris.txt 4, Miserables.txt 4
fran	NotreDame_De_Paris.txt 5
franc	Miserables.txt 27, NotreDame_De_Paris.txt 1
francais	Miserables.txt 4
france	Miserables.txt 174, NotreDame_De_Paris.txt 47
franche	NotreDame_De_Paris.txt 1, Miserables.txt 1
franchises	NotreDame_De_Paris.txt 1
franciae	NotreDame_De_Paris.txt 1
francis	Miserables.txt 1
franciscan	NotreDame_De_Paris.txt 1
franciscans	Miserables.txt 1
francois	Miserables.txt 14, NotreDame_De_Paris.txt 1
francoise	Miserables.txt 1
franconi	Miserables.txt 1
francs	Miserables.txt 286, NotreDame_De_Paris.txt 1
frangere	Miserables.txt 1
frangir	Miserables.txt 1
frank	Miserables.txt 3, NotreDame_De_Paris.txt 1
frankly	Miserables.txt 4, NotreDame_De_Paris.txt 2
frankness	NotreDame_De_Paris.txt 2, Miserables.txt 1
frantic	NotreDame_De_Paris.txt 3, Miserables.txt 1
frantically	Miserables.txt 2, NotreDame_De_Paris.txt 1
frasnes	Miserables.txt 1
fraternal	Miserables.txt 3, NotreDame_De_Paris.txt 2
fraternally	NotreDame_De_Paris.txt 1, Miserables.txt 1
fraternity	Miserables.txt 14, NotreDame_De_Paris.txt 2
fraternization	Miserables.txt 2
fraternize	Miserables.txt 3
fraternized	Miserables.txt 4
fraternizes	Miserables.txt 2
fraud	Miserables.txt 2
fraught	Miserables.txt 4, NotreDame_De_Paris.txt 1
fray	Miserables.txt 8
frayed	Miserables.txt 2
frayssinous	Miserables.txt 1
freak	NotreDame_De_Paris.txt 4, Miserables.txt 2
freaks	Miserables.txt 6
freckled	Miserables.txt 1
freckles	Miserables.txt 2
frederic	Miserables.txt 1
frederick	Miserables.txt 4
free	Miserables.txt 73, NotreDame_De_Paris.txt 21
freed	Miserables.txt 7
freedom	Miserables.txt 6, NotreDame_De_Paris.txt 1
freeholder	Miserables.txt 1
freeholds	Miserables.txt 1
freely	Miserables.txt 17, NotreDame_De_Paris.txt 8
freewill	NotreDame_De_Paris.txt 1
freeze	Miserables.txt 2
freezes	Miserables.txt 1
freezing	Miserables.txt 6, NotreDame_De_Paris.txt 2
freight	Miserables.txt 1
freighted	Miserables.txt 1
freiras	Miserables.txt 1
french	Miserables.txt 110, NotreDame_De_Paris.txt 9
frenchman	NotreDame_De_Paris.txt 3, Miserables.txt 3
frenchmen	Miserables.txt 5
frenzied	Miserables.txt 4
frenzy	Miserables.txt 4, NotreDame_De_Paris.txt 3
frequency	Miserables.txt 2
frequent	NotreDame_De_Paris.txt 7, Miserables.txt 6
frequented	Miserables.txt 6, NotreDame_De_Paris.txt 3
frequenter	Miserables.txt 2
frequenters	Miserables.txt 1
frequently	Miserables.txt 17, NotreDame_De_Paris.txt 7
frescoes	Miserables.txt 1
fresh	Miserables.txt 67, NotreDame_De_Paris.txt 32
fresher	Miserables.txt 2
freshly	Miserables.txt 6
freshness	Miserables.txt 3, NotreDame_De_Paris.txt 1
fretted	NotreDame_De_Paris.txt 3, Miserables.txt 1
frevent	Miserables.txt 1
friability	Miserables.txt 1
friable	Miserables.txt 2
friant	Miserables.txt 1
friar	NotreDame_De_Paris.txt 2
friars	Miserables.txt 1
fricot	Miserables.txt 1
friction	Miserables.txt 3, NotreDame_De_Paris.txt 2
friday	Miserables.txt 4, NotreDame_De_Paris.txt 1
fridays	Miserables.txt 1
fried	Miserables.txt 1
friedland	Miserables.txt 4
friend	Miserables.txt 52, NotreDame_De_Paris.txt 43
friendly	Miserables.txt 6, NotreDame_De_Paris.txt 1
friends	Miserables.txt 86, NotreDame_De_Paris.txt 25
friendship	Miserables.txt 4, NotreDame_De_Paris.txt 3
friendships	Miserables.txt 2
frieze	NotreDame_De_Paris.txt 1
frigate	Miserables.txt 2
frigates	Miserables.txt 1
fright	Miserables.txt 11, NotreDame_De_Paris.txt 10
frighten	Miserables.txt 5, NotreDame_De_Paris.txt 2
frightened	Miserables.txt 36, NotreDame_De_Paris.txt 21
frightening	Miserables.txt 2
frightens	NotreDame_De_Paris.txt 1, Miserables.txt 1
frightful	Miserables.txt 89, NotreDame_De_Paris.txt 32
frightfully	Miserables.txt 7, NotreDame_De_Paris.txt 1
frights	Miserables.txt 2
frigid	Miserables.txt 1
frills	Miserables.txt 1
fringe	NotreDame_De_Paris.txt 1, Miserables.txt 1
fringes	NotreDame_De_Paris.txt 3
fripon	Miserables.txt 1
fripperies	Miserables.txt 2
fririon	Miserables.txt 1
frischemont	Miserables.txt 6
frisking	NotreDame_De_Paris.txt 1
frisky	NotreDame_De_Paris.txt 1
fritters	Miserables.txt 1
frivolities	Miserables.txt 1
frivolous	Miserables.txt 4
frizzed	Miserables.txt 2
fro	Miserables.txt 7, NotreDame_De_Paris.txt 4
frock	Miserables.txt 13, NotreDame_De_Paris.txt 1
frocks	Miserables.txt 1
frog	NotreDame_De_Paris.txt 2, Miserables.txt 2
frogs	Miserables.txt 3, NotreDame_De_Paris.txt 1
froid	Miserables.txt 1
froidmanteau	Miserables.txt 1
frolicked	Miserables.txt 1
frolicsome	NotreDame_De_Paris.txt 1, Miserables.txt 1
frollo	NotreDame_De_Paris.txt 60
from	Miserables.txt 2455, NotreDame_De_Paris.txt 900
fromage	Miserables.txt 1
frondibus	Miserables.txt 2
front	Miserables.txt 176, NotreDame_De_Paris.txt 69
frontage	Miserables.txt 1
fronted	Miserables.txt 1
frontier	Miserables.txt 10
frontiers	Miserables.txt 6
frontispiece	Miserables.txt 8, NotreDame_De_Paris.txt 1
frontispieces	NotreDame_De_Paris.txt 1
frontpapers	Miserables.txt 2
fronts	Miserables.txt 11, NotreDame_De_Paris.txt 2
frost	Miserables.txt 4
froth	Miserables.txt 3
frothed	NotreDame_De_Paris.txt 2
frothing	NotreDame_De_Paris.txt 1
froths	Miserables.txt 1
frown	Miserables.txt 5, NotreDame_De_Paris.txt 3
frowned	NotreDame_De_Paris.txt 5, Miserables.txt 4
frowns	Miserables.txt 1
froze	NotreDame_De_Paris.txt 3, Miserables.txt 1
frozen	NotreDame_De_Paris.txt 6, Miserables.txt 3
frugal	Miserables.txt 1
frugality	Miserables.txt 1
fruit	Miserables.txt 21, NotreDame_De_Paris.txt 6
fruiterer	Miserables.txt 3
fruitful	Miserables.txt 2
fruitieres	Miserables.txt 3
fruitless	NotreDame_De_Paris.txt 1
fruitlessness	Miserables.txt 1
fruits	Miserables.txt 4
frusques	Miserables.txt 1
fry	Miserables.txt 1
frying	NotreDame_De_Paris.txt 4
fualdes	Miserables.txt 2
fugitive	Miserables.txt 8
fugitives	Miserables.txt 8, NotreDame_De_Paris.txt 1
fuit	NotreDame_De_Paris.txt 1
fulfil	Miserables.txt 4, NotreDame_De_Paris.txt 2
fulfilled	Miserables.txt 7, NotreDame_De_Paris.txt 2
fulfilling	Miserables.txt 2, NotreDame_De_Paris.txt 1
fulfilment	Miserables.txt 1
fulfils	NotreDame_De_Paris.txt 1, Miserables.txt 1
fulgurating	Miserables.txt 1
full	Miserables.txt 235, NotreDame_De_Paris.txt 78
fuller	Miserables.txt 1
fullest	Miserables.txt 1
fully	Miserables.txt 25, NotreDame_De_Paris.txt 4
fulminating	Miserables.txt 1
fulminatrix	Miserables.txt 1
fulness	Miserables.txt 1
fultitude	Miserables.txt 1
fumade	Miserables.txt 2
fumble	Miserables.txt 2, NotreDame_De_Paris.txt 1
fumbled	Miserables.txt 18
fumbles	Miserables.txt 1
fumbling	Miserables.txt 7, NotreDame_De_Paris.txt 2
fumblingly	Miserables.txt 1
fumes	Miserables.txt 2
fun	Miserables.txt 3, NotreDame_De_Paris.txt 1
function	Miserables.txt 10
functionaries	Miserables.txt 3
functionary	Miserables.txt 4
functions	Miserables.txt 8
fund	Miserables.txt 6
fundamental	Miserables.txt 1
fundamentally	Miserables.txt 1
fundraising	NotreDame_De_Paris.txt 1, Miserables.txt 1
funds	Miserables.txt 5, NotreDame_De_Paris.txt 2
funeral	Miserables.txt 17, NotreDame_De_Paris.txt 1
funerals	Miserables.txt 3, NotreDame_De_Paris.txt 1
funereal	Miserables.txt 19, NotreDame_De_Paris.txt 3
fungi	Miserables.txt 2, NotreDame_De_Paris.txt 1
funnel	Miserables.txt 2
funnels	NotreDame_De_Paris.txt 1, Miserables.txt 1
fur	NotreDame_De_Paris.txt 2, Miserables.txt 1
furbelows	Miserables.txt 1
furies	Miserables.txt 5
furious	Miserables.txt 33, NotreDame_De_Paris.txt 19
furiously	Miserables.txt 9, NotreDame_De_Paris.txt 4
furnace	NotreDame_De_Paris.txt 21, Miserables.txt 14
furnaces	Miserables.txt 2
furnish	Miserables.txt 10, NotreDame_De_Paris.txt 2
furnished	Miserables.txt 42, NotreDame_De_Paris.txt 3
furnishes	Miserables.txt 4, NotreDame_De_Paris.txt 2
furnishing	Miserables.txt 4
furniture	Miserables.txt 39, NotreDame_De_Paris.txt 2
furred	NotreDame_De_Paris.txt 7
furrier	NotreDame_De_Paris.txt 4
furrow	Miserables.txt 3, NotreDame_De_Paris.txt 2
furrowed	NotreDame_De_Paris.txt 4, Miserables.txt 1
furrows	Miserables.txt 5
furs	NotreDame_De_Paris.txt 1
further	Miserables.txt 89, NotreDame_De_Paris.txt 15
furthermore	NotreDame_De_Paris.txt 1
furthest	Miserables.txt 2
furtive	Miserables.txt 4, NotreDame_De_Paris.txt 2
furtively	NotreDame_De_Paris.txt 2, Miserables.txt 2
furto	Miserables.txt 1
fury	Miserables.txt 25, NotreDame_De_Paris.txt 21
fuscus	Miserables.txt 1
fuse	NotreDame_De_Paris.txt 1, Miserables.txt 1
fused	Miserables.txt 1
fusillade	Miserables.txt 14
fusillades	Miserables.txt 2
fusion	Miserables.txt 4
fustian	NotreDame_De_Paris.txt 2, Miserables.txt 2
fut	Miserables.txt 1
futile	Miserables.txt 1
future	Miserables.txt 98, NotreDame_De_Paris.txt 11
fuyant	Miserables.txt 1
fye	NotreDame_De_Paris.txt 1
