r	Miserables.txt 7, NotreDame_De_Paris.txt 4
ra	NotreDame_De_Paris.txt 1
rabbi	NotreDame_De_Paris.txt 1
rabbinical	Miserables.txt 1
rabbinicum	Miserables.txt 1
rabbit	Miserables.txt 3
rabbits	Miserables.txt 1
rabble	NotreDame_De_Paris.txt 19, Miserables.txt 15
rabelais	Miserables.txt 4, NotreDame_De_Paris.txt 2
rabellais	Miserables.txt 1
rabidness	NotreDame_De_Paris.txt 1
rabine	NotreDame_De_Paris.txt 1
rabouin	Miserables.txt 4
race	Miserables.txt 68, NotreDame_De_Paris.txt 15
racer	NotreDame_De_Paris.txt 1
races	Miserables.txt 7, NotreDame_De_Paris.txt 4
racine	Miserables.txt 5, NotreDame_De_Paris.txt 1
racing	Miserables.txt 2
rack	NotreDame_De_Paris.txt 2, Miserables.txt 1
racket	Miserables.txt 1
racks	NotreDame_De_Paris.txt 1
radcliffe	Miserables.txt 1
radiance	Miserables.txt 37, NotreDame_De_Paris.txt 5
radiances	Miserables.txt 3
radiant	Miserables.txt 36, NotreDame_De_Paris.txt 7
radiantly	NotreDame_De_Paris.txt 1, Miserables.txt 1
radiate	Miserables.txt 1
radiated	Miserables.txt 2
radiating	NotreDame_De_Paris.txt 1, Miserables.txt 1
radiation	Miserables.txt 2
radiations	Miserables.txt 1
radical	NotreDame_De_Paris.txt 1
radin	NotreDame_De_Paris.txt 2
radish	NotreDame_De_Paris.txt 1, Miserables.txt 1
radius	NotreDame_De_Paris.txt 2
radolphus	NotreDame_De_Paris.txt 1
raffermir	Miserables.txt 1
raft	Miserables.txt 3
rafters	Miserables.txt 1
rafts	Miserables.txt 1
rag	Miserables.txt 30, NotreDame_De_Paris.txt 5
rage	Miserables.txt 38, NotreDame_De_Paris.txt 22
raged	NotreDame_De_Paris.txt 1, Miserables.txt 1
rages	NotreDame_De_Paris.txt 1, Miserables.txt 1
ragged	Miserables.txt 14, NotreDame_De_Paris.txt 5
raging	Miserables.txt 9, NotreDame_De_Paris.txt 1
ragpicker	Miserables.txt 1
ragpickers	Miserables.txt 1
rags	Miserables.txt 59, NotreDame_De_Paris.txt 14
raguier	NotreDame_De_Paris.txt 1
raid	Miserables.txt 2
raiding	Miserables.txt 1
railed	Miserables.txt 1
railing	Miserables.txt 10, NotreDame_De_Paris.txt 7
railings	Miserables.txt 1
raille	Miserables.txt 1
railleries	NotreDame_De_Paris.txt 1
raillery	Miserables.txt 3, NotreDame_De_Paris.txt 2
railles	Miserables.txt 1
railroads	Miserables.txt 1
rails	Miserables.txt 2
railway	Miserables.txt 5
rain	Miserables.txt 73, NotreDame_De_Paris.txt 14
rained	Miserables.txt 13, NotreDame_De_Paris.txt 3
raining	Miserables.txt 12
rains	Miserables.txt 13
rainstorm	Miserables.txt 2
rainy	Miserables.txt 2, NotreDame_De_Paris.txt 1
raise	Miserables.txt 29, NotreDame_De_Paris.txt 13
raised	Miserables.txt 159, NotreDame_De_Paris.txt 86
raises	Miserables.txt 3, NotreDame_De_Paris.txt 1
raisin	Miserables.txt 1
raising	Miserables.txt 27, NotreDame_De_Paris.txt 12
raisons	Miserables.txt 1
rakes	NotreDame_De_Paris.txt 1
ralda	NotreDame_De_Paris.txt 1
rallied	Miserables.txt 10, NotreDame_De_Paris.txt 3
rallies	Miserables.txt 1
rally	Miserables.txt 1
rallying	Miserables.txt 5, NotreDame_De_Paris.txt 1
ram	NotreDame_De_Paris.txt 9, Miserables.txt 4
ramble	Miserables.txt 1
rambled	Miserables.txt 1
rambler	Miserables.txt 3
rambouillet	Miserables.txt 1
rambuteau	Miserables.txt 4
rameau	Miserables.txt 1
ramification	Miserables.txt 1
ramifications	Miserables.txt 6, NotreDame_De_Paris.txt 2
ramified	Miserables.txt 1
ramillies	Miserables.txt 1
ramis	Miserables.txt 1
ramonchamp	NotreDame_De_Paris.txt 1
rampart	Miserables.txt 3
ramparts	NotreDame_De_Paris.txt 1
ramponneau	Miserables.txt 1
ramrods	Miserables.txt 1
rams	NotreDame_De_Paris.txt 1
ramshackle	Miserables.txt 2
ramus	Miserables.txt 1
ran	Miserables.txt 80, NotreDame_De_Paris.txt 41
ranch	NotreDame_De_Paris.txt 1
rancid	NotreDame_De_Paris.txt 1, Miserables.txt 1
rancor	Miserables.txt 6, NotreDame_De_Paris.txt 2
rancors	Miserables.txt 1
random	Miserables.txt 20
rang	NotreDame_De_Paris.txt 14, Miserables.txt 13
range	Miserables.txt 6, NotreDame_De_Paris.txt 1
ranged	Miserables.txt 9, NotreDame_De_Paris.txt 8
ranges	Miserables.txt 1
ranging	Miserables.txt 1
rangling	Miserables.txt 1
rank	Miserables.txt 11, NotreDame_De_Paris.txt 2
ranked	Miserables.txt 1
ranks	Miserables.txt 22, NotreDame_De_Paris.txt 7
ransack	NotreDame_De_Paris.txt 1
ransacked	NotreDame_De_Paris.txt 2
ransacking	NotreDame_De_Paris.txt 2, Miserables.txt 2
raoul	Miserables.txt 2
rap	Miserables.txt 1
rape	NotreDame_De_Paris.txt 1
rapee	Miserables.txt 3
raphael	NotreDame_De_Paris.txt 4, Miserables.txt 2
rapid	Miserables.txt 31, NotreDame_De_Paris.txt 7
rapidity	Miserables.txt 4, NotreDame_De_Paris.txt 3
rapidly	Miserables.txt 47, NotreDame_De_Paris.txt 11
rapids	Miserables.txt 1
rapier	NotreDame_De_Paris.txt 1
rapin	Miserables.txt 1
rapine	Miserables.txt 2, NotreDame_De_Paris.txt 1
rapped	Miserables.txt 3
rappelez	Miserables.txt 1
rappelles	Miserables.txt 1
rapture	Miserables.txt 5, NotreDame_De_Paris.txt 4
raptures	NotreDame_De_Paris.txt 2
rapturous	Miserables.txt 2
rarde	NotreDame_De_Paris.txt 2
rare	Miserables.txt 50, NotreDame_De_Paris.txt 20
rarely	Miserables.txt 15, NotreDame_De_Paris.txt 4
rarer	NotreDame_De_Paris.txt 2
rarest	NotreDame_De_Paris.txt 1, Miserables.txt 1
rarity	Miserables.txt 4, NotreDame_De_Paris.txt 1
ras	Miserables.txt 2
rascal	Miserables.txt 20, NotreDame_De_Paris.txt 7
rascalion	Miserables.txt 1
rascalities	Miserables.txt 1
rascality	Miserables.txt 1
rascally	Miserables.txt 3, NotreDame_De_Paris.txt 2
rascals	Miserables.txt 14, NotreDame_De_Paris.txt 4
rash	NotreDame_De_Paris.txt 1
rat	NotreDame_De_Paris.txt 18, Miserables.txt 8
rate	Miserables.txt 9, NotreDame_De_Paris.txt 1
rated	Miserables.txt 1
rates	Miserables.txt 1
rather	Miserables.txt 160, NotreDame_De_Paris.txt 37
ratichon	Miserables.txt 1
ratiocinate	Miserables.txt 1
rational	Miserables.txt 1
ratisbon	Miserables.txt 1
rats	Miserables.txt 12, NotreDame_De_Paris.txt 2
rattan	Miserables.txt 1
rattle	Miserables.txt 17, NotreDame_De_Paris.txt 5
rattled	Miserables.txt 4, NotreDame_De_Paris.txt 2
rattles	Miserables.txt 1
rattling	Miserables.txt 9
rault	NotreDame_De_Paris.txt 1
raux	Miserables.txt 1
ravaged	Miserables.txt 1
ravages	Miserables.txt 5, NotreDame_De_Paris.txt 2
ravaging	Miserables.txt 1
ravaillac	NotreDame_De_Paris.txt 3
raved	NotreDame_De_Paris.txt 1, Miserables.txt 1
raven	NotreDame_De_Paris.txt 3, Miserables.txt 1
ravens	NotreDame_De_Paris.txt 3
ravine	Miserables.txt 10, NotreDame_De_Paris.txt 2
ravined	Miserables.txt 1
ravines	Miserables.txt 2
raving	Miserables.txt 3, NotreDame_De_Paris.txt 1
ravished	Miserables.txt 1
ravishing	Miserables.txt 8, NotreDame_De_Paris.txt 3
ravissait	Miserables.txt 1
ravissants	Miserables.txt 1
raw	Miserables.txt 7
ray	NotreDame_De_Paris.txt 31, Miserables.txt 31
raymond	NotreDame_De_Paris.txt 1
raynal	Miserables.txt 1
rays	Miserables.txt 17, NotreDame_De_Paris.txt 7
razes	Miserables.txt 1
razing	NotreDame_De_Paris.txt 1
razor	Miserables.txt 2
re	Miserables.txt 107, NotreDame_De_Paris.txt 52
reach	Miserables.txt 49, NotreDame_De_Paris.txt 14
reached	Miserables.txt 154, NotreDame_De_Paris.txt 43
reaches	Miserables.txt 10
reaching	Miserables.txt 17, NotreDame_De_Paris.txt 3
react	NotreDame_De_Paris.txt 1
reacted	Miserables.txt 1
reaction	Miserables.txt 6, NotreDame_De_Paris.txt 1
read	Miserables.txt 152, NotreDame_De_Paris.txt 30
readable	NotreDame_De_Paris.txt 2, Miserables.txt 2
reader	Miserables.txt 133, NotreDame_De_Paris.txt 72
readers	NotreDame_De_Paris.txt 12, Miserables.txt 5
readest	Miserables.txt 2
readily	Miserables.txt 9, NotreDame_De_Paris.txt 5
readiness	Miserables.txt 8, NotreDame_De_Paris.txt 2
reading	Miserables.txt 33, NotreDame_De_Paris.txt 15
readjusted	NotreDame_De_Paris.txt 1
reads	NotreDame_De_Paris.txt 2, Miserables.txt 1
ready	Miserables.txt 53, NotreDame_De_Paris.txt 16
reagents	Miserables.txt 1
real	Miserables.txt 73, NotreDame_De_Paris.txt 9
realities	Miserables.txt 22, NotreDame_De_Paris.txt 1
reality	Miserables.txt 45, NotreDame_De_Paris.txt 13
realizations	Miserables.txt 1
realize	Miserables.txt 6
realized	Miserables.txt 13, NotreDame_De_Paris.txt 2
realizes	Miserables.txt 3
realizing	NotreDame_De_Paris.txt 1
really	Miserables.txt 100, NotreDame_De_Paris.txt 21
realm	Miserables.txt 4, NotreDame_De_Paris.txt 1
reanimated	Miserables.txt 3, NotreDame_De_Paris.txt 1
reap	NotreDame_De_Paris.txt 1
reaped	NotreDame_De_Paris.txt 1, Miserables.txt 1
reaping	NotreDame_De_Paris.txt 1
reappear	Miserables.txt 10, NotreDame_De_Paris.txt 2
reappearance	Miserables.txt 2
reappeared	Miserables.txt 11, NotreDame_De_Paris.txt 2
reappears	Miserables.txt 6, NotreDame_De_Paris.txt 1
rear	Miserables.txt 39, NotreDame_De_Paris.txt 7
reared	Miserables.txt 10, NotreDame_De_Paris.txt 6
rearguard	NotreDame_De_Paris.txt 1, Miserables.txt 1
rearing	Miserables.txt 2
rearrangement	NotreDame_De_Paris.txt 1
rears	Miserables.txt 2, NotreDame_De_Paris.txt 1
reascended	NotreDame_De_Paris.txt 1
reason	Miserables.txt 70, NotreDame_De_Paris.txt 22
reasonable	Miserables.txt 6, NotreDame_De_Paris.txt 1
reasoned	Miserables.txt 3
reasoning	Miserables.txt 11, NotreDame_De_Paris.txt 3
reasons	Miserables.txt 32, NotreDame_De_Paris.txt 6
reasserts	Miserables.txt 2
reassume	Miserables.txt 1
reassurance	Miserables.txt 1
reassure	Miserables.txt 1
reassured	Miserables.txt 18, NotreDame_De_Paris.txt 4
reassuring	Miserables.txt 6
reawakening	Miserables.txt 1
rebec	NotreDame_De_Paris.txt 1
rebecs	NotreDame_De_Paris.txt 3
rebel	NotreDame_De_Paris.txt 1
rebellion	Miserables.txt 10, NotreDame_De_Paris.txt 2
rebellions	Miserables.txt 1
rebellious	Miserables.txt 3
rebels	Miserables.txt 1
rebless	Miserables.txt 1
rebound	Miserables.txt 3
rebounded	Miserables.txt 4, NotreDame_De_Paris.txt 1
rebounding	Miserables.txt 1
rebounds	Miserables.txt 1
rebuffed	Miserables.txt 1
rebuild	NotreDame_De_Paris.txt 1, Miserables.txt 1
rebuilding	NotreDame_De_Paris.txt 1
rebuilt	Miserables.txt 1
rebuke	Miserables.txt 1
rebus	Miserables.txt 3, NotreDame_De_Paris.txt 1
rebuses	NotreDame_De_Paris.txt 1, Miserables.txt 1
rebuttoned	Miserables.txt 1
recall	Miserables.txt 29, NotreDame_De_Paris.txt 7
recalled	Miserables.txt 35, NotreDame_De_Paris.txt 17
recalling	Miserables.txt 6, NotreDame_De_Paris.txt 1
recalls	Miserables.txt 6, NotreDame_De_Paris.txt 1
recamier	Miserables.txt 1
recantations	Miserables.txt 1
recapitulate	NotreDame_De_Paris.txt 1
recapitulation	Miserables.txt 1
recapture	Miserables.txt 1
recaptured	Miserables.txt 8, NotreDame_De_Paris.txt 1
recast	NotreDame_De_Paris.txt 1, Miserables.txt 1
receded	Miserables.txt 2
receipt	Miserables.txt 6, NotreDame_De_Paris.txt 2
receipts	Miserables.txt 2
receive	Miserables.txt 43, NotreDame_De_Paris.txt 14
received	Miserables.txt 108, NotreDame_De_Paris.txt 23
receiver	Miserables.txt 1
receivership	NotreDame_De_Paris.txt 2
receives	Miserables.txt 6
receiving	Miserables.txt 9, NotreDame_De_Paris.txt 4
recent	Miserables.txt 6, NotreDame_De_Paris.txt 1
recently	Miserables.txt 21
receptacle	NotreDame_De_Paris.txt 1, Miserables.txt 1
reception	NotreDame_De_Paris.txt 3, Miserables.txt 3
receptions	Miserables.txt 1
recess	Miserables.txt 10
recesses	Miserables.txt 3
recipes	Miserables.txt 1
recipient	NotreDame_De_Paris.txt 1
reciprocal	Miserables.txt 2
reciprocally	Miserables.txt 1
reciprocle	Miserables.txt 1
recital	Miserables.txt 2, NotreDame_De_Paris.txt 1
recite	NotreDame_De_Paris.txt 1, Miserables.txt 1
reckless	Miserables.txt 1
recklessly	NotreDame_De_Paris.txt 1
reckon	Miserables.txt 3, NotreDame_De_Paris.txt 2
reckoned	Miserables.txt 8, NotreDame_De_Paris.txt 2
reckoning	NotreDame_De_Paris.txt 9, Miserables.txt 7
reckons	Miserables.txt 1
reclaim	NotreDame_De_Paris.txt 2, Miserables.txt 1
reclassing	NotreDame_De_Paris.txt 1
reclining	Miserables.txt 3, NotreDame_De_Paris.txt 1
reclosed	Miserables.txt 1
recluse	NotreDame_De_Paris.txt 50
recluses	NotreDame_De_Paris.txt 2, Miserables.txt 2
recognition	Miserables.txt 6, NotreDame_De_Paris.txt 1
recognizable	Miserables.txt 10, NotreDame_De_Paris.txt 4
recognize	Miserables.txt 67, NotreDame_De_Paris.txt 19
recognized	Miserables.txt 101, NotreDame_De_Paris.txt 30
recognizes	Miserables.txt 4
recognizing	Miserables.txt 11, NotreDame_De_Paris.txt 5
recoil	Miserables.txt 6
recoiled	Miserables.txt 24, NotreDame_De_Paris.txt 5
recollect	Miserables.txt 6, NotreDame_De_Paris.txt 1
recollected	Miserables.txt 2
recollection	Miserables.txt 9, NotreDame_De_Paris.txt 2
recollections	Miserables.txt 3
recommence	Miserables.txt 2
recommenced	Miserables.txt 2
recommend	Miserables.txt 3
recommendation	Miserables.txt 5
recommended	Miserables.txt 7, NotreDame_De_Paris.txt 1
recommending	Miserables.txt 1
recommends	Miserables.txt 2
recommitted	Miserables.txt 1
recompense	Miserables.txt 10, NotreDame_De_Paris.txt 1
recompensed	Miserables.txt 3
recomposition	Miserables.txt 1
reconcile	NotreDame_De_Paris.txt 1, Miserables.txt 1
reconciled	Miserables.txt 3, NotreDame_De_Paris.txt 2
reconciliation	Miserables.txt 3, NotreDame_De_Paris.txt 1
reconciling	Miserables.txt 2
reconnaisance	Miserables.txt 1
reconnaissance	Miserables.txt 1
reconnoitre	Miserables.txt 4
reconstitute	Miserables.txt 1
reconstituted	Miserables.txt 1
reconstruct	NotreDame_De_Paris.txt 3, Miserables.txt 1
reconstructed	Miserables.txt 3, NotreDame_De_Paris.txt 1
reconstructing	Miserables.txt 1
reconstruction	Miserables.txt 1
reconstructions	Miserables.txt 2
reconstructs	Miserables.txt 2
record	Miserables.txt 4
recorded	Miserables.txt 2
recording	Miserables.txt 2
records	NotreDame_De_Paris.txt 2, Miserables.txt 2
recount	Miserables.txt 1
recounted	Miserables.txt 1
recourse	Miserables.txt 7
recover	Miserables.txt 10, NotreDame_De_Paris.txt 2
recovered	Miserables.txt 19, NotreDame_De_Paris.txt 8
recovering	Miserables.txt 5, NotreDame_De_Paris.txt 3
recovers	Miserables.txt 2, NotreDame_De_Paris.txt 1
recreation	Miserables.txt 8, NotreDame_De_Paris.txt 2
recreations	NotreDame_De_Paris.txt 1
recrudescence	Miserables.txt 4
recruit	Miserables.txt 3
recruited	Miserables.txt 3, NotreDame_De_Paris.txt 2
recruiting	Miserables.txt 1
recruits	Miserables.txt 7
rectangle	Miserables.txt 1
recteur	NotreDame_De_Paris.txt 3
rectification	Miserables.txt 1
rectified	Miserables.txt 2
rectifying	Miserables.txt 1
rectilinear	Miserables.txt 7
rectitude	Miserables.txt 2
rector	NotreDame_De_Paris.txt 15, Miserables.txt 1
recumbent	Miserables.txt 1
recur	Miserables.txt 8, NotreDame_De_Paris.txt 1
recurred	Miserables.txt 16, NotreDame_De_Paris.txt 4
recurrence	Miserables.txt 1
recurring	NotreDame_De_Paris.txt 1, Miserables.txt 1
red	Miserables.txt 134, NotreDame_De_Paris.txt 69
redan	Miserables.txt 1
redans	Miserables.txt 1
redbreast	Miserables.txt 1
redbreasts	Miserables.txt 1
redden	NotreDame_De_Paris.txt 1
reddened	NotreDame_De_Paris.txt 5, Miserables.txt 3
reddening	Miserables.txt 1
reddest	NotreDame_De_Paris.txt 1, Miserables.txt 1
reddish	Miserables.txt 10, NotreDame_De_Paris.txt 4
redeem	NotreDame_De_Paris.txt 1, Miserables.txt 1
redeemed	NotreDame_De_Paris.txt 1
redeems	Miserables.txt 1
redhaired	Miserables.txt 1
redistribute	NotreDame_De_Paris.txt 1, Miserables.txt 1
redistributing	NotreDame_De_Paris.txt 2, Miserables.txt 2
redistribution	NotreDame_De_Paris.txt 2, Miserables.txt 2
redivivus	Miserables.txt 1
redly	Miserables.txt 1
redness	NotreDame_De_Paris.txt 3
redouble	NotreDame_De_Paris.txt 4, Miserables.txt 1
redoubled	Miserables.txt 23, NotreDame_De_Paris.txt 12
redoubling	NotreDame_De_Paris.txt 2, Miserables.txt 2
redoubt	Miserables.txt 33
redoubtable	Miserables.txt 21, NotreDame_De_Paris.txt 4
redoubts	Miserables.txt 2
redress	Miserables.txt 2
reds	Miserables.txt 3, NotreDame_De_Paris.txt 1
reduced	Miserables.txt 14, NotreDame_De_Paris.txt 3
reducible	Miserables.txt 1
reduction	Miserables.txt 4
reed	Miserables.txt 5, NotreDame_De_Paris.txt 2
reef	Miserables.txt 2
reefs	NotreDame_De_Paris.txt 2, Miserables.txt 1
reeking	NotreDame_De_Paris.txt 1
reeks	Miserables.txt 1
reel	Miserables.txt 1
reeled	Miserables.txt 2
reeling	Miserables.txt 2
reestablished	NotreDame_De_Paris.txt 1
refait	Miserables.txt 1
refectories	NotreDame_De_Paris.txt 1
refectory	Miserables.txt 7, NotreDame_De_Paris.txt 1
refer	Miserables.txt 3, NotreDame_De_Paris.txt 1
reference	Miserables.txt 5, NotreDame_De_Paris.txt 1
references	Miserables.txt 3, NotreDame_De_Paris.txt 2
referred	Miserables.txt 5
refers	NotreDame_De_Paris.txt 1, Miserables.txt 1
refilled	Miserables.txt 1
refilling	Miserables.txt 1
refine	Miserables.txt 1
refined	Miserables.txt 1
refinement	NotreDame_De_Paris.txt 2, Miserables.txt 1
refinements	Miserables.txt 2
reflect	Miserables.txt 15, NotreDame_De_Paris.txt 4
reflected	Miserables.txt 38, NotreDame_De_Paris.txt 7
reflecting	NotreDame_De_Paris.txt 5, Miserables.txt 4
reflection	Miserables.txt 45, NotreDame_De_Paris.txt 12
reflections	Miserables.txt 13, NotreDame_De_Paris.txt 4
reflects	NotreDame_De_Paris.txt 1, Miserables.txt 1
refoncez	Miserables.txt 1
reform	NotreDame_De_Paris.txt 2, Miserables.txt 1
reformed	Miserables.txt 2
reformer	Miserables.txt 1
reformers	Miserables.txt 1
reforms	Miserables.txt 1
refraction	NotreDame_De_Paris.txt 2
refractory	Miserables.txt 5, NotreDame_De_Paris.txt 1
refrain	Miserables.txt 32, NotreDame_De_Paris.txt 8
refrained	Miserables.txt 1
refrains	Miserables.txt 3
refresh	Miserables.txt 1
refreshment	NotreDame_De_Paris.txt 2
refreshments	NotreDame_De_Paris.txt 1
refuge	Miserables.txt 37, NotreDame_De_Paris.txt 21
refugee	NotreDame_De_Paris.txt 1
refugees	Miserables.txt 2
refuges	Miserables.txt 2
refund	NotreDame_De_Paris.txt 10, Miserables.txt 10
refurnish	Miserables.txt 1
refusal	Miserables.txt 8, NotreDame_De_Paris.txt 1
refuse	Miserables.txt 17, NotreDame_De_Paris.txt 3
refused	Miserables.txt 34, NotreDame_De_Paris.txt 7
refuses	Miserables.txt 5
refusing	Miserables.txt 5
refuting	Miserables.txt 1
regain	Miserables.txt 4, NotreDame_De_Paris.txt 1
regained	Miserables.txt 20, NotreDame_De_Paris.txt 4
regaining	Miserables.txt 3, NotreDame_De_Paris.txt 2
regains	Miserables.txt 1
regale	NotreDame_De_Paris.txt 1, Miserables.txt 1
regaled	NotreDame_De_Paris.txt 1
regaling	NotreDame_De_Paris.txt 1
regalis	NotreDame_De_Paris.txt 1
regard	Miserables.txt 28, NotreDame_De_Paris.txt 4
regarde	NotreDame_De_Paris.txt 2
regarded	Miserables.txt 18
regardez	Miserables.txt 1
regarding	Miserables.txt 6, NotreDame_De_Paris.txt 4
regards	Miserables.txt 5
regency	Miserables.txt 1
regenerated	Miserables.txt 1
regent	Miserables.txt 1
reges	NotreDame_De_Paris.txt 1
regia	Miserables.txt 1
regicide	Miserables.txt 4
regicides	Miserables.txt 3
regild	Miserables.txt 2
regilded	Miserables.txt 1
regime	Miserables.txt 11, NotreDame_De_Paris.txt 1
regiment	Miserables.txt 26, NotreDame_De_Paris.txt 1
regimentals	Miserables.txt 1
regiments	Miserables.txt 17
region	Miserables.txt 9
regions	Miserables.txt 10, NotreDame_De_Paris.txt 1
register	NotreDame_De_Paris.txt 6, Miserables.txt 1
registered	NotreDame_De_Paris.txt 3, Miserables.txt 2
registers	Miserables.txt 2, NotreDame_De_Paris.txt 1
registrar	NotreDame_De_Paris.txt 1
registration	NotreDame_De_Paris.txt 1
registries	NotreDame_De_Paris.txt 1
registry	Miserables.txt 1
regnault	NotreDame_De_Paris.txt 1
regnier	Miserables.txt 3
regret	Miserables.txt 22, NotreDame_De_Paris.txt 11
regretfully	Miserables.txt 1
regrets	Miserables.txt 1
regrettable	Miserables.txt 1
regretted	Miserables.txt 10, NotreDame_De_Paris.txt 1
regrettedest	Miserables.txt 1
regretting	NotreDame_De_Paris.txt 1, Miserables.txt 1
reguise	Miserables.txt 1
regular	Miserables.txt 27, NotreDame_De_Paris.txt 9
regularibus	NotreDame_De_Paris.txt 1
regularity	Miserables.txt 4, NotreDame_De_Paris.txt 1
regularly	Miserables.txt 6, NotreDame_De_Paris.txt 1
regulas	Miserables.txt 1
regulate	Miserables.txt 1
regulated	Miserables.txt 10, NotreDame_De_Paris.txt 1
regulates	Miserables.txt 2
regulating	NotreDame_De_Paris.txt 3, Miserables.txt 3
regulation	Miserables.txt 5
regulations	Miserables.txt 13, NotreDame_De_Paris.txt 1
regulators	NotreDame_De_Paris.txt 1
rehabilitated	Miserables.txt 1
rehabilitation	Miserables.txt 2
rehung	Miserables.txt 1
reichenau	Miserables.txt 1
reichstadt	Miserables.txt 1
reign	Miserables.txt 18, NotreDame_De_Paris.txt 8
reigned	Miserables.txt 24, NotreDame_De_Paris.txt 1
reigning	Miserables.txt 9
reigns	Miserables.txt 9
reille	Miserables.txt 6
reims	NotreDame_De_Paris.txt 25, Miserables.txt 2
rein	Miserables.txt 1
reinforce	Miserables.txt 1
reinforced	Miserables.txt 1
reinforcement	Miserables.txt 3
reinforcements	Miserables.txt 5
reins	NotreDame_De_Paris.txt 1
reintegration	NotreDame_De_Paris.txt 1
reject	Miserables.txt 8, NotreDame_De_Paris.txt 3
rejecta	NotreDame_De_Paris.txt 1
rejected	Miserables.txt 7, NotreDame_De_Paris.txt 3
rejecting	Miserables.txt 2
rejects	Miserables.txt 2
rejoice	NotreDame_De_Paris.txt 1, Miserables.txt 1
rejoiced	NotreDame_De_Paris.txt 1, Miserables.txt 1
rejoices	NotreDame_De_Paris.txt 1, Miserables.txt 1
rejoicing	Miserables.txt 1
rejoicings	NotreDame_De_Paris.txt 1, Miserables.txt 1
rejoin	NotreDame_De_Paris.txt 1, Miserables.txt 1
rejoinder	Miserables.txt 1
rejoined	Miserables.txt 5, NotreDame_De_Paris.txt 4
rejuvenation	Miserables.txt 1
relapse	Miserables.txt 1
relapsed	Miserables.txt 5
relapses	Miserables.txt 1
relate	Miserables.txt 12, NotreDame_De_Paris.txt 2
related	Miserables.txt 14, NotreDame_De_Paris.txt 1
relates	Miserables.txt 3, NotreDame_De_Paris.txt 1
relating	Miserables.txt 11
relation	Miserables.txt 5, NotreDame_De_Paris.txt 2
relations	Miserables.txt 10
relationship	Miserables.txt 3, NotreDame_De_Paris.txt 1
relationships	Miserables.txt 1
relative	Miserables.txt 9
relatively	Miserables.txt 1
relatives	Miserables.txt 14, NotreDame_De_Paris.txt 1
relax	Miserables.txt 2, NotreDame_De_Paris.txt 1
relaxation	NotreDame_De_Paris.txt 3, Miserables.txt 1
relaxed	Miserables.txt 3, NotreDame_De_Paris.txt 1
relaxing	NotreDame_De_Paris.txt 1, Miserables.txt 1
relay	Miserables.txt 2
relays	Miserables.txt 3
release	NotreDame_De_Paris.txt 9, Miserables.txt 9
released	Miserables.txt 25, NotreDame_De_Paris.txt 7
releasing	Miserables.txt 5, NotreDame_De_Paris.txt 3
relegated	NotreDame_De_Paris.txt 1, Miserables.txt 1
relic	Miserables.txt 8, NotreDame_De_Paris.txt 1
relics	Miserables.txt 3, NotreDame_De_Paris.txt 1
relied	Miserables.txt 2
relief	Miserables.txt 11, NotreDame_De_Paris.txt 10
reliefs	NotreDame_De_Paris.txt 2, Miserables.txt 1
relieve	Miserables.txt 5
relieved	Miserables.txt 12, NotreDame_De_Paris.txt 5
relieves	Miserables.txt 1
relieving	Miserables.txt 1
relighted	Miserables.txt 1
religion	Miserables.txt 34, NotreDame_De_Paris.txt 13
religionists	Miserables.txt 1
religions	Miserables.txt 5, NotreDame_De_Paris.txt 1
religious	Miserables.txt 27, NotreDame_De_Paris.txt 12
religiously	Miserables.txt 5
relinquish	Miserables.txt 1
relinquishes	Miserables.txt 1
reliquaries	NotreDame_De_Paris.txt 2, Miserables.txt 1
reliquary	NotreDame_De_Paris.txt 1, Miserables.txt 1
reload	Miserables.txt 1
reloaded	Miserables.txt 1
reloading	Miserables.txt 2
reluctance	NotreDame_De_Paris.txt 1
remain	Miserables.txt 93, NotreDame_De_Paris.txt 24
remainder	Miserables.txt 7, NotreDame_De_Paris.txt 2
remained	Miserables.txt 239, NotreDame_De_Paris.txt 100
remaining	Miserables.txt 21, NotreDame_De_Paris.txt 3
remains	Miserables.txt 43, NotreDame_De_Paris.txt 18
remark	Miserables.txt 55, NotreDame_De_Paris.txt 8
remarkable	Miserables.txt 19, NotreDame_De_Paris.txt 5
remarkably	NotreDame_De_Paris.txt 1
remarked	Miserables.txt 26, NotreDame_De_Paris.txt 13
remarking	NotreDame_De_Paris.txt 1
remarks	Miserables.txt 13, NotreDame_De_Paris.txt 6
rembrandt	NotreDame_De_Paris.txt 3, Miserables.txt 1
remedies	NotreDame_De_Paris.txt 2, Miserables.txt 1
remedy	Miserables.txt 6, NotreDame_De_Paris.txt 2
remember	Miserables.txt 52, NotreDame_De_Paris.txt 13
remembered	Miserables.txt 43, NotreDame_De_Paris.txt 11
remembering	Miserables.txt 1
remembers	NotreDame_De_Paris.txt 2, Miserables.txt 1
remind	Miserables.txt 10, NotreDame_De_Paris.txt 2
reminded	NotreDame_De_Paris.txt 5, Miserables.txt 3
reminder	Miserables.txt 1
reminding	NotreDame_De_Paris.txt 1
reminds	NotreDame_De_Paris.txt 2
reminiscences	NotreDame_De_Paris.txt 3, Miserables.txt 1
remittances	Miserables.txt 1
remitted	Miserables.txt 1
remnant	Miserables.txt 8, NotreDame_De_Paris.txt 5
remnants	Miserables.txt 2
remonstrance	Miserables.txt 1
remonstrances	Miserables.txt 2
remorse	Miserables.txt 8, NotreDame_De_Paris.txt 1
remote	Miserables.txt 4
remotest	Miserables.txt 1
remoto	Miserables.txt 2
remount	Miserables.txt 1
remounted	NotreDame_De_Paris.txt 1
removal	Miserables.txt 3, NotreDame_De_Paris.txt 1
remove	Miserables.txt 7, NotreDame_De_Paris.txt 1
removed	Miserables.txt 31, NotreDame_De_Paris.txt 10
removes	Miserables.txt 3
removeth	NotreDame_De_Paris.txt 1
removing	NotreDame_De_Paris.txt 5, Miserables.txt 5
remy	NotreDame_De_Paris.txt 3
renaissance	NotreDame_De_Paris.txt 11
renamed	NotreDame_De_Paris.txt 1, Miserables.txt 1
renard	Miserables.txt 4
renauld	NotreDame_De_Paris.txt 1
rend	Miserables.txt 3, NotreDame_De_Paris.txt 1
render	Miserables.txt 41, NotreDame_De_Paris.txt 8
rendered	Miserables.txt 84, NotreDame_De_Paris.txt 26
rendering	Miserables.txt 10, NotreDame_De_Paris.txt 1
renders	Miserables.txt 12, NotreDame_De_Paris.txt 5
rendez	Miserables.txt 2
rendezvous	NotreDame_De_Paris.txt 6, Miserables.txt 6
rending	Miserables.txt 11, NotreDame_De_Paris.txt 2
rends	Miserables.txt 2
renee	Miserables.txt 1
renew	Miserables.txt 2, NotreDame_De_Paris.txt 1
renewal	NotreDame_De_Paris.txt 1
renewed	Miserables.txt 6, NotreDame_De_Paris.txt 2
rennet	NotreDame_De_Paris.txt 10
renounce	Miserables.txt 8
renounced	Miserables.txt 5, NotreDame_De_Paris.txt 2
renouncing	Miserables.txt 4
renown	Miserables.txt 7, NotreDame_De_Paris.txt 1
renowned	Miserables.txt 2
rent	Miserables.txt 30, NotreDame_De_Paris.txt 13
rentre	Miserables.txt 1
rents	NotreDame_De_Paris.txt 6, Miserables.txt 4
renunciation	Miserables.txt 7
renunciations	Miserables.txt 1
reorganization	Miserables.txt 1
repaid	Miserables.txt 3
repair	Miserables.txt 4
repaired	Miserables.txt 7, NotreDame_De_Paris.txt 1
repairing	Miserables.txt 4, NotreDame_De_Paris.txt 1
repairs	Miserables.txt 3
reparation	Miserables.txt 10, NotreDame_De_Paris.txt 1
repassed	Miserables.txt 1
repassing	NotreDame_De_Paris.txt 1
repast	Miserables.txt 4, NotreDame_De_Paris.txt 3
repasts	Miserables.txt 2
repaving	Miserables.txt 1
repay	Miserables.txt 4, NotreDame_De_Paris.txt 2
repeat	Miserables.txt 31, NotreDame_De_Paris.txt 3
repeated	Miserables.txt 58, NotreDame_De_Paris.txt 51
repeatedly	Miserables.txt 2, NotreDame_De_Paris.txt 1
repeating	NotreDame_De_Paris.txt 11, Miserables.txt 5
repeats	Miserables.txt 3, NotreDame_De_Paris.txt 1
repel	NotreDame_De_Paris.txt 2
repelled	Miserables.txt 3
repellent	NotreDame_De_Paris.txt 1
repent	NotreDame_De_Paris.txt 2
repentance	Miserables.txt 5
repentant	Miserables.txt 1
repented	Miserables.txt 1
repeopled	NotreDame_De_Paris.txt 1
repertory	Miserables.txt 8
repete	Miserables.txt 1
repetition	Miserables.txt 2
repetitions	Miserables.txt 1
replace	Miserables.txt 13, NotreDame_De_Paris.txt 1
replaced	Miserables.txt 32, NotreDame_De_Paris.txt 9
replacement	NotreDame_De_Paris.txt 5, Miserables.txt 5
replaces	Miserables.txt 6, NotreDame_De_Paris.txt 1
replacing	Miserables.txt 3
replenished	NotreDame_De_Paris.txt 1
repleta	NotreDame_De_Paris.txt 1
replied	Miserables.txt 309, NotreDame_De_Paris.txt 167
replies	Miserables.txt 15, NotreDame_De_Paris.txt 2
reply	Miserables.txt 81, NotreDame_De_Paris.txt 28
replying	Miserables.txt 19, NotreDame_De_Paris.txt 1
repointed	NotreDame_De_Paris.txt 1
repondu	Miserables.txt 1
report	Miserables.txt 29, NotreDame_De_Paris.txt 2
reported	Miserables.txt 7, NotreDame_De_Paris.txt 1
reports	Miserables.txt 8, NotreDame_De_Paris.txt 1
repose	Miserables.txt 27, NotreDame_De_Paris.txt 3
reposed	NotreDame_De_Paris.txt 2
reposeful	NotreDame_De_Paris.txt 1
reposes	Miserables.txt 2
reposing	Miserables.txt 1
reprends	Miserables.txt 1
represent	Miserables.txt 6, NotreDame_De_Paris.txt 2
representation	NotreDame_De_Paris.txt 5, Miserables.txt 1
representations	Miserables.txt 3, NotreDame_De_Paris.txt 1
representative	Miserables.txt 7, NotreDame_De_Paris.txt 1
represented	Miserables.txt 30, NotreDame_De_Paris.txt 6
representing	NotreDame_De_Paris.txt 5, Miserables.txt 4
represents	NotreDame_De_Paris.txt 4, Miserables.txt 4
repress	Miserables.txt 5, NotreDame_De_Paris.txt 3
repressed	Miserables.txt 8, NotreDame_De_Paris.txt 2
repression	Miserables.txt 7
reprieve	NotreDame_De_Paris.txt 1
reprimand	Miserables.txt 2
reprint	NotreDame_De_Paris.txt 1
reprinted	Miserables.txt 1
reprisal	Miserables.txt 1
reprisals	Miserables.txt 3
reproach	Miserables.txt 19, NotreDame_De_Paris.txt 6
reproached	Miserables.txt 8, NotreDame_De_Paris.txt 1
reproaches	Miserables.txt 5, NotreDame_De_Paris.txt 2
reproachful	Miserables.txt 1
reproaching	Miserables.txt 2
reprobation	Miserables.txt 1
reproduce	Miserables.txt 4, NotreDame_De_Paris.txt 1
reproduced	Miserables.txt 5, NotreDame_De_Paris.txt 1
reproducing	NotreDame_De_Paris.txt 1
reprove	Miserables.txt 1
reproved	Miserables.txt 4
reptile	NotreDame_De_Paris.txt 1, Miserables.txt 1
reptitalmus	Miserables.txt 1
republic	Miserables.txt 51, NotreDame_De_Paris.txt 1
republican	Miserables.txt 11, NotreDame_De_Paris.txt 2
republicans	Miserables.txt 8
republics	Miserables.txt 4
repudiate	Miserables.txt 1
repudiated	Miserables.txt 1
repugnance	NotreDame_De_Paris.txt 2, Miserables.txt 2
repugnant	Miserables.txt 7, NotreDame_De_Paris.txt 1
repulse	NotreDame_De_Paris.txt 4, Miserables.txt 1
repulsed	Miserables.txt 6, NotreDame_De_Paris.txt 3
repulsing	Miserables.txt 1
repulsive	Miserables.txt 14, NotreDame_De_Paris.txt 1
repulsiveness	Miserables.txt 1
reputation	NotreDame_De_Paris.txt 7, Miserables.txt 7
reputations	Miserables.txt 3
repute	Miserables.txt 3
reputed	NotreDame_De_Paris.txt 3, Miserables.txt 3
request	Miserables.txt 10, NotreDame_De_Paris.txt 5
requested	Miserables.txt 6
requesting	Miserables.txt 1
requests	NotreDame_De_Paris.txt 2, Miserables.txt 1
requiem	Miserables.txt 1
requiescant	Miserables.txt 2
requiescat	Miserables.txt 1
require	Miserables.txt 17, NotreDame_De_Paris.txt 5
required	Miserables.txt 60, NotreDame_De_Paris.txt 18
requirement	Miserables.txt 1
requirements	Miserables.txt 11, NotreDame_De_Paris.txt 4
requirere	NotreDame_De_Paris.txt 1
requires	Miserables.txt 4, NotreDame_De_Paris.txt 2
requiring	Miserables.txt 1
requisite	Miserables.txt 8
requisites	Miserables.txt 1
requisition	Miserables.txt 2, NotreDame_De_Paris.txt 1
requite	Miserables.txt 1
requited	Miserables.txt 1
requiting	Miserables.txt 1
reread	NotreDame_De_Paris.txt 1
rerum	NotreDame_De_Paris.txt 1
res	Miserables.txt 3, NotreDame_De_Paris.txt 2
rescue	NotreDame_De_Paris.txt 8, Miserables.txt 6
rescued	Miserables.txt 5, NotreDame_De_Paris.txt 3
rescuer	Miserables.txt 1
rescuing	Miserables.txt 3
research	NotreDame_De_Paris.txt 2, Miserables.txt 2
researches	Miserables.txt 9
reseated	Miserables.txt 1
resemblance	Miserables.txt 15, NotreDame_De_Paris.txt 4
resemblances	Miserables.txt 1
resemble	Miserables.txt 25, NotreDame_De_Paris.txt 10
resembled	Miserables.txt 71, NotreDame_De_Paris.txt 16
resembles	Miserables.txt 37, NotreDame_De_Paris.txt 7
resemblest	NotreDame_De_Paris.txt 1, Miserables.txt 1
resembling	Miserables.txt 14, NotreDame_De_Paris.txt 1
resentful	Miserables.txt 1
resentment	NotreDame_De_Paris.txt 1
reservation	Miserables.txt 2
reservations	Miserables.txt 2
reserve	Miserables.txt 12, NotreDame_De_Paris.txt 5
reserved	Miserables.txt 21, NotreDame_De_Paris.txt 8
reserves	Miserables.txt 5
reserving	Miserables.txt 3
reservoir	NotreDame_De_Paris.txt 2, Miserables.txt 2
reside	Miserables.txt 1
resided	Miserables.txt 2, NotreDame_De_Paris.txt 1
residence	Miserables.txt 12
residences	NotreDame_De_Paris.txt 1
resident	Miserables.txt 1
residue	NotreDame_De_Paris.txt 1
residuum	Miserables.txt 1
resign	Miserables.txt 4, NotreDame_De_Paris.txt 2
resignation	Miserables.txt 11, NotreDame_De_Paris.txt 2
resigned	Miserables.txt 5, NotreDame_De_Paris.txt 4
resigning	Miserables.txt 1
resin	Miserables.txt 4
resinous	Miserables.txt 1
resist	Miserables.txt 14, NotreDame_De_Paris.txt 5
resistance	Miserables.txt 22, NotreDame_De_Paris.txt 13
resistances	Miserables.txt 3
resisted	Miserables.txt 12, NotreDame_De_Paris.txt 5
resisting	Miserables.txt 5, NotreDame_De_Paris.txt 2
resists	Miserables.txt 4
resolute	Miserables.txt 7, NotreDame_De_Paris.txt 2
resolutely	Miserables.txt 17, NotreDame_De_Paris.txt 1
resolution	Miserables.txt 20, NotreDame_De_Paris.txt 5
resolutions	Miserables.txt 4
resolve	Miserables.txt 8
resolved	Miserables.txt 14, NotreDame_De_Paris.txt 2
resolves	Miserables.txt 1
resort	NotreDame_De_Paris.txt 2, Miserables.txt 2
resound	NotreDame_De_Paris.txt 1
resounded	Miserables.txt 5, NotreDame_De_Paris.txt 3
resounding	Miserables.txt 1
resounds	NotreDame_De_Paris.txt 1
resource	Miserables.txt 10, NotreDame_De_Paris.txt 3
resources	Miserables.txt 11
respect	Miserables.txt 70, NotreDame_De_Paris.txt 12
respectability	Miserables.txt 2
respectable	Miserables.txt 19, NotreDame_De_Paris.txt 2
respected	Miserables.txt 10, NotreDame_De_Paris.txt 1
respectful	Miserables.txt 19, NotreDame_De_Paris.txt 2
respectfully	Miserables.txt 5
respecting	Miserables.txt 2
respective	NotreDame_De_Paris.txt 1, Miserables.txt 1
respects	Miserables.txt 7
respirable	Miserables.txt 2
respiration	Miserables.txt 10
respite	Miserables.txt 6, NotreDame_De_Paris.txt 3
resplendent	Miserables.txt 5, NotreDame_De_Paris.txt 4
respond	NotreDame_De_Paris.txt 2
responded	Miserables.txt 23, NotreDame_De_Paris.txt 6
responding	Miserables.txt 2
responds	Miserables.txt 2
response	Miserables.txt 4, NotreDame_De_Paris.txt 3
responses	NotreDame_De_Paris.txt 3
responsibility	Miserables.txt 3, NotreDame_De_Paris.txt 1
responsible	Miserables.txt 8, NotreDame_De_Paris.txt 2
rest	Miserables.txt 126, NotreDame_De_Paris.txt 32
restai	Miserables.txt 1
restaurant	Miserables.txt 6
reste	Miserables.txt 2
rested	Miserables.txt 29, NotreDame_De_Paris.txt 13
restif	Miserables.txt 1
resting	Miserables.txt 24, NotreDame_De_Paris.txt 6
restitution	Miserables.txt 5
restive	Miserables.txt 1
restless	Miserables.txt 2, NotreDame_De_Paris.txt 1
restoration	Miserables.txt 26, NotreDame_De_Paris.txt 1
restorations	NotreDame_De_Paris.txt 2
restore	Miserables.txt 7, NotreDame_De_Paris.txt 3
restored	Miserables.txt 14, NotreDame_De_Paris.txt 7
restores	Miserables.txt 4, NotreDame_De_Paris.txt 1
restoring	Miserables.txt 3
restrain	Miserables.txt 6, NotreDame_De_Paris.txt 1
restrained	Miserables.txt 6, NotreDame_De_Paris.txt 2
restrains	NotreDame_De_Paris.txt 1
restrict	Miserables.txt 1
restricted	Miserables.txt 8
restriction	Miserables.txt 3
restrictions	Miserables.txt 3, NotreDame_De_Paris.txt 2
rests	Miserables.txt 7, NotreDame_De_Paris.txt 1
result	Miserables.txt 52, NotreDame_De_Paris.txt 4
resulted	Miserables.txt 6, NotreDame_De_Paris.txt 1
resulting	Miserables.txt 2, NotreDame_De_Paris.txt 1
results	Miserables.txt 22, NotreDame_De_Paris.txt 4
resume	Miserables.txt 5, NotreDame_De_Paris.txt 2
resumed	Miserables.txt 168, NotreDame_De_Paris.txt 91
resumes	Miserables.txt 1
resuming	Miserables.txt 2
resurrection	Miserables.txt 7
resuscitate	Miserables.txt 1
resuscitated	Miserables.txt 2
resuscitating	Miserables.txt 1
retail	Miserables.txt 1
retain	Miserables.txt 8, NotreDame_De_Paris.txt 2
retained	Miserables.txt 14, NotreDame_De_Paris.txt 3
retaining	Miserables.txt 2, NotreDame_De_Paris.txt 1
retains	Miserables.txt 2
retaken	Miserables.txt 1
retaliation	Miserables.txt 1
retard	Miserables.txt 1
retarded	Miserables.txt 3
retarding	Miserables.txt 1
reticence	NotreDame_De_Paris.txt 1, Miserables.txt 1
retif	NotreDame_De_Paris.txt 1
retinue	Miserables.txt 1
retire	Miserables.txt 10, NotreDame_De_Paris.txt 2
retired	Miserables.txt 30, NotreDame_De_Paris.txt 13
retirement	Miserables.txt 1
retires	Miserables.txt 1
retiring	Miserables.txt 2
retort	Miserables.txt 7, NotreDame_De_Paris.txt 2
retorted	Miserables.txt 46, NotreDame_De_Paris.txt 16
retorting	Miserables.txt 1
retorts	NotreDame_De_Paris.txt 1, Miserables.txt 1
retourner	Miserables.txt 1
retrace	Miserables.txt 7, NotreDame_De_Paris.txt 3
retraced	Miserables.txt 12, NotreDame_De_Paris.txt 2
retracing	NotreDame_De_Paris.txt 2, Miserables.txt 2
retract	Miserables.txt 3
retreat	Miserables.txt 33, NotreDame_De_Paris.txt 17
retreated	Miserables.txt 34, NotreDame_De_Paris.txt 12
retreating	Miserables.txt 16, NotreDame_De_Paris.txt 2
retreats	Miserables.txt 3
retrench	Miserables.txt 1
retrenching	Miserables.txt 1
retro	Miserables.txt 1
retrocedes	Miserables.txt 1
retrograde	Miserables.txt 1
retrograding	Miserables.txt 1
retrospective	Miserables.txt 1
retrospectively	Miserables.txt 1
retrouveras	NotreDame_De_Paris.txt 1
return	Miserables.txt 124, NotreDame_De_Paris.txt 23
returned	Miserables.txt 182, NotreDame_De_Paris.txt 56
returning	Miserables.txt 26, NotreDame_De_Paris.txt 9
returns	Miserables.txt 20, NotreDame_De_Paris.txt 3
retying	NotreDame_De_Paris.txt 1
reuilly	Miserables.txt 1
reunion	Miserables.txt 1
reunions	Miserables.txt 1
reunited	Miserables.txt 1
revarnished	Miserables.txt 1
revasseries	Miserables.txt 1
reveal	Miserables.txt 7
revealed	Miserables.txt 8, NotreDame_De_Paris.txt 4
revealer	Miserables.txt 1
revealers	Miserables.txt 1
revealing	NotreDame_De_Paris.txt 1, Miserables.txt 1
reveals	Miserables.txt 1
revelation	Miserables.txt 9
revelations	Miserables.txt 5
revenge	Miserables.txt 10
revenging	Miserables.txt 1
revenue	NotreDame_De_Paris.txt 2, Miserables.txt 1
revenues	NotreDame_De_Paris.txt 3, Miserables.txt 2
reverberated	NotreDame_De_Paris.txt 2
reverberating	NotreDame_De_Paris.txt 2
reverberation	NotreDame_De_Paris.txt 1, Miserables.txt 1
reverberations	Miserables.txt 2
revere	Miserables.txt 2
revered	Miserables.txt 2
reverence	NotreDame_De_Paris.txt 3, Miserables.txt 2
reverences	NotreDame_De_Paris.txt 2
reverend	Miserables.txt 32, NotreDame_De_Paris.txt 11
reveries	Miserables.txt 8, NotreDame_De_Paris.txt 2
revers	Miserables.txt 3
reversal	Miserables.txt 2
reverse	Miserables.txt 4, NotreDame_De_Paris.txt 2
reversed	Miserables.txt 5, NotreDame_De_Paris.txt 2
reverses	Miserables.txt 1
reversing	Miserables.txt 3
reversion	NotreDame_De_Paris.txt 1, Miserables.txt 1
revert	NotreDame_De_Paris.txt 1
reverted	Miserables.txt 4
reverting	Miserables.txt 1
revery	Miserables.txt 59, NotreDame_De_Paris.txt 14
revictual	Miserables.txt 1
review	Miserables.txt 14
revile	NotreDame_De_Paris.txt 1
revised	NotreDame_De_Paris.txt 1, Miserables.txt 1
revising	Miserables.txt 1
revision	Miserables.txt 1
revived	NotreDame_De_Paris.txt 3, Miserables.txt 2
reviving	Miserables.txt 1
revocation	Miserables.txt 1
revocations	NotreDame_De_Paris.txt 1
revolt	Miserables.txt 49, NotreDame_De_Paris.txt 13
revolted	Miserables.txt 1
revolting	Miserables.txt 1
revolts	Miserables.txt 7, NotreDame_De_Paris.txt 1
revolution	Miserables.txt 163, NotreDame_De_Paris.txt 10
revolutionary	Miserables.txt 33
revolutionist	Miserables.txt 4
revolutionists	Miserables.txt 5
revolutions	Miserables.txt 31, NotreDame_De_Paris.txt 4
revolved	Miserables.txt 1
revolving	Miserables.txt 2
reward	NotreDame_De_Paris.txt 2
rewards	Miserables.txt 1
rewrite	NotreDame_De_Paris.txt 2
rewriting	NotreDame_De_Paris.txt 1
rex	NotreDame_De_Paris.txt 1
reyniere	Miserables.txt 2
rez	NotreDame_De_Paris.txt 1
rhamseion	NotreDame_De_Paris.txt 1
rhapsodies	NotreDame_De_Paris.txt 1
rhapsody	NotreDame_De_Paris.txt 1
rheims	Miserables.txt 3
rhetorician	Miserables.txt 1
rheumatism	Miserables.txt 2
rhine	Miserables.txt 4
rhodes	Miserables.txt 1
rhododendron	Miserables.txt 4
rhone	Miserables.txt 1
rhyme	Miserables.txt 2, NotreDame_De_Paris.txt 1
rhymed	Miserables.txt 1
rhymes	Miserables.txt 2, NotreDame_De_Paris.txt 1
rhymester	NotreDame_De_Paris.txt 1
rhythm	Miserables.txt 3
rhythmics	NotreDame_De_Paris.txt 1
riait	Miserables.txt 1
ribald	NotreDame_De_Paris.txt 1
ribbed	Miserables.txt 2
ribbon	Miserables.txt 22, NotreDame_De_Paris.txt 2
ribboned	Miserables.txt 1
ribbons	Miserables.txt 10, NotreDame_De_Paris.txt 6
ribonribette	Miserables.txt 1
ribonribo	Miserables.txt 1
ribotte	Miserables.txt 1
ribs	Miserables.txt 6
rich	Miserables.txt 77, NotreDame_De_Paris.txt 24
richard	NotreDame_De_Paris.txt 1, Miserables.txt 1
richarde	NotreDame_De_Paris.txt 1
richefeu	Miserables.txt 5
richelieu	Miserables.txt 4, NotreDame_De_Paris.txt 1
richer	NotreDame_De_Paris.txt 1, Miserables.txt 1
riches	Miserables.txt 13, NotreDame_De_Paris.txt 1
richest	Miserables.txt 2
richly	NotreDame_De_Paris.txt 2, Miserables.txt 1
richmond	Miserables.txt 1
richness	NotreDame_De_Paris.txt 3
ricketty	NotreDame_De_Paris.txt 1
rickety	NotreDame_De_Paris.txt 1, Miserables.txt 1
rid	Miserables.txt 17, NotreDame_De_Paris.txt 6
ridden	Miserables.txt 6, NotreDame_De_Paris.txt 1
riddle	NotreDame_De_Paris.txt 1, Miserables.txt 1
riddled	Miserables.txt 5
riddles	Miserables.txt 2
riddling	Miserables.txt 2
ride	Miserables.txt 4, NotreDame_De_Paris.txt 1
rider	Miserables.txt 3, NotreDame_De_Paris.txt 2
riders	Miserables.txt 3
rides	NotreDame_De_Paris.txt 2
ridet	Miserables.txt 1
ridge	Miserables.txt 4, NotreDame_De_Paris.txt 1
ridicule	Miserables.txt 2, NotreDame_De_Paris.txt 1
ridicules	Miserables.txt 1
ridiculous	Miserables.txt 15, NotreDame_De_Paris.txt 5
ridiculously	NotreDame_De_Paris.txt 1
riding	NotreDame_De_Paris.txt 3, Miserables.txt 1
riego	Miserables.txt 1
rien	Miserables.txt 2
rife	Miserables.txt 1
rifle	Miserables.txt 13
rifled	Miserables.txt 4
rifod	NotreDame_De_Paris.txt 1
rift	Miserables.txt 2
rigadoons	Miserables.txt 1
riggers	NotreDame_De_Paris.txt 1
rigging	Miserables.txt 4
right	Miserables.txt 421, NotreDame_De_Paris.txt 74
righted	Miserables.txt 1
rightly	Miserables.txt 5, NotreDame_De_Paris.txt 1
rights	Miserables.txt 35, NotreDame_De_Paris.txt 1
rigid	Miserables.txt 11, NotreDame_De_Paris.txt 2
rigidity	Miserables.txt 3, NotreDame_De_Paris.txt 1
rigmarole	Miserables.txt 2
rigor	NotreDame_De_Paris.txt 2
rigorous	Miserables.txt 2
rigorously	Miserables.txt 3, NotreDame_De_Paris.txt 1
rim	Miserables.txt 3, NotreDame_De_Paris.txt 1
rimmed	Miserables.txt 1
rind	NotreDame_De_Paris.txt 1, Miserables.txt 1
rinet	NotreDame_De_Paris.txt 1
ring	Miserables.txt 14, NotreDame_De_Paris.txt 9
ringer	NotreDame_De_Paris.txt 2, Miserables.txt 1
ringing	NotreDame_De_Paris.txt 9, Miserables.txt 3
ringlets	NotreDame_De_Paris.txt 1
rings	Miserables.txt 8, NotreDame_De_Paris.txt 6
rinse	Miserables.txt 1
rio	Miserables.txt 1
riot	Miserables.txt 22, NotreDame_De_Paris.txt 2
rioter	Miserables.txt 2
rioters	Miserables.txt 1
rioting	Miserables.txt 2
riots	Miserables.txt 9
rip	Miserables.txt 2, NotreDame_De_Paris.txt 1
ripe	Miserables.txt 15
riper	Miserables.txt 1
ripped	NotreDame_De_Paris.txt 1, Miserables.txt 1
ripple	NotreDame_De_Paris.txt 1, Miserables.txt 1
rippling	NotreDame_De_Paris.txt 1, Miserables.txt 1
riqueza	NotreDame_De_Paris.txt 1
rire	Miserables.txt 1
rise	Miserables.txt 57, NotreDame_De_Paris.txt 14
risen	Miserables.txt 23, NotreDame_De_Paris.txt 8
rises	Miserables.txt 16, NotreDame_De_Paris.txt 4
rising	Miserables.txt 33, NotreDame_De_Paris.txt 13
risings	Miserables.txt 1
risk	Miserables.txt 29, NotreDame_De_Paris.txt 7
risked	Miserables.txt 10, NotreDame_De_Paris.txt 3
risking	Miserables.txt 1
risks	Miserables.txt 4
risky	Miserables.txt 1
rite	Miserables.txt 1
ritournelles	Miserables.txt 1
ritual	NotreDame_De_Paris.txt 1
rival	NotreDame_De_Paris.txt 3, Miserables.txt 1
rivalled	Miserables.txt 2, NotreDame_De_Paris.txt 1
rivalries	Miserables.txt 1
rivalry	Miserables.txt 3, NotreDame_De_Paris.txt 2
river	Miserables.txt 46, NotreDame_De_Paris.txt 26
rivers	Miserables.txt 5, NotreDame_De_Paris.txt 1
riverside	Miserables.txt 1
riveted	Miserables.txt 13, NotreDame_De_Paris.txt 12
rivetted	Miserables.txt 1
rivoli	Miserables.txt 5, NotreDame_De_Paris.txt 1
rivulet	Miserables.txt 3
rivulets	Miserables.txt 1
rixa	NotreDame_De_Paris.txt 1
road	Miserables.txt 144, NotreDame_De_Paris.txt 8
roadmending	Miserables.txt 1
roads	Miserables.txt 33, NotreDame_De_Paris.txt 4
roadsteads	Miserables.txt 1
roam	Miserables.txt 4, NotreDame_De_Paris.txt 2
roamed	Miserables.txt 2, NotreDame_De_Paris.txt 1
roamer	Miserables.txt 2
roaming	NotreDame_De_Paris.txt 2, Miserables.txt 1
roams	Miserables.txt 1
roar	Miserables.txt 14, NotreDame_De_Paris.txt 4
roared	Miserables.txt 4, NotreDame_De_Paris.txt 2
roaring	NotreDame_De_Paris.txt 3
roarings	NotreDame_De_Paris.txt 1
roars	Miserables.txt 2, NotreDame_De_Paris.txt 1
roast	Miserables.txt 2, NotreDame_De_Paris.txt 1
roastbeef	Miserables.txt 1
roasted	NotreDame_De_Paris.txt 1
roasting	Miserables.txt 3, NotreDame_De_Paris.txt 1
roastings	NotreDame_De_Paris.txt 1
rob	Miserables.txt 9
robbed	Miserables.txt 21
robber	Miserables.txt 8, NotreDame_De_Paris.txt 2
robberies	Miserables.txt 1
robbers	Miserables.txt 9, NotreDame_De_Paris.txt 3
robbery	Miserables.txt 6
robbing	Miserables.txt 3, NotreDame_De_Paris.txt 1
robe	NotreDame_De_Paris.txt 24, Miserables.txt 10
robecque	Miserables.txt 1
robed	Miserables.txt 1
robert	NotreDame_De_Paris.txt 19, Miserables.txt 3
robes	NotreDame_De_Paris.txt 12, Miserables.txt 5
robespierre	Miserables.txt 18
robin	NotreDame_De_Paris.txt 17, Miserables.txt 3
robust	Miserables.txt 16, NotreDame_De_Paris.txt 2
robustus	NotreDame_De_Paris.txt 1
rocaille	Miserables.txt 1
roch	NotreDame_De_Paris.txt 1
roche	Miserables.txt 3, NotreDame_De_Paris.txt 1
rochefort	Miserables.txt 1
rock	Miserables.txt 22, NotreDame_De_Paris.txt 3
rocked	Miserables.txt 2
rockets	NotreDame_De_Paris.txt 1
rocking	NotreDame_De_Paris.txt 1
rocks	Miserables.txt 4
rocky	Miserables.txt 1
rococo	Miserables.txt 2
rod	Miserables.txt 3
rode	NotreDame_De_Paris.txt 3, Miserables.txt 2
rodents	Miserables.txt 1
rods	NotreDame_De_Paris.txt 2, Miserables.txt 1
roelof	NotreDame_De_Paris.txt 1
roger	NotreDame_De_Paris.txt 1, Miserables.txt 1
rogue	Miserables.txt 7, NotreDame_De_Paris.txt 3
rogueries	Miserables.txt 1
roguery	Miserables.txt 1
roguet	Miserables.txt 3
roguish	Miserables.txt 3
rohan	Miserables.txt 7
roi	Miserables.txt 14, NotreDame_De_Paris.txt 5
roland	NotreDame_De_Paris.txt 15, Miserables.txt 1
rolande	NotreDame_De_Paris.txt 3
role	NotreDame_De_Paris.txt 1
roles	Miserables.txt 3, NotreDame_De_Paris.txt 2
roll	Miserables.txt 29, NotreDame_De_Paris.txt 4
rolleboise	Miserables.txt 1
rolled	Miserables.txt 14, NotreDame_De_Paris.txt 4
rollet	Miserables.txt 1
rollin	Miserables.txt 3
rolling	Miserables.txt 10, NotreDame_De_Paris.txt 3
rolls	Miserables.txt 9, NotreDame_De_Paris.txt 3
romainville	Miserables.txt 6
roman	NotreDame_De_Paris.txt 33, Miserables.txt 16
romance	Miserables.txt 22, NotreDame_De_Paris.txt 9
romancero	NotreDame_De_Paris.txt 1
romanceros	NotreDame_De_Paris.txt 2
romancers	Miserables.txt 1
romances	Miserables.txt 10
romanesque	NotreDame_De_Paris.txt 19
romanoffs	Miserables.txt 1
romans	Miserables.txt 3, NotreDame_De_Paris.txt 1
romantic	Miserables.txt 8
romantically	Miserables.txt 1
romanticism	Miserables.txt 2, NotreDame_De_Paris.txt 1
rome	Miserables.txt 45, NotreDame_De_Paris.txt 14
romeo	Miserables.txt 3, NotreDame_De_Paris.txt 1
romorantin	Miserables.txt 1
romulus	Miserables.txt 1
rond	NotreDame_De_Paris.txt 3
ronde	Miserables.txt 1
rondelle	NotreDame_De_Paris.txt 1
rondo	NotreDame_De_Paris.txt 1
ronds	Miserables.txt 2
ronge	NotreDame_De_Paris.txt 2
roof	Miserables.txt 59, NotreDame_De_Paris.txt 44
roofed	NotreDame_De_Paris.txt 1, Miserables.txt 1
roofers	Miserables.txt 1
roofs	NotreDame_De_Paris.txt 37, Miserables.txt 27
roogny	NotreDame_De_Paris.txt 1
room	Miserables.txt 302, NotreDame_De_Paris.txt 33
rooms	Miserables.txt 28, NotreDame_De_Paris.txt 2
roost	Miserables.txt 1
roosts	Miserables.txt 1
root	Miserables.txt 7, NotreDame_De_Paris.txt 2
rooted	Miserables.txt 4, NotreDame_De_Paris.txt 2
rootless	Miserables.txt 1
roots	Miserables.txt 11, NotreDame_De_Paris.txt 3
rope	Miserables.txt 72, NotreDame_De_Paris.txt 27
roped	NotreDame_De_Paris.txt 1
ropes	Miserables.txt 14, NotreDame_De_Paris.txt 5
roquelaure	Miserables.txt 3
roquette	Miserables.txt 1
rosa	Miserables.txt 2, NotreDame_De_Paris.txt 1
rosaries	NotreDame_De_Paris.txt 1
rosary	Miserables.txt 3
rose	Miserables.txt 132, NotreDame_De_Paris.txt 74
rosebush	Miserables.txt 1
rosee	Miserables.txt 1
roses	Miserables.txt 22, NotreDame_De_Paris.txt 2
rosette	Miserables.txt 3
rosettes	NotreDame_De_Paris.txt 2, Miserables.txt 1
rosewood	Miserables.txt 1
rosier	NotreDame_De_Paris.txt 1
rosin	NotreDame_De_Paris.txt 1
rosse	Miserables.txt 1
rosses	Miserables.txt 1
rossomme	Miserables.txt 6
rostopchine	Miserables.txt 1
rostrum	Miserables.txt 2, NotreDame_De_Paris.txt 1
rostrums	NotreDame_De_Paris.txt 1
rosy	Miserables.txt 36, NotreDame_De_Paris.txt 6
rot	NotreDame_De_Paris.txt 2, Miserables.txt 1
rota	NotreDame_De_Paris.txt 1, Miserables.txt 1
rotary	NotreDame_De_Paris.txt 1
rotatory	NotreDame_De_Paris.txt 4
rothschild	Miserables.txt 3
rotisserie	NotreDame_De_Paris.txt 1
rotted	NotreDame_De_Paris.txt 2, Miserables.txt 2
rotten	Miserables.txt 6, NotreDame_De_Paris.txt 1
rottenness	Miserables.txt 2
rotterdam	NotreDame_De_Paris.txt 1
rotting	Miserables.txt 3, NotreDame_De_Paris.txt 1
rotunda	Miserables.txt 4
rouault	NotreDame_De_Paris.txt 2
roubles	Miserables.txt 1
rouen	Miserables.txt 2, NotreDame_De_Paris.txt 1
rouge	NotreDame_De_Paris.txt 3, Miserables.txt 2
rouged	Miserables.txt 1
rouges	Miserables.txt 3
rouget	Miserables.txt 1
rough	Miserables.txt 22, NotreDame_De_Paris.txt 16
roughened	Miserables.txt 2
roughhewn	Miserables.txt 1
roughly	Miserables.txt 17, NotreDame_De_Paris.txt 8
roughness	Miserables.txt 2
roula	Miserables.txt 1
roule	Miserables.txt 1
roulette	Miserables.txt 1
roulotte	Miserables.txt 1
roumania	Miserables.txt 1
round	Miserables.txt 174, NotreDame_De_Paris.txt 84
roundabout	Miserables.txt 2
rounded	NotreDame_De_Paris.txt 7, Miserables.txt 2
rounding	Miserables.txt 1
roundness	Miserables.txt 1
rounds	Miserables.txt 8, NotreDame_De_Paris.txt 1
roundsman	Miserables.txt 1
rouse	Miserables.txt 7, NotreDame_De_Paris.txt 1
roused	Miserables.txt 11, NotreDame_De_Paris.txt 8
rousing	Miserables.txt 1
rousseau	Miserables.txt 19, NotreDame_De_Paris.txt 3
rousses	Miserables.txt 1
roussillon	NotreDame_De_Paris.txt 1
roussins	Miserables.txt 1
rout	Miserables.txt 12, NotreDame_De_Paris.txt 4
route	Miserables.txt 7, NotreDame_De_Paris.txt 1
routed	Miserables.txt 2
routes	Miserables.txt 1
routine	Miserables.txt 1
routines	Miserables.txt 1
rouvray	NotreDame_De_Paris.txt 1
rover	Miserables.txt 1
row	Miserables.txt 15, NotreDame_De_Paris.txt 12
rowed	NotreDame_De_Paris.txt 2
rowels	NotreDame_De_Paris.txt 1
rowing	NotreDame_De_Paris.txt 3
rows	Miserables.txt 14, NotreDame_De_Paris.txt 3
royal	Miserables.txt 41, NotreDame_De_Paris.txt 20
royale	Miserables.txt 4, NotreDame_De_Paris.txt 3
royalism	Miserables.txt 5
royalist	Miserables.txt 24
royalists	Miserables.txt 6
royally	Miserables.txt 2
royalties	NotreDame_De_Paris.txt 2, Miserables.txt 2
royalty	Miserables.txt 23, NotreDame_De_Paris.txt 4
royer	Miserables.txt 2
roysterers	Miserables.txt 1
roze	Miserables.txt 2
rubans	Miserables.txt 1
rubaudiere	Miserables.txt 2
rubbed	Miserables.txt 7, NotreDame_De_Paris.txt 4
rubbing	Miserables.txt 3, NotreDame_De_Paris.txt 1
rubbish	Miserables.txt 23, NotreDame_De_Paris.txt 4
rubble	NotreDame_De_Paris.txt 1
rubebbe	NotreDame_De_Paris.txt 1
rubicon	Miserables.txt 2
rubies	Miserables.txt 3
rubigine	Miserables.txt 1
rubric	Miserables.txt 1
rubs	Miserables.txt 2
ruby	NotreDame_De_Paris.txt 1
ruddy	Miserables.txt 7, NotreDame_De_Paris.txt 2
rude	Miserables.txt 6, NotreDame_De_Paris.txt 2
rudely	NotreDame_De_Paris.txt 3, Miserables.txt 3
rudeness	Miserables.txt 2
rudiment	NotreDame_De_Paris.txt 1
rudimentary	Miserables.txt 1
rue	Miserables.txt 667, NotreDame_De_Paris.txt 94
rues	Miserables.txt 4, NotreDame_De_Paris.txt 3
ruff	NotreDame_De_Paris.txt 1
ruffian	Miserables.txt 12
ruffianism	Miserables.txt 3
ruffians	Miserables.txt 46, NotreDame_De_Paris.txt 3
ruffle	Miserables.txt 1
ruffled	Miserables.txt 2, NotreDame_De_Paris.txt 1
ruffles	NotreDame_De_Paris.txt 1
ruffs	NotreDame_De_Paris.txt 1
rug	Miserables.txt 2, NotreDame_De_Paris.txt 1
ruin	Miserables.txt 42, NotreDame_De_Paris.txt 6
ruined	Miserables.txt 19, NotreDame_De_Paris.txt 11
ruining	Miserables.txt 4, NotreDame_De_Paris.txt 2
ruinous	NotreDame_De_Paris.txt 1, Miserables.txt 1
ruins	Miserables.txt 16, NotreDame_De_Paris.txt 11
ruisseau	Miserables.txt 1
rule	Miserables.txt 29, NotreDame_De_Paris.txt 3
ruled	Miserables.txt 2, NotreDame_De_Paris.txt 1
ruler	Miserables.txt 1
rules	Miserables.txt 6, NotreDame_De_Paris.txt 3
rully	NotreDame_De_Paris.txt 1
rumble	Miserables.txt 5
rumbled	Miserables.txt 5
rumbling	Miserables.txt 3, NotreDame_De_Paris.txt 2
ruminated	NotreDame_De_Paris.txt 1
rummage	Miserables.txt 3, NotreDame_De_Paris.txt 1
rummaged	Miserables.txt 6, NotreDame_De_Paris.txt 1
rummager	Miserables.txt 1
rummages	Miserables.txt 1
rummaging	NotreDame_De_Paris.txt 3, Miserables.txt 2
rumor	Miserables.txt 6, NotreDame_De_Paris.txt 1
rumored	Miserables.txt 1
rumors	Miserables.txt 7, NotreDame_De_Paris.txt 3
rumpling	NotreDame_De_Paris.txt 1
run	Miserables.txt 64, NotreDame_De_Paris.txt 22
runaway	NotreDame_De_Paris.txt 1, Miserables.txt 1
runaways	NotreDame_De_Paris.txt 1
rung	NotreDame_De_Paris.txt 2, Miserables.txt 2
rungs	Miserables.txt 3, NotreDame_De_Paris.txt 2
runners	Miserables.txt 1
running	Miserables.txt 26, NotreDame_De_Paris.txt 23
runs	Miserables.txt 14, NotreDame_De_Paris.txt 5
ruppin	Miserables.txt 1
ruptures	Miserables.txt 1
rural	Miserables.txt 3
ruris	Miserables.txt 1
ruse	Miserables.txt 4, NotreDame_De_Paris.txt 1
rush	Miserables.txt 11, NotreDame_De_Paris.txt 3
rushed	Miserables.txt 30, NotreDame_De_Paris.txt 15
rushes	NotreDame_De_Paris.txt 1, Miserables.txt 1
rushing	NotreDame_De_Paris.txt 1, Miserables.txt 1
russe	Miserables.txt 1
russet	Miserables.txt 1
russia	Miserables.txt 5, NotreDame_De_Paris.txt 1
russian	Miserables.txt 7
russians	Miserables.txt 3
rust	Miserables.txt 4
rusted	NotreDame_De_Paris.txt 6, Miserables.txt 2
rustic	Miserables.txt 10, NotreDame_De_Paris.txt 2
rusticating	Miserables.txt 1
rusticity	Miserables.txt 1
rustics	NotreDame_De_Paris.txt 4, Miserables.txt 2
rusting	Miserables.txt 1
rustle	Miserables.txt 4
rustled	Miserables.txt 4, NotreDame_De_Paris.txt 2
rustler	Miserables.txt 2
rustles	Miserables.txt 1
rustling	Miserables.txt 4, NotreDame_De_Paris.txt 1
rusty	Miserables.txt 10, NotreDame_De_Paris.txt 4
rut	Miserables.txt 3
ruthlessly	Miserables.txt 1
ruts	Miserables.txt 6
ruysdeel	Miserables.txt 1
ruyter	Miserables.txt 1
ry	NotreDame_De_Paris.txt 5
rye	Miserables.txt 7, NotreDame_De_Paris.txt 1
rylandt	Miserables.txt 2
rym	NotreDame_De_Paris.txt 26
ryssel	Miserables.txt 1
